,match_id,team_id,possession_full_match,shots_on,shots_on_first_half,shots_on_second_half,goals,goals_first_half,goals_second_half
0,1729,10260,55,11,6,5,1,1,0
1,1729,10261,45,1,0,1,1,1,0
2,1730,9825,66,12,7,5,1,1,0
3,1730,8659,34,2,0,2,0,0,0
4,1731,8472,46,4,2,2,1,0,1
5,1731,8650,54,11,4,7,0,0,0
6,1732,8654,52,5,3,2,2,2,0
7,1732,8528,48,7,1,6,1,0,1
8,1733,10252,52,5,4,1,4,0,4
9,1733,8456,48,9,2,7,2,0,2
10,1734,8668,51,2,1,1,3,1,2
11,1734,8655,49,8,4,4,2,1,1
12,1735,8549,53,7,3,4,4,1,3
13,1735,8586,47,2,0,2,0,0,0
14,1736,8559,47,5,3,2,3,3,0
15,1736,10194,53,1,0,1,1,0,1
16,1737,9879,47,4,4,0,1,1,0
17,1737,8667,53,5,2,3,2,1,1
18,1739,10260,60,11,6,5,2,2,0
19,1739,8654,40,3,2,1,0,0,0
20,1740,9825,62,9,3,6,4,1,3
21,1740,8586,38,3,0,3,4,1,3
22,1741,8456,55,11,3,8,2,0,2
23,1741,8549,45,5,5,0,0,0,0
24,1742,8559,53,13,7,6,1,0,1
25,1742,8668,47,6,5,1,0,0,0
26,1744,8472,48,4,3,1,1,0,1
27,1744,10194,52,4,4,0,0,0,0
28,1745,8650,54,9,5,4,1,0,1
29,1745,8462,46,1,1,0,0,0,0
30,1746,10252,57,2,2,0,2,1,1
31,1746,8655,43,7,4,3,3,1,2
32,1747,10261,51,4,2,2,2,2,0
33,1747,8659,49,5,1,4,1,0,1
34,1750,8650,51,5,2,3,2,1,1
35,1750,8586,49,5,2,3,1,0,1
36,1751,8668,54,5,4,1,1,0,1
37,1751,9879,46,7,3,4,0,0,0
38,1752,8654,47,8,1,7,1,1,0
39,1752,8549,53,8,2,6,1,0,1
40,1753,10261,55,5,3,2,2,0,2
41,1753,10252,45,1,1,0,0,0,0
42,1754,8559,55,8,3,5,1,0,1
43,1754,8456,45,7,3,4,1,0,1
44,1755,8659,59,7,2,5,2,1,1
45,1755,8655,41,4,1,3,2,0,2
46,1756,8528,55,9,4,5,2,1,1
47,1756,8462,45,8,3,5,1,0,1
48,1757,9825,55,4,3,1,2,1,1
49,1757,10194,45,3,2,1,1,0,1
50,1758,8455,55,8,6,2,5,3,2
51,1758,8472,45,0,0,0,0,0,0
52,1759,10260,48,9,5,4,2,1,1
53,1759,9825,52,6,3,3,2,1,1
54,1760,8650,51,8,7,1,3,2,1
55,1760,8659,49,2,1,1,0,0,0
56,1761,8462,45,3,3,0,1,1,0
57,1761,8472,55,4,2,2,2,0,2
58,1762,8654,55,11,7,4,1,0,1
59,1762,8668,45,3,1,2,3,0,3
60,1763,10252,56,10,7,3,2,1,1
61,1763,8549,44,5,2,3,1,1,0
62,1764,8456,45,6,2,4,1,1,0
63,1764,8586,55,5,2,3,2,1,1
64,1765,8455,60,9,6,3,2,1,1
65,1765,8655,40,3,1,2,0,0,0
66,1766,9879,53,5,4,1,2,1,1
67,1766,10261,47,6,1,5,1,0,1
68,1767,8667,55,8,2,6,1,0,1
69,1767,8559,45,7,1,6,0,0,0
70,1768,8528,57,9,2,7,5,2,3
71,1768,10194,43,1,0,1,0,0,0
72,1769,10260,58,11,5,6,2,1,1
73,1769,10194,42,0,0,0,1,0,1
74,1770,10252,47,4,4,0,1,1,0
75,1770,9825,53,8,3,5,1,0,1
76,1772,8549,45,2,1,1,2,1,1
77,1772,8668,55,7,5,2,2,0,2
78,1773,8528,46,4,2,2,2,1,1
79,1773,10261,54,6,1,5,1,0,1
80,1775,9879,52,13,3,10,2,1,1
81,1775,8586,48,5,3,2,1,1,0
82,1776,8650,52,7,4,3,3,3,0
83,1776,8559,48,10,1,9,0,0,0
84,1777,8455,51,7,2,5,2,1,1
85,1777,8659,49,3,3,0,2,2,0
86,1778,8667,52,3,0,3,1,1,0
87,1778,8456,48,3,0,3,0,0,0
88,1779,9879,47,5,4,1,1,1,0
89,1779,8650,53,8,5,3,0,0,0
90,1780,8472,56,4,3,1,3,2,1
91,1780,8654,44,6,5,1,1,0,1
92,1781,8655,47,10,4,6,3,1,2
93,1781,8586,53,10,2,8,0,0,0
94,1782,10252,40,7,3,4,3,1,2
95,1782,10260,60,5,4,1,1,0,1
96,1783,8559,49,2,2,0,1,0,1
97,1783,8549,51,10,4,6,0,0,0
98,1784,9825,46,5,2,3,1,0,1
99,1784,8456,54,4,1,3,0,0,0
100,1785,8462,54,4,3,1,2,2,0
101,1785,8667,46,7,2,5,4,3,1
102,1786,10194,55,9,4,5,1,0,1
103,1786,8659,45,3,1,2,0,0,0
104,1788,8455,61,17,8,9,1,0,1
105,1788,10261,39,0,0,0,0,0,0
106,1790,8472,51,6,2,4,1,1,0
107,1790,8559,49,4,1,3,0,0,0
108,1791,8668,49,5,3,2,3,0,3
109,1791,8586,51,6,1,5,2,0,2
110,1792,9879,44,2,1,1,1,1,0
111,1792,10252,56,6,0,6,1,0,1
112,1793,8549,53,7,1,6,1,0,1
113,1793,10261,47,6,2,4,2,0,2
114,1794,10260,51,8,4,4,3,1,2
115,1794,8456,49,1,0,1,0,0,0
116,1795,8462,53,2,1,1,1,0,1
117,1795,8655,47,2,2,0,0,0,0
118,1796,10194,53,8,4,4,1,1,0
119,1796,8667,47,5,0,5,0,0,0
120,1797,8528,51,7,3,4,2,0,2
121,1797,8659,49,9,2,7,0,0,0
122,1798,8455,58,6,5,1,3,1,2
123,1798,9825,42,5,4,1,2,1,1
124,1799,10260,80,10,5,5,2,2,0
125,1799,8472,20,1,0,1,2,0,2
126,1800,8528,40,7,3,4,3,0,3
127,1800,9825,60,3,1,2,1,0,1
128,1801,8586,47,9,3,6,1,1,0
129,1801,8654,53,5,1,4,1,1,0
130,1802,10252,39,3,2,1,2,2,0
131,1802,8668,61,7,6,1,0,0,0
132,1803,10261,49,4,3,1,2,0,2
133,1803,10194,51,4,0,4,1,0,1
134,1804,8655,41,2,2,0,1,1,0
135,1804,8650,59,5,0,5,3,3,0
136,1805,8456,44,7,2,5,4,3,1
137,1805,9879,56,7,3,4,0,0,0
138,1806,8559,46,8,3,5,1,0,1
139,1806,8455,54,4,2,2,0,0,0
140,1808,8549,48,6,3,3,3,2,1
141,1808,8667,52,6,3,3,3,1,2
142,1809,8650,70,12,7,5,1,1,0
143,1809,8667,30,3,2,1,1,1,0
144,1810,8472,48,7,5,2,3,2,1
145,1810,8659,52,13,7,6,0,0,0
146,1811,8586,38,5,3,2,1,1,0
147,1811,10260,62,10,5,5,1,0,1
148,1812,10252,55,4,1,3,1,0,1
149,1812,8559,45,1,0,1,0,0,0
150,1813,9825,52,10,3,7,1,0,1
151,1813,8549,48,3,1,2,0,0,0
152,1816,9879,57,7,2,5,2,1,1
153,1816,10194,43,0,0,0,1,1,0
154,1817,8528,4,1,1,0,3,3,0
155,1817,8655,96,4,3,1,0,0,0
156,1818,8455,57,16,6,10,3,1,2
157,1818,8654,43,1,0,1,0,0,0
158,1821,8654,59,12,6,6,3,1,2
159,1821,10252,41,6,4,2,3,1,2
160,1822,8455,56,7,5,2,3,1,2
161,1822,8668,44,9,5,4,0,0,0
162,1823,8586,55,6,4,2,1,0,1
163,1823,10261,45,3,3,0,0,0,0
164,1824,10194,55,4,1,3,2,1,1
165,1824,8655,45,6,1,5,2,0,2
166,1825,8549,47,6,4,2,2,1,1
167,1825,9879,53,10,7,3,0,0,0
168,1828,8667,49,8,6,2,5,4,1
169,1828,8472,51,5,0,5,1,0,1
170,1829,8650,67,9,5,4,1,0,1
171,1829,8559,33,1,1,0,0,0,0
172,1830,8655,44,3,1,2,2,2,0
173,1830,8472,56,9,0,9,0,0,0
174,1832,10252,45,7,5,2,2,0,2
175,1832,9825,55,3,0,3,1,0,1
176,1833,8549,54,5,3,2,2,0,2
177,1833,8668,46,4,1,3,1,0,1
178,1834,8667,44,6,3,3,1,0,1
179,1834,8456,56,9,8,1,0,0,0
180,1836,10194,48,4,1,3,3,0,3
181,1836,10260,52,8,3,5,0,0,0
182,1838,8455,62,14,6,8,1,1,0
183,1838,8659,38,5,1,4,1,1,0
184,1839,8650,57,6,3,3,1,1,0
185,1839,8549,43,4,2,2,0,0,0
186,1840,8472,45,4,3,1,3,0,3
187,1840,8586,55,6,0,6,1,0,1
188,1841,10261,57,6,2,4,1,1,0
189,1841,8559,43,3,1,2,0,0,0
190,1842,8456,58,5,4,1,3,1,2
191,1842,8654,42,0,0,0,2,0,2
192,1843,8655,60,4,2,2,1,0,1
193,1843,8667,40,3,1,2,0,0,0
194,1844,9825,53,8,2,6,1,0,1
195,1844,9879,47,2,2,0,0,0,0
196,1845,8659,47,7,2,5,1,1,0
197,1845,8668,53,4,2,2,2,0,2
198,1846,10260,64,7,3,4,3,2,1
199,1846,8462,36,4,1,3,0,0,0
200,1847,10194,46,1,1,0,2,1,1
201,1847,10252,54,0,0,0,2,0,2
202,1849,10260,53,12,7,5,2,1,1
203,1849,8549,47,2,2,0,2,0,2
204,1850,9825,57,6,2,4,1,1,0
205,1850,8462,43,4,2,2,0,0,0
206,1851,10194,33,4,1,3,2,0,2
207,1851,8654,67,12,5,7,0,0,0
208,1852,8472,41,6,4,2,1,0,1
209,1852,8668,59,3,1,2,0,0,0
210,1854,8655,51,7,3,4,3,1,2
211,1854,8456,49,1,0,1,0,0,0
212,1855,8455,59,17,9,8,1,0,1
213,1855,9879,41,1,1,0,0,0,0
214,1856,8559,44,9,3,6,1,1,0
215,1856,8528,56,6,6,0,2,1,1
216,1857,8659,53,7,3,4,2,2,0
217,1857,8586,47,5,2,3,0,0,0
218,1858,10252,57,3,1,2,1,1,0
219,1858,8667,43,3,1,2,1,0,1
220,1859,8455,44,6,4,2,1,1,0
221,1859,10260,56,6,3,3,2,0,2
222,1860,9825,64,7,1,6,2,0,2
223,1860,8559,36,3,0,3,0,0,0
224,1861,8659,47,6,3,3,1,1,0
225,1861,10252,53,14,6,8,0,0,0
226,1862,8668,57,2,2,0,1,0,1
227,1862,8667,43,0,0,0,0,0,0
228,1863,8549,55,4,2,2,1,0,1
229,1863,8472,45,4,2,2,1,0,1
230,1865,9879,49,8,5,3,1,0,1
231,1865,8655,51,7,3,4,1,0,1
232,1866,8462,55,6,2,4,4,1,3
233,1866,8456,45,8,4,4,1,1,0
234,1867,8650,65,5,2,3,1,0,1
235,1867,10194,35,0,0,0,0,0,0
236,1868,8586,49,4,2,2,3,0,3
237,1868,8528,51,5,4,1,0,0,0
238,1869,8668,44,5,3,2,1,0,1
239,1869,8650,56,5,3,2,0,0,0
240,1871,8586,54,15,10,5,3,1,2
241,1871,8462,46,4,4,0,1,0,1
242,1872,8654,59,6,4,2,1,0,1
243,1872,9879,41,5,1,4,2,0,2
244,1873,8456,49,2,2,0,1,0,1
245,1873,8528,51,8,1,7,0,0,0
246,1874,10261,46,3,3,0,3,3,0
247,1874,8655,54,3,1,2,1,0,1
248,1875,10260,59,13,6,7,3,2,1
249,1875,8559,41,3,3,0,0,0,0
250,1877,8667,43,4,3,1,6,2,4
251,1877,9825,57,5,2,3,0,0,0
252,1878,8455,56,19,10,9,1,1,0
253,1878,10194,44,1,1,0,0,0,0
254,1879,9879,47,9,4,5,1,1,0
255,1879,8472,53,12,5,7,1,0,1
256,1880,8586,58,11,6,5,1,0,1
257,1880,10194,42,1,0,1,1,0,1
258,1881,8667,44,12,7,5,2,1,1
259,1881,8654,56,10,4,6,1,0,1
260,1882,10260,61,6,4,2,2,2,0
261,1882,8659,39,4,3,1,3,0,3
262,1883,8462,54,8,3,5,2,0,2
263,1883,10252,46,2,2,0,0,0,0
264,1884,8528,48,2,2,0,1,1,0
265,1884,8650,52,3,1,2,0,0,0
266,1885,9825,51,4,2,2,2,0,2
267,1885,8668,49,4,2,2,0,0,0
268,1886,8456,64,4,2,2,1,1,0
269,1886,10261,36,0,0,0,2,0,2
270,1887,8655,52,11,3,8,3,1,2
271,1887,8559,48,1,1,0,1,0,1
272,1888,8455,61,12,6,6,3,1,2
273,1888,8549,39,6,3,3,2,0,2
274,1889,10260,52,11,6,5,2,1,1
275,1889,8668,48,5,1,4,2,0,2
276,1890,9825,55,9,3,6,1,1,0
277,1890,8654,45,2,1,1,0,0,0
278,1891,8455,46,4,3,1,2,0,2
279,1891,8650,54,14,5,9,0,0,0
280,1893,8655,49,12,3,9,2,1,1
281,1893,8549,51,6,2,4,0,0,0
282,1894,8472,49,10,8,2,3,1,2
283,1894,10261,51,14,6,8,0,0,0
284,1895,8462,52,7,4,3,1,0,1
285,1895,9879,48,4,1,3,0,0,0
286,1896,8586,54,8,3,5,3,3,0
287,1896,8559,46,5,3,2,2,1,1
288,1897,8667,53,10,5,5,3,2,1
289,1897,8659,47,4,0,4,1,1,0
290,1898,8456,57,6,1,5,2,0,2
291,1898,10194,43,3,2,1,1,0,1
292,1899,8472,60,6,4,2,1,1,0
293,1899,10194,40,2,1,1,0,0,0
294,1901,8654,47,5,3,2,1,1,0
295,1901,10260,53,8,5,3,0,0,0
296,1902,8668,68,8,4,4,2,0,2
297,1902,8559,32,5,0,5,1,0,1
298,1903,8549,39,5,3,2,2,2,0
299,1903,8456,61,14,6,8,1,0,1
300,1905,10261,51,6,4,2,2,1,1
301,1905,8659,49,4,1,3,1,1,0
302,1907,9879,46,3,3,0,1,0,1
303,1907,8528,54,4,1,3,3,0,3
304,1908,8455,59,12,7,5,4,2,2
305,1908,8667,41,3,2,1,0,0,0
306,1909,8655,42,6,1,5,1,1,0
307,1909,10260,58,5,2,3,1,0,1
308,1910,9825,64,8,5,3,2,1,1
309,1910,8472,36,2,2,0,2,0,2
310,1911,8650,52,7,3,4,3,2,1
311,1911,8456,48,4,1,3,0,0,0
312,1912,8455,58,9,5,4,1,1,0
313,1912,10252,42,6,2,4,2,0,2
314,1914,8668,53,7,3,4,1,0,1
315,1914,10261,47,1,0,1,0,0,0
316,1915,9879,54,10,3,7,2,2,0
317,1915,8659,46,7,3,4,1,0,1
318,1916,8559,46,6,3,3,2,1,1
319,1916,8654,54,9,3,6,1,0,1
320,1917,8586,53,6,1,5,4,3,1
321,1917,8667,47,3,1,2,2,1,1
322,1918,8462,46,3,1,2,3,3,0
323,1918,10194,54,2,2,0,1,1,0
324,1919,10260,52,12,7,5,2,1,1
325,1919,8462,48,2,0,2,1,0,1
326,1920,9879,45,4,2,2,1,1,0
327,1920,9825,55,6,3,3,0,0,0
328,1921,8586,46,8,5,3,2,0,2
329,1921,8472,54,4,0,4,0,0,0
330,1923,10252,61,5,4,1,1,1,0
331,1923,10194,39,0,0,0,2,1,1
332,1924,8659,45,10,4,6,2,1,1
333,1924,8668,55,6,4,2,0,0,0
334,1925,8650,44,9,6,3,1,0,1
335,1925,8549,56,3,2,1,0,0,0
336,1926,8559,52,5,3,2,1,1,0
337,1926,10261,48,12,4,8,4,2,2
338,1927,8655,51,5,3,2,1,1,0
339,1927,8667,49,4,2,2,3,0,3
340,1928,8528,43,6,5,1,2,1,1
341,1928,8455,57,12,8,4,1,0,1
342,1929,8549,47,4,3,1,3,2,1
343,1929,8586,53,4,3,1,1,0,1
344,1930,8659,40,6,2,4,1,1,0
345,1930,9825,60,4,0,4,1,0,1
346,1932,8559,46,9,4,5,2,2,0
347,1932,10194,54,3,0,3,3,1,2
348,1933,8528,56,8,2,6,1,1,0
349,1933,8654,44,2,0,2,1,1,0
350,1934,8472,42,2,2,0,2,2,0
351,1934,8650,58,11,7,4,0,0,0
352,1935,10261,37,5,3,2,5,4,1
353,1935,10260,63,7,4,3,0,0,0
354,1936,8456,51,6,2,4,3,2,1
355,1936,10252,49,5,0,5,0,0,0
356,1938,9879,49,10,3,7,3,1,2
357,1938,8667,51,2,1,1,0,0,0
358,1939,10260,61,8,3,5,3,1,2
359,1939,8650,39,3,1,2,4,3,1
360,1940,9825,57,9,2,7,2,0,2
361,1940,8655,43,4,2,2,0,0,0
362,1942,8659,47,3,2,1,1,1,0
363,1942,8654,53,4,4,0,4,1,3
364,1943,8586,53,9,5,4,5,3,2
365,1943,10252,47,5,3,2,0,0,0
366,1944,8668,53,9,4,5,2,1,1
367,1944,10194,47,2,1,1,3,0,3
368,1945,8462,51,3,3,0,2,1,1
369,1945,8549,49,8,1,7,0,0,0
370,1946,8559,46,5,3,2,1,1,0
371,1946,9879,54,4,2,2,1,0,1
372,1947,10261,51,4,1,3,2,1,1
373,1947,8667,49,1,0,1,0,0,0
374,1948,8456,47,3,1,2,1,1,0
375,1948,8455,53,5,1,4,2,1,1
376,1949,10260,55,8,5,3,1,0,1
377,1949,9879,45,1,1,0,0,0,0
378,1950,9825,53,12,6,6,1,0,1
379,1950,10261,47,1,0,1,0,0,0
380,1951,8456,54,6,3,3,3,1,2
381,1951,8472,46,4,3,1,2,1,1
382,1952,8655,45,7,3,4,2,1,1
383,1952,8654,55,4,1,3,0,0,0
384,1953,8650,55,5,1,4,4,1,3
385,1953,10252,45,2,1,1,0,0,0
386,1956,8559,52,10,3,7,2,0,2
387,1956,8659,48,7,4,3,0,0,0
388,1957,8528,52,1,1,0,1,1,0
389,1957,8667,48,4,1,3,2,0,2
390,1959,8650,57,4,2,2,1,0,1
391,1959,10252,43,4,3,1,0,0,0
392,1961,9825,59,10,6,4,4,2,2
393,1961,10261,41,4,1,3,1,1,0
394,1962,8456,61,10,3,7,2,1,1
395,1962,8472,39,4,2,2,0,0,0
396,1963,8655,56,12,6,6,4,2,2
397,1963,8654,44,1,1,0,0,0,0
398,1964,9879,54,11,9,2,1,0,1
399,1964,10260,46,13,1,12,0,0,0
400,1966,8462,44,9,4,5,3,2,1
401,1966,8668,56,3,0,3,3,1,2
402,1967,10194,48,2,1,1,3,2,1
403,1967,8549,52,6,3,3,1,1,0
404,1968,8667,53,3,2,1,1,1,0
405,1968,8528,47,6,4,2,3,0,3
406,1969,10260,53,6,3,3,1,1,0
407,1969,10252,47,4,4,0,1,0,1
408,1971,8472,48,8,3,5,1,1,0
409,1971,8654,52,7,1,6,4,0,4
410,1972,8668,57,7,3,4,6,1,5
411,1972,8528,43,10,2,8,4,0,4
412,1973,8455,52,10,2,8,1,1,0
413,1973,10261,48,6,2,4,0,0,0
414,1974,8586,51,4,3,1,4,2,2
415,1974,8655,49,5,0,5,2,1,1
416,1975,8650,52,9,5,4,1,0,1
417,1975,9879,48,2,0,2,0,0,0
418,1976,8559,45,7,4,3,1,0,1
419,1976,8549,55,4,2,2,0,0,0
420,1977,10194,39,5,5,0,1,1,0
421,1977,8659,61,12,2,10,2,0,2
422,1978,8462,42,1,1,0,2,2,0
423,1978,8667,58,1,0,1,5,0,5
424,1979,8650,60,7,5,2,2,1,1
425,1979,8655,40,7,2,5,0,0,0
426,1981,8586,60,9,3,6,2,1,1
427,1981,8654,40,5,2,3,1,0,1
428,1982,10252,47,6,3,3,2,1,1
429,1982,8668,53,3,3,0,0,0,0
430,1983,8549,49,9,4,5,1,1,0
431,1983,8667,51,4,1,3,0,0,0
432,1984,9879,53,9,3,6,1,1,0
433,1984,8456,47,6,0,6,1,0,1
434,1986,10194,52,9,4,5,3,1,2
435,1986,10261,48,5,2,3,0,0,0
436,1987,8528,41,3,1,2,3,1,2
437,1987,9825,59,1,0,1,1,0,1
438,1989,8650,52,13,8,5,3,2,1
439,1989,9825,48,0,0,0,0,0,0
440,1991,8586,52,18,8,10,2,0,2
441,1991,10261,48,5,3,2,0,0,0
442,1993,8549,52,18,10,8,2,1,1
443,1993,9879,48,6,1,5,0,0,0
444,1994,8456,57,9,3,6,1,1,0
445,1994,8659,43,12,3,9,0,0,0
446,1995,8462,53,13,9,4,2,1,1
447,1995,8559,47,1,1,0,0,0,0
448,1996,8655,43,4,2,2,3,3,0
449,1996,10194,57,2,0,2,2,0,2
450,1997,8528,48,6,4,2,3,2,1
451,1997,10260,52,6,2,4,0,0,0
452,1998,8668,51,6,3,3,1,1,0
453,1998,8455,49,10,3,7,2,2,0
454,1999,8586,47,2,1,1,1,1,0
455,1999,10260,53,12,8,4,0,0,0
456,2000,9825,54,11,3,8,4,3,1
457,2000,8549,46,6,2,4,1,1,0
458,2002,8456,48,7,2,5,2,2,0
459,2002,8668,52,5,1,4,0,0,0
460,2003,10261,52,7,4,3,3,2,1
461,2003,8462,48,6,2,4,2,0,2
462,2004,8528,46,11,1,10,4,3,1
463,2004,8655,54,8,7,1,0,0,0
464,2005,9879,57,5,1,4,4,2,2
465,2005,10194,43,4,0,4,0,0,0
466,2006,8559,48,5,3,2,3,1,2
467,2006,10252,52,6,5,1,1,0,1
468,2007,8472,51,4,4,0,3,1,2
469,2007,8659,49,6,3,3,1,1,0
470,2008,8650,54,7,5,2,3,2,1
471,2008,8667,46,2,0,2,1,0,1
472,2009,10261,43,4,3,1,1,1,0
473,2009,8650,57,11,6,5,3,1,2
474,2010,8668,54,6,4,2,1,1,0
475,2010,8472,46,6,1,5,1,0,1
476,2011,8586,55,13,9,4,1,1,0
477,2011,8659,45,7,4,3,1,0,1
478,2012,8667,45,5,2,3,2,1,1
479,2012,10252,55,6,3,3,1,0,1
480,2013,8549,44,8,7,1,2,0,2
481,2013,10260,56,3,0,3,0,0,0
482,2014,8655,51,8,2,6,2,1,1
483,2014,8456,49,6,4,2,0,0,0
484,2015,8462,48,5,1,4,2,1,1
485,2015,9825,52,6,2,4,2,0,2
486,2016,10194,47,5,2,3,3,0,3
487,2016,8654,53,2,2,0,2,0,2
488,2017,8528,55,13,9,4,2,1,1
489,2017,8559,45,2,0,2,1,0,1
490,2018,9879,44,2,2,0,1,1,0
491,2018,8455,56,4,2,2,0,0,0
492,2019,10260,49,6,3,3,1,1,0
493,2019,8456,51,5,2,3,0,0,0
494,2020,9825,44,9,2,7,2,1,1
495,2020,8455,56,5,4,1,0,0,0
496,2021,8650,51,7,2,5,1,1,0
497,2021,8654,49,2,1,1,0,0,0
498,2022,8668,51,6,3,3,1,1,0
499,2022,8586,49,0,0,0,0,0,0
500,2023,8549,43,4,3,1,2,1,1
501,2023,10261,57,7,3,4,1,0,1
502,2024,8655,55,4,2,2,1,1,0
503,2024,8462,45,4,1,3,3,1,2
504,2025,10252,43,5,3,2,2,2,0
505,2025,9879,57,8,5,3,1,0,1
506,2026,8472,55,2,2,0,1,0,1
507,2026,8559,45,2,0,2,2,0,2
508,2030,8586,51,9,8,1,3,2,1
509,2030,8456,49,4,1,3,1,0,1
510,2031,8668,63,6,2,4,1,0,1
511,2031,8654,37,6,1,5,0,0,0
512,2033,10261,52,4,1,3,1,1,0
513,2033,9879,48,4,2,2,3,2,1
514,2034,8667,49,9,5,4,2,2,0
515,2034,8559,51,8,5,3,1,1,0
516,2035,8659,41,7,3,4,1,1,0
517,2035,8650,59,7,3,4,3,0,3
518,2037,8528,45,3,2,1,2,0,2
519,2037,10194,55,6,4,2,0,0,0
520,2038,8655,43,5,4,1,1,1,0
521,2038,8455,57,11,6,5,3,0,3
522,2040,8586,46,3,2,1,3,0,3
523,2040,8650,54,2,0,2,0,0,0
524,2041,8455,56,6,3,3,2,2,0
525,2041,8472,44,4,0,4,1,0,1
526,2042,8654,54,7,2,5,2,2,0
527,2042,8549,46,4,1,3,1,0,1
528,2043,10261,43,3,3,0,2,1,1
529,2043,10252,57,7,5,2,0,0,0
530,2044,8456,59,16,7,9,2,2,0
531,2044,8559,41,0,0,0,1,1,0
532,2045,8659,51,6,4,2,2,0,2
533,2045,8655,49,4,4,0,1,0,1
534,2046,8668,48,12,6,6,2,2,0
535,2046,9879,52,8,2,6,2,1,1
536,2047,10260,48,4,2,2,2,1,1
537,2047,8667,52,9,4,5,0,0,0
538,2048,8528,49,9,6,3,1,0,1
539,2048,8462,51,3,3,0,0,0,0
540,2050,8586,54,14,5,9,2,1,1
541,2050,10252,46,9,5,4,1,0,1
542,2052,8455,52,5,2,3,1,0,1
543,2052,8456,48,3,1,2,0,0,0
544,2054,9879,64,11,5,6,2,2,0
545,2054,8559,36,5,1,4,0,0,0
546,2059,8650,64,13,6,7,5,1,4
547,2059,10194,36,2,0,2,0,0,0
548,2060,8549,49,12,4,8,1,1,0
549,2060,8472,51,11,5,6,3,0,3
550,2062,8654,59,4,3,1,2,2,0
551,2062,10261,41,9,3,6,3,1,2
552,2064,9879,53,5,2,3,5,1,4
553,2064,8655,47,2,2,0,0,0,0
554,2065,8559,43,7,3,4,3,1,2
555,2065,9825,57,5,0,5,1,1,0
556,2066,8659,49,7,3,4,1,0,1
557,2066,10252,51,4,2,2,0,0,0
558,2067,8667,46,4,3,1,2,0,2
559,2067,8668,54,7,3,4,0,0,0
560,2069,8559,21,5,3,2,3,1,2
561,2069,10260,79,19,12,7,1,1,0
562,2070,9825,62,12,4,8,2,1,1
563,2070,8667,38,3,0,3,1,1,0
564,2072,8650,51,8,2,6,1,0,1
565,2072,8668,49,2,1,1,1,0,1
566,2074,8655,46,6,5,1,1,1,0
567,2074,10261,54,1,0,1,1,0,1
568,2075,8654,42,9,1,8,3,1,2
569,2075,9879,58,7,3,4,0,0,0
570,2077,8455,58,13,6,7,1,0,1
571,2077,10194,42,6,1,5,1,0,1
572,2078,8456,49,8,2,6,3,0,3
573,2078,8528,51,4,1,3,0,0,0
574,2079,8472,39,5,3,2,2,1,1
575,2079,9825,61,6,1,5,1,0,1
576,2082,8668,35,3,1,2,4,1,3
577,2082,10261,65,9,4,5,0,0,0
578,2084,8655,39,4,2,2,1,1,0
579,2084,10260,61,8,6,2,0,0,0
580,2085,8659,51,6,1,5,1,1,0
581,2085,9879,49,5,4,1,0,0,0
582,2086,10194,43,3,3,0,2,1,1
583,2086,8462,57,11,3,8,1,0,1
584,2087,8528,55,11,3,8,2,1,1
585,2087,8549,45,2,1,1,0,0,0
586,2088,8455,49,15,9,6,7,4,3
587,2088,10252,51,2,2,0,1,0,1
588,2089,10260,78,10,6,4,2,1,1
589,2089,8659,22,2,1,1,0,0,0
590,2090,9825,61,11,4,7,2,1,1
591,2090,8668,39,4,3,1,0,0,0
592,2091,8650,60,8,4,4,1,1,0
593,2091,8528,40,3,2,1,0,0,0
594,2092,8462,42,3,3,0,1,1,0
595,2092,10252,58,6,1,5,1,1,0
596,2093,8455,60,8,4,4,1,1,0
597,2093,8549,40,4,1,3,4,0,4
598,2094,8456,60,10,4,6,3,2,1
599,2094,10261,40,2,1,1,2,1,1
600,2095,8472,51,7,3,4,2,1,1
601,2095,9879,49,10,5,5,1,0,1
602,2096,8559,53,5,2,3,1,0,1
603,2096,8655,47,1,0,1,0,0,0
604,2097,8667,46,3,2,1,1,0,1
605,2097,8654,54,7,5,2,1,0,1
606,2098,10194,46,3,1,2,2,0,2
607,2098,8586,54,5,5,0,0,0,0
608,2099,10261,44,6,5,1,3,1,2
609,2099,8472,56,3,2,1,2,0,2
610,2101,9825,61,10,3,7,4,2,2
611,2101,8654,39,6,2,4,0,0,0
612,2102,8668,57,10,6,4,3,1,2
613,2102,10260,43,10,8,2,1,0,1
614,2103,8456,57,8,1,7,3,1,2
615,2103,10194,43,6,3,3,1,1,0
616,2104,8655,52,2,2,0,1,1,0
617,2104,8549,48,1,0,1,1,0,1
618,2105,8667,53,6,3,3,2,1,1
619,2105,8659,47,14,6,8,0,0,0
620,2106,8462,54,11,7,4,5,2,3
621,2106,9879,46,5,2,3,0,0,0
622,2107,10252,54,4,2,2,1,0,1
623,2107,8528,46,6,3,3,0,0,0
624,2108,8455,70,6,5,1,3,2,1
625,2108,8650,30,2,1,1,0,0,0
626,2109,10260,55,18,11,7,2,2,0
627,2109,8658,45,3,1,2,2,0,2
628,2110,8586,57,9,3,6,1,1,0
629,2110,8650,43,3,0,3,1,1,0
630,2111,10252,42,4,4,0,1,1,0
631,2111,8528,58,8,4,4,2,0,2
632,2112,9825,55,4,2,2,3,2,1
633,2112,8668,45,5,1,4,2,1,1
634,2113,8654,52,9,6,3,2,1,1
635,2113,8602,48,10,2,8,1,0,1
636,2114,8655,47,8,7,1,2,1,1
637,2114,8456,53,3,1,2,1,0,1
638,2115,8559,43,4,3,1,2,1,1
639,2115,8472,57,9,5,4,2,2,0
640,2117,8191,48,10,4,6,6,2,4
641,2117,10194,52,4,2,2,1,1,0
642,2120,8455,65,14,8,6,1,1,0
643,2120,8655,35,4,2,2,3,0,3
644,2121,8668,54,9,7,2,1,0,1
645,2121,8559,46,4,0,4,0,0,0
646,2122,8472,53,6,3,3,1,1,0
647,2122,8658,47,11,5,6,0,0,0
648,2123,10194,33,3,2,1,1,0,1
649,2123,8586,67,10,4,6,0,0,0
650,2125,10252,45,6,2,4,1,1,0
651,2125,8602,55,4,4,0,1,0,1
652,2126,8667,53,2,1,1,1,1,0
653,2126,8462,47,3,0,3,1,0,1
654,2127,8650,49,6,4,2,4,3,1
655,2127,10260,51,7,2,5,0,0,0
656,2128,8456,49,8,4,4,3,2,1
657,2128,9879,51,2,1,1,3,3,0
658,2129,8462,54,8,3,5,2,0,2
659,2129,8528,46,4,1,3,2,0,2
660,2130,8655,35,2,1,1,3,1,2
661,2130,10260,65,9,5,4,1,0,1
662,2131,8650,49,4,3,1,9,1,8
663,2131,9879,51,2,0,2,1,0,1
664,2132,8668,46,3,3,0,1,1,0
665,2132,10252,54,6,3,3,1,0,1
666,2133,8667,40,4,1,3,4,1,3
667,2133,8191,60,4,2,2,1,1,0
668,2134,8455,52,15,8,7,1,1,0
669,2134,8559,48,6,4,2,0,0,0
670,2135,8658,43,5,4,1,1,1,0
671,2135,8456,57,8,4,4,1,0,1
672,2136,9825,56,8,5,3,3,3,0
673,2136,8586,44,6,1,5,1,0,1
674,2137,8602,48,5,3,2,1,1,0
675,2137,10194,52,4,4,0,1,0,1
676,2139,8528,57,13,5,8,2,1,1
677,2139,9879,43,6,1,5,1,1,0
678,2140,10194,47,3,2,1,1,0,1
679,2140,8667,53,3,1,2,0,0,0
680,2141,8602,40,3,1,2,3,1,2
681,2141,9825,60,8,4,4,0,0,0
682,2142,8654,54,8,3,5,4,1,3
683,2142,8668,46,4,1,3,0,0,0
684,2143,8586,51,4,1,3,2,1,1
685,2143,8472,49,8,3,5,3,0,3
686,2145,8650,63,15,9,6,2,1,1
687,2145,8658,37,0,0,0,1,0,1
688,2146,10252,60,8,4,4,3,2,1
689,2146,8559,40,7,2,5,1,0,1
690,2147,8655,60,5,1,4,1,1,0
691,2147,8462,40,2,0,2,0,0,0
692,2148,8455,52,6,4,2,3,0,3
693,2148,10260,48,8,2,6,2,0,2
694,2149,8658,45,1,1,0,3,2,1
695,2149,9879,55,5,2,3,0,0,0
696,2150,9825,57,5,4,1,3,2,1
697,2150,8472,43,1,1,0,0,0,0
698,2151,8462,47,10,2,8,1,1,0
699,2151,10194,53,3,1,2,0,0,0
700,2152,8191,41,3,1,2,3,1,2
701,2152,10252,59,5,0,5,2,1,1
702,2153,8602,30,4,3,1,1,1,0
703,2153,8455,70,12,5,7,0,0,0
704,2154,8654,45,8,4,4,2,1,1
705,2154,8667,55,6,5,1,1,0,1
706,2155,8650,51,7,4,3,1,1,0
707,2155,8456,49,3,0,3,0,0,0
708,2156,10260,67,7,5,2,1,0,1
709,2156,8668,33,6,1,5,1,0,1
710,2157,8586,58,7,3,4,3,2,1
711,2157,8528,42,4,3,1,3,2,1
712,2158,8655,59,8,3,5,2,1,1
713,2158,8559,41,7,3,4,0,0,0
714,2159,10260,54,4,2,2,3,2,1
715,2159,8462,46,11,6,5,0,0,0
716,2161,8658,47,7,5,2,4,3,1
717,2161,8602,53,3,0,3,1,0,1
718,2162,8456,61,6,2,4,1,1,0
719,2162,8667,39,2,1,1,2,1,1
720,2164,8650,48,8,5,3,3,0,3
721,2164,8668,52,7,3,4,1,0,1
722,2166,8586,51,18,9,9,3,2,1
723,2166,10252,49,2,1,1,1,0,1
724,2167,9825,55,9,6,3,2,1,1
725,2167,8455,45,4,3,1,1,0,1
726,2168,8528,49,8,3,5,2,1,1
727,2168,8472,51,0,0,0,1,0,1
728,2169,8462,48,2,2,0,3,1,2
729,2169,8191,52,7,3,4,1,0,1
730,2170,10260,59,3,2,1,2,1,1
731,2170,8654,41,6,1,5,0,0,0
732,2171,8658,54,10,5,5,1,1,0
733,2171,8528,46,7,5,2,3,0,3
734,2172,8559,45,8,4,4,2,1,1
735,2172,8602,55,7,5,2,0,0,0
736,2173,8455,47,6,3,3,4,3,1
737,2173,8456,53,8,5,3,3,2,1
738,2174,8472,55,5,2,3,1,1,0
739,2174,9879,45,3,2,1,1,1,0
740,2175,8586,52,8,5,3,2,1,1
741,2175,8668,48,5,4,1,0,0,0
742,2176,8650,57,11,3,8,1,1,0
743,2176,8655,43,3,2,1,1,0,1
744,2177,10252,52,6,4,2,1,1,0
745,2177,8667,48,2,2,0,1,0,1
746,2178,9825,61,7,3,4,2,1,1
747,2178,10194,39,4,1,3,0,0,0
748,2179,10260,57,10,3,7,1,1,0
749,2179,10252,43,4,3,1,1,0,1
750,2180,8528,49,7,5,2,2,2,0
751,2180,10194,51,6,3,3,0,0,0
752,2182,8586,60,17,6,11,2,0,2
753,2182,8602,40,1,0,1,0,0,0
754,2183,8650,47,4,4,0,2,1,1
755,2183,9825,53,4,1,3,2,0,2
756,2184,8667,47,8,5,3,1,1,0
757,2184,8655,53,9,2,7,1,0,1
758,2186,9879,63,4,3,1,1,1,0
759,2186,8191,37,8,5,3,0,0,0
760,2187,8559,33,7,4,3,3,0,3
761,2187,8456,67,6,2,4,0,0,0
762,2190,8472,48,7,3,4,2,2,0
763,2190,10252,52,2,1,1,4,1,3
764,2192,10260,63,11,4,7,1,1,0
765,2192,8602,37,1,0,1,3,0,3
766,2193,8667,53,4,2,2,2,1,1
767,2193,8668,47,3,1,2,2,0,2
768,2194,9825,51,10,4,6,3,1,2
769,2194,8191,49,3,1,2,0,0,0
770,2195,8654,53,8,3,5,1,0,1
771,2195,8559,47,6,2,4,0,0,0
772,2196,8658,49,5,2,3,5,3,2
773,2196,8655,51,6,1,5,1,1,0
774,2197,8650,51,8,2,6,1,1,0
775,2197,8528,49,7,4,3,1,1,0
776,2198,8455,57,10,6,4,1,1,0
777,2198,8462,43,2,1,1,0,0,0
778,2199,9825,65,7,5,2,4,2,2
779,2199,8667,35,3,0,3,0,0,0
780,2200,8191,48,6,1,5,2,1,1
781,2200,8602,52,9,4,5,0,0,0
782,2201,8528,54,3,2,1,3,1,2
783,2201,8559,46,0,0,0,0,0,0
784,2202,8455,55,6,4,2,2,1,1
785,2202,8654,45,3,1,2,0,0,0
786,2203,8462,48,4,1,3,1,0,1
787,2203,8650,52,2,0,2,0,0,0
788,2204,8456,49,3,1,2,2,1,1
789,2204,8472,51,4,2,2,3,1,2
790,2206,8668,48,8,5,3,2,0,2
791,2206,8658,52,3,1,2,0,0,0
792,2207,8655,51,10,4,6,2,1,1
793,2207,8586,49,2,2,0,1,0,1
794,2208,10252,57,7,5,2,2,1,1
795,2208,10194,43,7,0,7,2,0,2
796,2209,8528,56,3,1,2,2,0,2
797,2209,8655,44,2,0,2,2,0,2
798,2210,8462,46,7,3,4,1,0,1
799,2210,8654,54,7,2,5,0,0,0
800,2211,8668,64,4,2,2,5,3,2
801,2211,8472,36,4,1,3,0,0,0
802,2212,8456,67,4,1,3,2,1,1
803,2212,10194,33,4,2,2,2,2,0
804,2213,8650,59,9,6,3,3,1,2
805,2213,8602,41,2,2,0,1,0,1
806,2214,10260,42,9,6,3,4,2,2
807,2214,8667,58,5,4,1,1,0,1
808,2215,9879,52,6,3,3,3,1,2
809,2215,8586,48,3,1,2,0,0,0
810,2216,8191,57,6,2,4,1,1,0
811,2216,8559,43,4,4,0,1,1,0
812,2217,8455,58,16,10,6,1,0,1
813,2217,8658,42,7,1,6,0,0,0
814,2218,9825,69,8,4,4,1,1,0
815,2218,10252,31,3,2,1,1,0,1
816,2219,9825,57,10,6,4,5,1,4
817,2219,8559,43,4,2,2,0,0,0
818,2220,8455,63,8,5,3,2,1,1
819,2220,8472,37,2,1,1,0,0,0
820,2221,8654,55,9,6,3,3,2,1
821,2221,10252,45,9,6,3,1,0,1
822,2222,8655,55,3,3,0,2,2,0
823,2222,9879,45,0,0,0,1,0,1
824,2223,8658,47,8,3,5,1,0,1
825,2223,8462,53,7,3,4,1,0,1
826,2224,8586,65,7,2,5,3,1,2
827,2224,8667,35,6,2,4,0,0,0
828,2225,10260,64,10,3,7,3,0,3
829,2225,8191,36,2,1,1,0,0,0
830,2226,8602,44,3,2,1,2,2,0
831,2226,8528,56,6,4,2,0,0,0
832,2227,8650,53,11,5,6,7,4,3
833,2227,10194,47,3,1,2,2,0,2
834,2228,8456,57,10,5,5,1,1,0
835,2228,8668,43,4,1,3,2,1,1
836,2229,8456,51,4,1,3,2,1,1
837,2229,8602,49,4,2,2,0,0,0
838,2230,8586,55,9,4,5,1,0,1
839,2230,8654,45,2,1,1,0,0,0
840,2231,10194,51,8,5,3,2,1,1
841,2231,8658,49,7,1,6,0,0,0
842,2232,8462,49,5,3,2,1,0,1
843,2232,9825,51,6,3,3,1,0,1
844,2233,8668,58,11,4,7,4,1,3
845,2233,8191,42,9,4,5,0,0,0
846,2234,8455,57,11,6,5,1,1,0
847,2234,9879,43,3,1,2,0,0,0
848,2235,8667,44,5,2,3,2,2,0
849,2235,8559,56,4,0,4,0,0,0
850,2236,8472,45,8,4,4,3,2,1
851,2236,8655,55,7,1,6,0,0,0
852,2237,10252,49,5,3,2,2,1,1
853,2237,8650,51,8,5,3,1,0,1
854,2238,10260,65,9,6,3,1,0,1
855,2238,8528,35,5,1,4,0,0,0
856,2239,8528,57,6,4,2,2,2,0
857,2239,10252,43,9,5,4,0,0,0
858,2240,8654,60,8,4,4,1,1,0
859,2240,8602,40,0,0,0,1,0,1
860,2241,8655,42,2,0,2,3,1,2
861,2241,8456,58,2,0,2,1,0,1
862,2242,8586,47,8,3,5,2,1,1
863,2242,8650,53,5,1,4,1,0,1
864,2243,8455,55,11,4,7,3,2,1
865,2243,8667,45,4,0,4,1,0,1
866,2244,8462,52,9,8,1,1,0,1
867,2244,9879,48,8,4,4,1,0,1
868,2245,8191,51,4,2,2,3,1,2
869,2245,10194,49,3,0,3,2,1,1
870,2246,8559,47,6,2,4,3,2,1
871,2246,8472,53,4,2,2,0,0,0
872,2247,10260,67,13,6,7,1,1,0
873,2247,8658,33,5,1,4,1,0,1
874,2248,8668,48,5,2,3,2,2,0
875,2248,9825,52,5,1,4,0,0,0
876,2249,8462,51,6,4,2,2,1,1
877,2249,8658,49,4,2,2,1,0,1
878,2250,10194,49,3,1,2,1,0,1
879,2250,8650,51,4,3,1,0,0,0
880,2252,8528,56,12,7,5,1,1,0
881,2252,8602,44,6,2,4,2,0,2
882,2253,10260,61,10,5,5,1,0,1
883,2253,8191,39,8,1,7,0,0,0
884,2254,8456,49,5,3,2,1,1,0
885,2254,8668,51,5,4,1,0,0,0
886,2255,8472,35,2,2,0,1,1,0
887,2255,8455,65,9,3,6,1,0,1
888,2256,9825,55,3,3,0,1,1,0
889,2256,8559,45,5,2,3,1,0,1
890,2257,9879,55,9,7,2,1,1,0
891,2257,8655,45,3,2,1,0,0,0
892,2258,10252,56,5,2,3,2,2,0
893,2258,8654,44,2,0,2,0,0,0
894,2260,8586,49,5,2,3,1,1,0
895,2260,9879,51,5,2,3,3,2,1
896,2262,8654,53,6,3,3,2,1,1
897,2262,8462,47,8,4,4,0,0,0
898,2263,10260,58,10,8,2,3,1,2
899,2263,8667,42,4,3,1,0,0,0
900,2264,8191,54,2,2,0,1,1,0
901,2264,8559,46,7,2,5,2,0,2
902,2265,8668,55,4,3,1,3,1,2
903,2265,8472,45,3,0,3,0,0,0
904,2266,8455,57,11,6,5,3,1,2
905,2266,8658,43,2,1,1,0,0,0
906,2267,8528,49,4,3,1,1,1,0
907,2267,8655,51,2,0,2,3,1,2
908,2268,10252,51,1,1,0,2,1,1
909,2268,9825,49,11,5,6,0,0,0
910,2269,8654,51,3,1,2,3,1,2
911,2269,8655,49,3,0,3,0,0,0
912,2270,8668,52,4,3,1,2,1,1
913,2270,8528,48,3,1,2,0,0,0
914,2271,10194,48,3,1,2,2,1,1
915,2271,8472,52,4,3,1,5,1,4
916,2272,8462,42,4,2,2,2,2,0
917,2272,8456,58,5,4,1,1,0,1
918,2273,8559,43,4,3,1,1,1,0
919,2273,8650,57,13,4,9,3,1,2
920,2274,8667,48,3,1,2,3,1,2
921,2274,8602,52,4,2,2,0,0,0
922,2276,8191,47,4,3,1,2,2,0
923,2276,8455,53,5,1,4,1,1,0
924,2277,10260,45,3,2,1,2,1,1
925,2277,9825,55,2,0,2,0,0,0
926,2278,8658,51,7,3,4,2,1,1
927,2278,8586,49,10,6,4,4,1,3
928,2279,8462,40,5,4,1,4,2,2
929,2279,10260,60,7,3,4,1,1,0
930,2280,8655,45,4,3,1,1,1,0
931,2280,10194,55,3,0,3,0,0,0
932,2281,8472,53,8,4,4,2,2,0
933,2281,8528,47,6,4,2,1,0,1
934,2282,8586,58,13,5,8,1,0,1
935,2282,10252,42,3,2,1,0,0,0
936,2284,9825,55,7,5,2,5,1,4
937,2284,8455,45,2,0,2,0,0,0
938,2286,8667,52,3,2,1,5,3,2
939,2286,8456,48,7,3,4,2,1,1
940,2287,8650,54,4,2,2,2,2,0
941,2287,8668,46,5,1,4,1,1,0
942,2288,8658,55,9,7,2,3,1,2
943,2288,8602,45,6,3,3,1,0,1
944,2289,9825,49,4,3,1,1,0,1
945,2289,8650,51,6,1,5,0,0,0
946,2292,8602,57,6,5,1,1,0,1
947,2292,8586,43,4,2,2,0,0,0
948,2293,8528,56,8,7,1,4,2,2
949,2293,10194,44,7,3,4,1,1,0
950,2294,8472,52,3,2,1,2,1,1
951,2294,8462,48,7,1,6,2,1,1
952,2295,8655,55,8,5,3,2,1,1
953,2295,8667,45,3,1,2,2,1,1
954,2296,10260,57,7,4,3,1,0,1
955,2296,10252,43,4,2,2,2,0,2
956,2297,8455,70,8,3,5,2,1,1
957,2297,8668,30,4,3,1,0,0,0
958,2298,8456,53,2,2,0,2,1,1
959,2298,8559,47,5,3,2,0,0,0
960,2299,8658,48,7,3,4,1,0,1
961,2299,9879,52,5,2,3,0,0,0
962,2300,8462,54,5,2,3,1,0,1
963,2300,10194,46,3,1,2,0,0,0
964,2301,8654,53,8,4,4,1,1,0
965,2301,8667,47,3,2,1,1,0,1
966,2302,8559,40,8,5,3,5,0,5
967,2302,8655,60,4,1,3,0,0,0
968,2303,8668,51,4,3,1,3,1,2
969,2303,10260,49,2,1,1,1,0,1
970,2304,9825,64,11,4,7,1,1,0
971,2304,8472,36,4,1,3,1,0,1
972,2305,8586,52,9,4,5,3,0,3
973,2305,8528,48,6,3,3,0,0,0
974,2306,8602,42,8,3,5,4,3,1
975,2306,8455,58,1,1,0,1,0,1
976,2307,8456,49,3,0,3,2,1,1
977,2307,8650,51,1,0,1,1,1,0
978,2308,8191,48,5,3,2,2,2,0
979,2308,10252,52,4,1,3,2,1,1
980,2309,8472,49,5,3,2,4,1,3
981,2309,9879,51,1,0,1,0,0,0
982,2310,8586,35,7,1,6,1,1,0
983,2310,8668,65,4,0,4,2,0,2
984,2311,10194,41,4,3,1,4,1,3
985,2311,9825,59,10,2,8,1,1,0
986,2312,8654,40,8,3,5,1,0,1
987,2312,10260,60,8,5,3,0,0,0
988,2313,8655,55,5,3,2,3,2,1
989,2313,8650,45,0,0,0,1,0,1
990,2314,10252,54,4,1,3,2,1,1
991,2314,8667,46,5,2,3,1,1,0
992,2315,8455,51,15,5,10,3,2,1
993,2315,8456,49,4,1,3,1,1,0
994,2317,8191,49,6,2,4,1,1,0
995,2317,8462,51,2,1,1,1,0,1
996,2318,8559,53,8,5,3,2,1,1
997,2318,8602,47,4,3,1,3,1,2
998,2320,8654,56,9,5,4,2,0,2
999,2320,8559,44,6,5,1,0,0,0
1000,2321,8456,52,9,7,2,2,2,0
1001,2321,8586,48,7,2,5,1,0,1
1002,2322,8455,61,6,3,3,1,1,0
1003,2322,8462,39,3,3,0,3,2,1
1004,2323,8667,48,2,1,1,2,0,2
1005,2323,8668,52,6,1,5,1,0,1
1006,2325,10252,49,7,3,4,3,2,1
1007,2325,8472,51,3,1,2,0,0,0
1008,2326,8191,35,4,3,1,2,2,0
1009,2326,9825,65,11,2,9,0,0,0
1010,2327,10260,57,4,3,1,1,1,0
1011,2327,8602,43,7,4,3,3,0,3
1012,2328,9879,53,4,2,2,1,0,1
1013,2328,10194,47,2,1,1,0,0,0
1014,2329,9825,58,15,9,6,2,1,1
1015,2329,8462,42,5,1,4,0,0,0
1016,2330,10252,52,3,3,0,2,2,0
1017,2330,8650,48,15,5,10,0,0,0
1018,2331,8655,47,7,4,3,1,0,1
1019,2331,8472,53,4,3,1,1,0,1
1020,2332,8586,49,9,5,4,6,3,3
1021,2332,8654,51,8,4,4,1,0,1
1022,2333,8456,63,11,8,3,2,1,1
1023,2333,8602,37,4,1,3,0,0,0
1024,2334,8455,60,5,2,3,2,1,1
1025,2334,9879,40,1,0,1,1,0,1
1026,2335,8658,49,5,2,3,1,1,0
1027,2335,10194,51,2,1,1,2,0,2
1028,2336,8667,43,3,2,1,2,1,1
1029,2336,8559,57,12,4,8,3,1,2
1030,2337,8191,39,5,3,2,6,5,1
1031,2337,8668,61,11,7,4,1,0,1
1032,2338,10260,52,9,6,3,1,1,0
1033,2338,8528,48,7,3,4,0,0,0
1034,2339,8655,49,8,4,4,1,0,1
1035,2339,8586,51,4,2,2,1,0,1
1036,2340,8472,49,8,6,2,1,0,1
1037,2340,8456,51,13,1,12,0,0,0
1038,2341,10252,59,4,2,2,1,1,0
1039,2341,10194,41,5,0,5,0,0,0
1040,2342,9879,32,5,3,2,2,1,1
1041,2342,10260,68,16,8,8,1,0,1
1042,2343,8650,60,8,2,6,5,3,2
1043,2343,8462,40,2,0,2,1,1,0
1044,2344,9825,60,7,4,3,1,1,0
1045,2344,8667,40,2,1,1,4,1,3
1046,2345,8658,53,4,3,1,1,1,0
1047,2345,8668,47,6,3,3,0,0,0
1048,2346,8559,48,4,2,2,3,1,2
1049,2346,8528,52,6,4,2,1,0,1
1050,2347,8191,63,11,3,8,2,1,1
1051,2347,8602,37,4,2,2,3,0,3
1052,2348,8455,59,12,6,6,2,2,0
1053,2348,8654,41,3,0,3,2,1,1
1054,2349,8191,47,6,5,1,2,2,0
1055,2349,8528,53,11,2,9,1,0,1
1056,2350,8472,53,7,5,2,1,1,0
1057,2350,8658,47,11,4,7,2,0,2
1058,2351,9825,53,4,2,2,1,1,0
1059,2351,8654,47,4,3,1,3,2,1
1060,2352,10252,54,8,3,5,2,2,0
1061,2352,8602,46,4,1,3,1,0,1
1062,2353,8455,57,8,5,3,3,1,2
1063,2353,8655,43,2,2,0,2,0,2
1064,2354,8462,56,5,2,3,1,0,1
1065,2354,8667,44,1,1,0,0,0,0
1066,2355,8559,35,4,4,0,1,1,0
1067,2355,8668,65,11,4,7,1,0,1
1068,2356,8456,51,5,3,2,4,3,1
1069,2356,9879,49,4,1,3,1,0,1
1070,2357,10260,60,4,2,2,3,0,3
1071,2357,8650,40,1,0,1,1,0,1
1072,2358,8586,55,7,3,4,7,3,4
1073,2358,10194,45,4,4,0,0,0,0
1074,2359,8650,51,15,7,8,4,0,4
1075,2359,8472,49,2,0,2,0,0,0
1076,2361,8462,45,4,3,1,2,2,0
1077,2361,8586,55,7,3,4,2,0,2
1078,2362,10260,55,4,3,1,1,0,1
1079,2362,8559,45,12,7,5,0,0,0
1080,2363,10194,47,6,3,3,1,1,0
1081,2363,8654,53,12,7,5,0,0,0
1082,2364,8668,52,12,4,8,1,1,0
1083,2364,8602,48,2,2,0,0,0,0
1084,2365,9879,53,8,4,4,1,0,1
1085,2365,8667,47,3,2,1,0,0,0
1086,2367,8655,51,5,3,2,3,2,1
1087,2367,8191,49,1,0,1,1,1,0
1088,2368,9825,54,8,3,5,2,2,0
1089,2368,8658,46,3,3,0,1,0,1
1090,2369,8472,52,10,6,4,1,1,0
1091,2369,8586,48,9,3,6,2,1,1
1092,2370,10194,51,2,1,1,2,1,1
1093,2370,8667,49,3,0,3,3,0,3
1094,2371,8462,47,4,4,0,2,1,1
1095,2371,8655,53,8,3,5,0,0,0
1096,2372,8455,44,3,3,0,8,2,6
1097,2372,10260,56,3,2,1,0,0,0
1098,2373,8528,44,7,4,3,2,2,0
1099,2373,9879,56,3,2,1,4,1,3
1100,2374,8668,53,4,2,2,2,1,1
1101,2374,8654,47,3,1,2,2,0,2
1102,2375,8456,71,5,4,1,1,0,1
1103,2375,8191,29,7,3,4,0,0,0
1104,2376,8559,45,6,3,3,3,2,1
1105,2376,10252,55,8,5,3,1,1,0
1106,2377,8650,51,10,5,5,3,2,1
1107,2377,8658,49,3,1,2,1,0,1
1108,2378,9825,61,12,5,7,1,1,0
1109,2378,8602,39,4,0,4,1,1,0
1110,2380,10194,55,4,2,2,3,1,2
1111,2380,8602,45,7,3,4,1,0,1
1112,2381,8528,56,11,4,7,2,0,2
1113,2381,8462,44,2,1,1,1,0,1
1114,2382,9825,63,10,3,7,1,1,0
1115,2382,8586,37,9,2,7,1,0,1
1116,2383,8456,59,6,3,3,1,0,1
1117,2383,8658,41,2,0,2,2,0,2
1118,2384,8650,61,11,5,6,1,1,0
1119,2384,9879,39,2,1,1,1,0,1
1120,2385,8191,54,3,2,1,2,1,1
1121,2385,8667,46,4,1,3,3,1,2
1122,2386,8559,42,4,2,2,2,2,0
1123,2386,8455,58,9,2,7,0,0,0
1124,2387,8655,44,7,3,4,1,1,0
1125,2387,10260,56,7,4,3,0,0,0
1126,2388,8668,51,7,4,3,4,1,3
1127,2388,10252,49,4,3,1,0,0,0
1128,2389,9825,54,7,3,4,5,2,3
1129,2389,8528,46,10,2,8,0,0,0
1130,2390,8455,43,8,4,4,3,1,2
1131,2390,8586,57,12,7,5,2,1,1
1132,2391,8191,42,2,1,1,1,1,0
1133,2391,8472,58,7,4,3,3,2,1
1134,2392,10194,56,4,2,2,3,1,2
1135,2392,8559,44,5,1,4,3,0,3
1136,2393,8462,45,10,5,5,3,1,2
1137,2393,10252,55,6,3,3,1,0,1
1138,2394,8650,65,9,4,5,1,1,0
1139,2394,8654,35,2,1,1,2,0,2
1140,2395,9879,54,2,2,0,1,0,1
1141,2395,8602,46,0,0,0,0,0,0
1142,2396,8668,59,2,1,1,3,2,1
1143,2396,8655,41,10,8,2,2,1,1
1144,2397,8667,49,4,3,1,1,1,0
1145,2397,8658,51,5,4,1,2,1,1
1146,2398,10260,53,5,3,2,1,0,1
1147,2398,8456,47,4,2,2,0,0,0
1148,2401,8655,48,6,2,4,4,1,3
1149,2401,8602,52,5,0,5,3,1,2
1150,2402,8654,48,2,1,1,4,1,3
1151,2402,8528,52,6,2,4,1,0,1
1152,2403,10260,58,7,3,4,3,2,1
1153,2403,8586,42,2,1,1,2,2,0
1154,2404,8455,64,12,7,5,2,2,0
1155,2404,10194,36,2,1,1,0,0,0
1156,2405,8650,52,6,4,2,3,1,2
1157,2405,8191,48,7,2,5,0,0,0
1158,2406,8559,54,7,4,3,2,1,1
1159,2406,8462,46,3,1,2,1,0,1
1160,2407,10252,52,7,6,1,1,0,1
1161,2407,8658,48,10,5,5,1,0,1
1162,2410,8559,42,5,1,4,1,0,1
1163,2410,8586,58,8,5,3,0,0,0
1164,2411,10260,58,8,4,4,3,1,2
1165,2411,8472,42,5,4,1,1,0,1
1166,2412,10194,48,4,2,2,6,2,4
1167,2412,8668,52,8,3,5,1,1,0
1168,2413,8602,45,11,7,4,5,2,3
1169,2413,8462,55,4,2,2,1,1,0
1170,2415,8658,54,4,3,1,3,1,2
1171,2415,8191,46,5,3,2,1,0,1
1172,2416,8655,46,5,3,2,5,1,4
1173,2416,9825,54,4,2,2,2,0,2
1174,2417,9879,57,3,1,2,2,0,2
1175,2417,8654,43,3,2,1,0,0,0
1176,2418,8455,51,8,1,7,1,1,0
1177,2418,8650,49,2,0,2,0,0,0
1178,2421,8528,41,3,2,1,1,0,1
1179,2421,8455,59,3,1,2,0,0,0
1180,2422,8191,52,5,1,4,1,1,0
1181,2422,8586,48,5,1,4,2,1,1
1182,2423,8658,59,5,2,3,2,1,1
1183,2423,8559,41,4,3,1,1,0,1
1184,2424,10252,52,10,7,3,3,1,2
1185,2424,8655,48,2,1,1,1,0,1
1186,2425,9825,52,6,2,4,1,1,0
1187,2425,9879,48,1,0,1,0,0,0
1188,2426,10260,55,11,8,3,2,1,1
1189,2426,10194,45,7,3,4,2,0,2
1190,2427,8456,55,7,4,3,1,0,1
1191,2427,8654,45,6,1,5,1,0,1
1192,2428,8650,53,5,3,2,2,0,2
1193,2428,8667,47,8,4,4,0,0,0
1194,2429,9825,53,4,2,2,2,0,2
1195,2429,10260,47,6,2,4,1,0,1
1196,2430,8586,55,15,10,5,2,1,1
1197,2430,8658,45,4,4,0,2,1,1
1198,2431,9879,44,2,1,1,2,2,0
1199,2431,10252,56,1,1,0,6,3,3
1200,2432,8668,56,14,8,6,2,1,1
1201,2432,8528,44,5,1,4,1,1,0
1202,2433,8602,54,14,8,6,2,1,1
1203,2433,8667,46,2,1,1,0,0,0
1204,2434,8654,46,4,3,1,1,0,1
1205,2434,8655,54,8,3,5,1,0,1
1206,2435,8650,63,13,4,9,2,1,1
1207,2435,8559,37,3,3,0,3,3,0
1208,2436,8462,42,7,3,4,1,1,0
1209,2436,8456,58,7,2,5,2,1,1
1210,2437,8472,51,6,2,4,1,1,0
1211,2437,10194,49,5,1,4,0,0,0
1212,2438,8455,64,17,9,8,1,1,0
1213,2438,8191,36,2,0,2,1,0,1
1214,2439,8650,59,11,7,4,2,2,0
1215,2439,8191,41,4,3,1,1,0,1
1216,2440,8667,45,5,4,1,3,2,1
1217,2440,8472,55,4,1,3,1,1,0
1218,2441,10260,51,12,8,4,3,2,1
1219,2441,8586,49,7,2,5,0,0,0
1220,2442,8456,42,3,1,2,1,1,0
1221,2442,9825,58,7,0,7,0,0,0
1222,2443,8655,58,4,1,3,6,2,4
1223,2443,8602,42,3,1,2,0,0,0
1224,2444,9879,55,10,3,7,2,2,0
1225,2444,8668,45,9,4,5,1,0,1
1226,2445,8658,55,7,3,4,4,3,1
1227,2445,10252,45,4,1,3,1,0,1
1228,2446,8559,48,6,3,3,2,1,1
1229,2446,8462,52,8,2,6,0,0,0
1230,2447,8455,62,14,4,10,1,0,1
1231,2447,10194,38,1,0,1,0,0,0
1232,2448,8654,49,6,4,2,1,1,0
1233,2448,8528,51,6,4,2,2,1,1
1234,2449,8456,40,3,2,1,1,1,0
1235,2449,10260,60,8,0,8,2,1,1
1236,2450,9825,70,10,8,2,2,1,1
1237,2450,8528,30,5,3,2,1,0,1
1238,2451,8650,52,10,4,6,1,1,0
1239,2451,8654,48,4,1,3,0,0,0
1240,2452,10252,52,5,2,3,2,2,0
1241,2452,8462,48,12,3,9,0,0,0
1242,2453,8668,51,9,4,5,1,1,0
1243,2453,8655,49,6,3,3,1,0,1
1244,2454,8602,51,3,0,3,2,0,2
1245,2454,9879,49,5,0,5,2,0,2
1246,2455,10194,52,6,2,4,2,2,0
1247,2455,8559,48,5,1,4,0,0,0
1248,2456,8667,45,8,4,4,2,1,1
1249,2456,8658,55,8,4,4,2,1,1
1250,2458,8586,45,3,2,1,3,1,2
1251,2458,8455,55,13,2,11,2,0,2
1252,2459,8650,54,5,2,3,1,1,0
1253,2459,8667,46,3,3,0,1,0,1
1254,2460,8191,47,8,5,3,3,1,2
1255,2460,8586,53,9,7,2,2,1,1
1256,2461,8455,49,6,4,2,1,0,1
1257,2461,8528,51,8,8,0,1,0,1
1258,2462,8602,45,13,5,8,2,1,1
1259,2462,8472,55,7,4,3,1,0,1
1260,2463,10260,59,5,5,0,3,1,2
1261,2463,10194,41,1,0,1,2,0,2
1262,2464,8462,45,12,6,6,2,0,2
1263,2464,8668,55,8,5,3,0,0,0
1264,2466,9879,45,11,4,7,1,0,1
1265,2466,9825,55,3,1,2,0,0,0
1266,2467,8655,52,9,3,6,3,1,2
1267,2467,10252,48,3,1,2,0,0,0
1268,2468,8658,49,5,2,3,2,2,0
1269,2468,8559,51,4,0,4,3,0,3
1270,2469,10260,54,13,3,10,3,3,0
1271,2469,8472,46,1,1,0,0,0,0
1272,2470,8602,58,5,4,1,2,1,1
1273,2470,8462,42,5,4,1,2,1,1
1274,2471,9879,35,6,4,2,4,3,1
1275,2471,8654,65,11,4,7,1,0,1
1276,2472,10194,48,4,2,2,5,2,3
1277,2472,8668,52,15,9,6,1,0,1
1278,2473,8455,49,9,5,4,3,2,1
1279,2473,8650,51,7,4,3,2,1,1
1280,2474,8191,55,10,7,3,4,1,3
1281,2474,8658,45,5,2,3,2,0,2
1282,2475,8559,53,10,5,5,2,1,1
1283,2475,8586,47,7,1,6,2,0,2
1284,2478,8655,37,4,1,3,1,0,1
1285,2478,9825,63,12,4,8,1,0,1
1286,2480,10260,52,8,2,6,2,1,1
1287,2480,8559,48,10,3,7,1,1,0
1288,2481,9879,63,12,7,5,1,1,0
1289,2481,8667,37,4,0,4,0,0,0
1290,2482,8602,49,9,5,4,1,1,0
1291,2482,8668,51,4,0,4,0,0,0
1292,2483,8655,52,4,2,2,4,4,0
1293,2483,8191,48,3,1,2,0,0,0
1294,2484,10252,43,2,2,0,1,1,0
1295,2484,8455,57,13,3,10,0,0,0
1296,2485,8650,49,7,1,6,1,0,1
1297,2485,8472,51,6,3,3,0,0,0
1298,2486,8528,59,8,4,4,1,0,1
1299,2486,8456,41,4,2,2,0,0,0
1300,2487,8586,45,3,2,1,1,1,0
1301,2487,8462,55,9,4,5,0,0,0
1302,2488,9825,61,12,7,5,2,2,0
1303,2488,8658,39,1,1,0,1,0,1
1304,2489,10252,60,8,3,5,1,0,1
1305,2489,8654,40,3,1,2,1,0,1
1306,2490,8655,42,3,1,2,2,1,1
1307,2490,8668,58,8,4,4,0,0,0
1308,2492,8455,58,7,5,2,1,1,0
1309,2492,8659,42,3,2,1,1,0,1
1310,2497,8602,53,8,4,4,4,2,2
1311,2497,10194,47,3,0,3,0,0,0
1312,2498,8528,56,7,4,3,2,0,2
1313,2498,8483,44,4,3,1,1,0,1
1314,2499,10260,48,8,5,3,2,1,1
1315,2499,8586,52,6,5,1,1,0,1
1316,2500,9825,54,18,6,12,2,2,0
1317,2500,8654,46,5,3,2,2,0,2
1318,2501,8658,44,7,3,4,2,2,0
1319,2501,10252,56,3,0,3,1,0,1
1320,2504,8456,43,4,1,3,2,0,2
1321,2504,8602,57,2,0,2,0,0,0
1322,2505,8655,41,6,5,1,2,1,1
1323,2505,8455,59,5,1,4,0,0,0
1324,2508,8659,43,5,3,2,1,1,0
1325,2508,8483,57,7,0,7,2,1,1
1326,2510,9825,49,6,4,2,3,1,2
1327,2510,10261,51,2,0,2,2,0,2
1328,2511,8455,66,6,2,4,1,1,0
1329,2511,8650,34,4,1,3,1,0,1
1330,2514,10252,48,8,5,3,2,0,2
1331,2514,9879,52,9,4,5,2,0,2
1332,2515,8654,46,9,6,3,1,0,1
1333,2515,8658,54,5,1,4,0,0,0
1334,2517,8659,45,4,2,2,1,0,1
1335,2517,8456,55,5,2,3,0,0,0
1336,2520,8659,48,8,7,1,2,0,2
1337,2520,8654,52,3,2,1,0,0,0
1338,2522,10194,45,6,6,0,2,2,0
1339,2522,8658,55,8,1,7,0,0,0
1340,2523,8650,45,1,1,0,1,1,0
1341,2523,8528,55,10,5,5,2,0,2
1342,2524,10252,41,6,3,3,3,2,1
1343,2524,8483,59,3,1,2,0,0,0
1344,2525,8559,37,3,1,2,2,1,1
1345,2525,8668,63,9,5,4,2,1,1
1346,2532,8668,47,13,5,8,1,1,0
1347,2532,9825,53,5,2,3,1,0,1
1348,2533,10261,65,8,3,5,1,1,0
1349,2533,9879,35,8,7,1,0,0,0
1350,2535,8602,58,7,4,3,2,1,1
1351,2535,8559,42,8,2,6,1,0,1
1352,2536,10194,64,5,4,1,1,0,1
1353,2536,8650,36,6,3,3,0,0,0
1354,2537,8528,55,3,1,2,5,3,2
1355,2537,8659,45,8,3,5,0,0,0
1356,2538,8455,47,5,3,2,3,2,1
1357,2538,8472,53,3,2,1,2,0,2
1358,2540,8586,47,5,3,2,2,1,1
1359,2540,9825,53,6,2,4,2,0,2
1360,2541,8650,62,9,6,3,1,0,1
1361,2541,8654,38,3,2,1,1,0,1
1362,2542,8472,46,4,1,3,3,1,2
1363,2542,8668,54,7,4,3,4,1,3
1364,2544,9879,41,7,4,3,1,0,1
1365,2544,8456,59,3,1,2,1,0,1
1366,2546,8559,51,8,5,3,2,1,1
1367,2546,10261,49,1,0,1,3,1,2
1368,2553,8668,41,2,2,0,1,0,1
1369,2553,8659,59,2,0,2,1,0,1
1370,2555,8472,44,6,1,5,2,0,2
1371,2555,8602,56,6,2,4,0,0,0
1372,2557,8559,43,10,5,5,5,3,2
1373,2557,8483,57,6,2,4,0,0,0
1374,2558,10194,49,9,6,3,4,1,3
1375,2558,8456,51,6,2,4,0,0,0
1376,2559,9825,51,8,6,2,1,1,0
1377,2559,9879,49,5,3,2,0,0,0
1378,2561,8472,57,8,5,3,2,1,1
1379,2561,8654,43,2,1,1,2,0,2
1380,2562,8456,62,11,6,5,1,0,1
1381,2562,8559,38,7,3,4,1,0,1
1382,2567,10194,48,3,1,2,4,2,2
1383,2567,8528,52,6,3,3,0,0,0
1384,2573,8668,53,7,1,6,2,2,0
1385,2573,8528,47,4,1,3,1,0,1
1386,2575,8602,52,9,6,3,1,1,0
1387,2575,8658,48,0,0,0,2,0,2
1388,2578,10194,46,12,5,7,2,2,0
1389,2578,8483,54,3,3,0,4,2,2
1390,2580,8650,55,6,4,2,1,0,1
1391,2580,9879,45,8,2,6,0,0,0
1392,2581,8559,49,8,4,4,2,1,1
1393,2581,8472,51,5,3,2,2,2,0
1394,2582,8456,58,24,10,14,3,3,0
1395,2582,8668,42,1,1,0,1,1,0
1396,2583,8655,55,4,3,1,2,1,1
1397,2583,8654,45,1,1,0,3,1,2
1398,2584,10261,54,4,3,1,3,1,2
1399,2584,8658,46,5,2,3,4,1,3
1400,2585,8602,49,1,1,0,1,0,1
1401,2585,8659,51,11,2,9,0,0,0
1402,2586,8586,59,11,7,4,2,1,1
1403,2586,8483,41,2,0,2,1,0,1
1404,2587,10252,57,9,5,4,2,1,1
1405,2587,8528,43,9,4,5,0,0,0
1406,2591,10252,63,16,5,11,1,1,0
1407,2591,8586,37,6,4,2,1,0,1
1408,2593,10261,55,9,6,3,1,1,0
1409,2593,8456,45,3,1,2,2,1,1
1410,2594,8528,44,5,2,3,1,0,1
1411,2594,8602,56,4,3,1,0,0,0
1412,2595,10194,52,7,3,4,3,2,1
1413,2595,8655,48,8,2,6,1,0,1
1414,2597,8659,55,10,5,5,3,0,3
1415,2597,8559,45,6,2,4,2,0,2
1416,2598,8483,52,4,1,3,2,2,0
1417,2598,8650,48,8,2,6,0,0,0
1418,2600,8559,48,5,3,2,1,1,0
1419,2600,8654,52,6,4,2,1,1,0
1420,2601,8602,39,3,1,2,1,1,0
1421,2601,8668,61,5,4,1,1,0,1
1422,2605,8658,58,6,4,2,4,1,3
1423,2605,8655,42,5,2,3,0,0,0
1424,2606,8472,51,4,2,2,4,1,3
1425,2606,8659,49,3,0,3,0,0,0
1426,2609,8650,55,7,6,1,3,2,1
1427,2609,8602,45,2,0,2,1,0,1
1428,2610,8483,45,2,2,0,1,1,0
1429,2610,8472,55,11,2,9,2,2,0
1430,2616,9879,48,2,1,1,1,1,0
1431,2616,10194,52,11,4,7,0,0,0
1432,2619,8650,56,10,3,7,4,2,2
1433,2619,8559,44,6,0,6,1,0,1
1434,2620,8472,51,6,4,2,3,1,2
1435,2620,8655,49,4,1,3,1,0,1
1436,2625,8659,47,8,5,3,1,0,1
1437,2625,10260,53,1,0,1,0,0,0
1438,2626,10194,38,3,2,1,1,0,1
1439,2626,8668,62,6,3,3,0,0,0
1440,2631,8602,47,2,2,0,1,1,0
1441,2631,8455,53,9,6,3,1,0,1
1442,2633,8483,61,11,5,6,2,1,1
1443,2633,8658,39,5,2,3,1,1,0
1444,2634,10252,57,5,3,2,2,1,1
1445,2634,8472,43,5,1,4,2,0,2
1446,2636,10261,54,4,3,1,3,2,1
1447,2636,8654,46,5,1,4,0,0,0
1448,2637,8655,52,4,3,1,2,1,1
1449,2637,8650,48,4,1,3,0,0,0
1450,2639,8650,52,14,9,5,1,1,0
1451,2639,8668,48,4,2,2,0,0,0
1452,2640,10261,49,2,2,0,4,4,0
1453,2640,8472,51,6,4,2,2,0,2
1454,2643,8456,55,10,5,5,4,1,3
1455,2643,8602,45,5,4,1,0,0,0
1456,2644,8658,48,9,4,5,1,1,0
1457,2644,10252,52,4,0,4,2,1,1
1458,2645,8659,55,9,3,6,2,0,2
1459,2645,8483,45,0,0,0,0,0,0
1460,2647,9879,60,5,2,3,2,2,0
1461,2647,8528,40,3,2,1,4,0,4
1462,2648,8655,41,4,3,1,2,1,1
1463,2648,8455,59,8,1,7,2,0,2
1464,2649,10260,57,4,3,1,4,2,2
1465,2649,8658,43,2,0,2,1,0,1
1466,2650,9825,58,12,10,2,3,1,2
1467,2650,8528,42,1,0,1,1,0,1
1468,2651,10252,45,7,5,2,1,1,0
1469,2651,8456,55,10,4,6,1,1,0
1470,2652,8654,42,4,2,2,3,3,0
1471,2652,8668,58,5,2,3,0,0,0
1472,2653,8586,39,7,4,3,3,3,0
1473,2653,10261,61,5,1,4,2,2,0
1474,2657,8559,38,7,4,3,1,1,0
1475,2657,8455,62,8,3,5,1,1,0
1476,2658,8483,46,9,6,3,1,0,1
1477,2658,8472,54,5,0,5,0,0,0
1478,2660,9825,55,5,1,4,2,0,2
1479,2660,8668,45,6,3,3,0,0,0
1480,2661,8472,37,3,3,0,3,2,1
1481,2661,8455,63,12,3,9,0,0,0
1482,2663,8559,51,6,4,2,2,0,2
1483,2663,8602,49,5,2,3,4,0,4
1484,2664,8659,40,7,3,4,1,1,0
1485,2664,8528,60,4,2,2,1,1,0
1486,2665,8483,48,10,3,7,1,1,0
1487,2665,8654,52,7,6,1,1,0,1
1488,2676,8472,52,6,3,3,1,1,0
1489,2676,10194,48,4,2,2,1,1,0
1490,2677,8655,42,5,4,1,1,0,1
1491,2677,8528,58,4,2,2,0,0,0
1492,2678,8455,52,5,1,4,3,1,2
1493,2678,8650,48,3,1,2,0,0,0
1494,2679,8456,48,8,2,6,2,2,0
1495,2679,10260,52,3,2,1,1,1,0
1496,2680,9825,56,8,4,4,1,1,0
1497,2680,8602,44,1,0,1,0,0,0
1498,2681,8650,56,9,2,7,1,1,0
1499,2681,8528,44,6,3,3,1,1,0
1500,2682,8472,52,8,2,6,1,1,0
1501,2682,8586,48,4,1,3,2,1,1
1502,2683,10261,57,7,2,5,2,0,2
1503,2683,8655,43,2,1,1,1,0,1
1504,2685,10194,48,6,4,2,1,1,0
1505,2685,8658,52,4,2,2,1,0,1
1506,2690,8654,53,10,5,5,1,1,0
1507,2690,8650,47,10,3,7,1,1,0
1508,2691,10252,61,8,6,2,2,2,0
1509,2691,8655,39,1,0,1,1,1,0
1510,2692,8668,58,9,3,6,1,1,0
1511,2692,8472,42,7,2,5,2,0,2
1512,2693,8559,57,9,5,4,3,2,1
1513,2693,10261,43,5,4,1,1,0,1
1514,2694,8456,49,4,2,2,3,1,2
1515,2694,9879,51,3,1,2,1,1,0
1516,2695,8602,60,4,2,2,2,1,1
1517,2695,8483,40,1,1,0,0,0,0
1518,2697,8528,40,5,3,2,3,2,1
1519,2697,10260,60,7,0,7,4,3,1
1520,2698,8455,53,6,3,3,2,1,1
1521,2698,8658,47,4,3,1,2,1,1
1522,2699,8472,40,5,3,2,3,1,2
1523,2699,9825,60,9,4,5,3,1,2
1524,2702,8668,40,7,1,6,3,1,2
1525,2702,10261,60,8,2,6,0,0,0
1526,2703,8456,44,3,1,2,1,0,1
1527,2703,8528,56,4,1,3,1,0,1
1528,2705,9879,52,8,3,5,2,2,0
1529,2705,8655,48,6,4,2,4,0,4
1530,2708,8483,42,5,3,2,2,1,1
1531,2708,8455,58,11,5,6,2,1,1
1532,2710,8650,56,9,2,7,2,1,1
1533,2710,8659,44,6,2,4,0,0,0
1534,2711,8472,43,6,1,5,4,1,3
1535,2711,8456,57,7,3,4,1,1,0
1536,2714,10261,58,10,4,6,1,1,0
1537,2714,8602,42,2,2,0,2,0,2
1538,2715,9825,59,9,4,5,2,1,1
1539,2715,8655,41,12,8,4,1,0,1
1540,2716,8559,54,9,7,2,1,1,0
1541,2716,8658,46,3,1,2,1,1,0
1542,2718,8455,64,8,3,5,1,1,0
1543,2718,10194,36,4,2,2,0,0,0
1544,2720,8650,54,5,3,2,2,1,1
1545,2720,8472,46,3,0,3,2,0,2
1546,2722,8602,48,5,3,2,2,1,1
1547,2722,10252,52,8,2,6,0,0,0
1548,2724,8655,55,6,1,5,4,1,3
1549,2724,8483,45,5,1,4,2,0,2
1550,2726,10261,58,9,3,6,2,1,1
1551,2726,10194,42,1,0,1,2,1,1
1552,2727,8528,54,15,5,10,1,1,0
1553,2727,8658,46,5,3,2,0,0,0
1554,2728,8456,49,2,2,0,2,1,1
1555,2728,8455,51,9,4,5,1,0,1
1556,2729,9825,56,12,6,6,2,1,1
1557,2729,8655,44,2,2,0,1,0,1
1558,2730,10260,64,8,4,4,2,2,0
1559,2730,8654,36,2,1,1,1,0,1
1560,2731,8668,54,7,4,3,1,1,0
1561,2731,10252,46,4,3,1,1,0,1
1562,2732,10261,60,8,6,2,2,1,1
1563,2732,8602,40,11,5,6,1,1,0
1564,2735,8658,46,5,3,2,1,0,1
1565,2735,8559,54,13,6,7,0,0,0
1566,2737,8455,65,13,6,7,1,1,0
1567,2737,10194,35,5,1,4,2,1,1
1568,2740,8650,53,7,3,4,1,1,0
1569,2740,8456,47,4,2,2,2,1,1
1570,2742,8586,55,8,3,5,4,2,2
1571,2742,10194,45,6,2,4,0,0,0
1572,2745,8655,51,6,3,3,2,1,1
1573,2745,8658,49,2,1,1,0,0,0
1574,2748,8455,60,8,3,5,3,3,0
1575,2748,8528,40,7,1,6,0,0,0
1576,2752,8668,54,6,3,3,2,1,1
1577,2752,8655,46,3,1,2,1,0,1
1578,2758,10194,54,5,4,1,2,1,1
1579,2758,8602,46,1,0,1,0,0,0
1580,2761,8472,55,3,1,2,1,1,0
1581,2761,8528,45,7,3,4,3,1,2
1582,2763,10252,52,3,1,2,4,0,4
1583,2763,10194,48,3,2,1,0,0,0
1584,2764,9879,53,7,3,4,3,1,2
1585,2764,8602,47,2,0,2,1,0,1
1586,2767,10261,43,7,4,3,2,1,1
1587,2767,8483,57,6,5,1,2,1,1
1588,2769,10260,54,7,2,5,4,0,4
1589,2769,9825,46,2,0,2,0,0,0
1590,2771,8472,53,6,4,2,2,1,1
1591,2771,9879,47,2,0,2,0,0,0
1592,2772,8456,59,12,5,7,3,2,1
1593,2772,8654,41,3,1,2,0,0,0
1594,2773,8655,43,9,4,5,2,1,1
1595,2773,8559,57,1,1,0,3,1,2
1596,2774,8602,52,4,2,2,1,0,1
1597,2774,8658,48,1,1,0,0,0,0
1598,2777,8668,55,4,1,3,2,1,1
1599,2777,8528,45,10,1,9,3,1,2
1600,2780,8483,46,6,4,2,2,1,1
1601,2780,8586,54,12,5,7,1,0,1
1602,2781,8655,42,4,2,2,1,1,0
1603,2781,8654,58,9,6,3,2,1,1
1604,2782,10252,49,5,3,2,1,1,0
1605,2782,8528,51,2,1,1,0,0,0
1606,2784,10261,65,12,7,5,2,1,1
1607,2784,8658,35,1,0,1,1,1,0
1608,2787,8559,52,7,4,3,3,3,0
1609,2787,8472,48,4,2,2,0,0,0
1610,2788,10194,51,5,1,4,2,0,2
1611,2788,9825,49,6,2,4,1,0,1
1612,2791,8472,57,6,2,4,2,1,1
1613,2791,8602,43,4,0,4,1,0,1
1614,2794,9879,41,13,6,7,3,1,2
1615,2794,8658,59,2,1,1,1,0,1
1616,2796,8559,51,6,2,4,1,1,0
1617,2796,8483,49,2,2,0,2,1,1
1618,2798,10261,43,7,3,4,1,1,0
1619,2798,8455,57,5,2,3,4,2,2
1620,2799,10260,55,7,4,3,4,2,2
1621,2799,8483,45,7,1,6,2,1,1
1622,2801,8654,41,11,9,2,1,1,0
1623,2801,8472,59,9,6,3,0,0,0
1624,2803,8455,51,13,7,6,5,1,4
1625,2803,8668,49,2,1,1,1,0,1
1626,2804,10261,66,8,6,2,4,2,2
1627,2804,8659,34,5,3,2,0,0,0
1628,2806,9825,58,5,3,2,2,2,0
1629,2806,9879,42,2,0,2,1,0,1
1630,2807,8559,41,9,6,3,3,1,2
1631,2807,8456,59,8,5,3,0,0,0
1632,2809,9825,58,13,6,7,1,0,1
1633,2809,8559,42,8,5,3,0,0,0
1634,2817,10194,47,10,4,6,2,2,0
1635,2817,10252,53,5,3,2,1,0,1
1636,2820,9825,52,5,2,3,1,1,0
1637,2820,8472,48,8,3,5,2,1,1
1638,2822,10252,57,8,6,2,4,2,2
1639,2822,8559,43,7,1,6,1,0,1
1640,2823,8668,46,6,3,3,1,1,0
1641,2823,10261,54,3,3,0,2,0,2
1642,2825,8659,51,5,4,1,2,0,2
1643,2825,8658,49,2,1,1,1,0,1
1644,2827,8528,48,2,2,0,2,0,2
1645,2827,8456,52,4,0,4,1,0,1
1646,2829,9825,48,16,6,10,1,1,0
1647,2829,8659,52,5,2,3,1,0,1
1648,2830,8650,54,4,1,3,3,1,2
1649,2830,8472,46,1,0,1,2,0,2
1650,2831,8654,55,9,4,5,1,1,0
1651,2831,8586,45,10,6,4,1,1,0
1652,2832,10261,57,9,4,5,2,1,1
1653,2832,10194,43,3,1,2,2,1,1
1654,2835,8668,54,10,6,4,2,1,1
1655,2835,9879,46,5,2,3,1,0,1
1656,2838,8483,53,6,3,3,2,2,0
1657,2838,8655,47,6,0,6,1,0,1
1658,2839,8483,42,4,4,0,1,0,1
1659,2839,8650,58,8,6,2,0,0,0
1660,2842,8654,46,6,2,4,5,3,2
1661,2842,9879,54,5,2,3,0,0,0
1662,2843,10261,43,4,2,2,3,2,1
1663,2843,8456,57,8,3,5,0,0,0
1664,2846,10194,44,11,9,2,3,2,1
1665,2846,8655,56,4,3,1,3,2,1
1666,2850,9825,59,15,7,8,1,1,0
1667,2850,8658,41,4,3,1,1,1,0
1668,2862,8654,48,1,1,0,2,0,2
1669,2862,10261,52,7,2,5,0,0,0
1670,2863,8456,40,6,3,3,1,0,1
1671,2863,9825,60,8,3,5,1,0,1
1672,2864,8483,43,10,5,5,2,1,1
1673,2864,8658,57,6,4,2,0,0,0
1674,2865,8659,51,6,5,1,5,2,3
1675,2865,9879,49,2,0,2,0,0,0
1676,2866,10260,53,5,2,3,3,0,3
1677,2866,10194,47,2,2,0,0,0,0
1678,2868,8455,55,8,5,3,1,1,0
1679,2868,8602,45,10,4,6,1,0,1
1680,2869,8602,52,2,2,0,1,1,0
1681,2869,8655,48,2,0,2,1,0,1
1682,2872,8456,53,13,7,6,1,0,1
1683,2872,10003,47,3,0,3,0,0,0
1684,2874,10172,47,8,4,4,1,1,0
1685,2874,8559,53,9,1,8,3,1,2
1686,2875,8455,59,10,0,10,4,2,2
1687,2875,10194,41,3,0,3,0,0,0
1688,2884,8472,46,7,3,4,1,1,0
1689,2884,10252,54,3,0,3,1,0,1
1690,2885,10003,62,8,3,5,2,1,1
1691,2885,8559,38,3,3,0,2,0,2
1692,2888,9879,42,2,2,0,1,0,1
1693,2888,8528,58,9,4,5,0,0,0
1694,2889,9825,59,5,2,3,3,2,1
1695,2889,8659,41,4,0,4,1,0,1
1696,2890,9850,52,8,4,4,1,1,0
1697,2890,10252,48,6,4,2,2,0,2
1698,2891,8455,60,6,1,5,1,0,1
1699,2891,8655,40,9,1,8,0,0,0
1700,2897,10172,52,8,4,4,1,0,1
1701,2897,8456,48,5,3,2,0,0,0
1702,2899,8455,54,6,2,4,2,1,1
1703,2899,8650,46,1,1,0,0,0,0
1704,2902,9825,60,12,6,6,3,2,1
1705,2902,9850,40,3,0,3,0,0,0
1706,2904,9879,46,7,3,4,1,1,0
1707,2904,8472,54,7,3,4,2,1,1
1708,2905,10260,47,6,2,4,4,1,3
1709,2905,10003,53,5,1,4,1,0,1
1710,2907,8659,55,6,2,4,2,0,2
1711,2907,8559,45,6,5,1,1,0,1
1712,2911,8455,53,12,5,7,1,0,1
1713,2911,8602,47,3,0,3,1,0,1
1714,2913,10260,70,15,4,11,3,1,2
1715,2913,10261,30,5,3,2,2,0,2
1716,2914,10172,51,5,3,2,1,1,0
1717,2914,9850,49,8,5,3,0,0,0
1718,2915,8655,44,8,5,3,1,1,0
1719,2915,10194,56,2,0,2,1,0,1
1720,2916,8528,51,1,1,0,3,0,3
1721,2916,8472,49,9,8,1,2,0,2
1722,2917,10003,55,3,1,2,2,1,1
1723,2917,10252,45,4,2,2,2,0,2
1724,2918,8586,58,12,5,7,2,1,1
1725,2918,8659,42,5,2,3,0,0,0
1726,2920,8655,48,6,6,0,3,1,2
1727,2920,10003,52,3,1,2,2,2,0
1728,2921,10194,43,3,2,1,2,1,1
1729,2921,8668,57,5,1,4,0,0,0
1730,2923,8456,69,4,1,3,1,1,0
1731,2923,9850,31,2,0,2,3,2,1
1732,2924,10261,51,10,4,6,1,0,1
1733,2924,8455,49,10,4,6,1,0,1
1734,2925,10172,53,2,1,1,2,1,1
1735,2925,8659,47,9,5,4,1,1,0
1736,2926,8586,70,13,6,7,2,1,1
1737,2926,8559,30,7,4,3,1,1,0
1738,2929,8668,52,2,2,0,2,0,2
1739,2929,9825,48,7,5,2,0,0,0
1740,2930,8559,48,10,4,6,1,1,0
1741,2930,10252,52,7,5,2,2,0,2
1742,2931,8456,43,2,1,1,1,0,1
1743,2931,8455,57,8,4,4,2,0,2
1744,2933,10260,58,11,4,7,2,0,2
1745,2933,8602,42,6,1,5,0,0,0
1746,2936,8655,40,2,2,0,2,1,1
1747,2936,8472,60,7,2,5,1,0,1
1748,2937,10003,57,4,3,1,2,1,1
1749,2937,9879,43,7,1,6,0,0,0
1750,2940,8659,56,6,2,4,2,0,2
1751,2940,8655,44,11,4,7,1,0,1
1752,2941,8668,55,17,6,11,1,0,1
1753,2941,9850,45,0,0,0,2,0,2
1754,2944,10261,57,6,2,4,2,1,1
1755,2944,10003,43,0,0,0,3,0,3
1756,2949,10172,45,9,3,6,5,4,1
1757,2949,8472,55,7,2,5,0,0,0
1758,2950,8586,56,9,4,5,3,1,2
1759,2950,8455,44,8,2,6,0,0,0
1760,2952,8602,48,7,3,4,3,1,2
1761,2952,9850,52,12,7,5,0,0,0
1762,2953,10252,57,3,3,0,2,2,0
1763,2953,9825,43,5,2,3,2,0,2
1764,2954,8559,51,2,2,0,2,1,1
1765,2954,8655,49,5,0,5,1,0,1
1766,2955,8668,53,8,5,3,2,2,0
1767,2955,10003,47,3,0,3,0,0,0
1768,2956,10260,69,7,7,0,4,2,2
1769,2956,9879,31,9,1,8,0,0,0
1770,2957,8456,64,14,6,8,1,1,0
1771,2957,10194,36,1,0,1,1,1,0
1772,2958,8659,46,4,2,2,2,1,1
1773,2958,10261,54,9,1,8,0,0,0
1774,2959,8602,27,3,3,0,1,1,0
1775,2959,9825,73,14,5,9,2,1,1
1776,2960,10261,53,5,2,3,1,1,0
1777,2960,8559,47,3,1,2,0,0,0
1778,2961,9879,42,5,3,2,1,1,0
1779,2961,8455,58,16,4,12,1,0,1
1780,2962,8650,65,11,3,8,2,1,1
1781,2962,8655,35,2,1,1,0,0,0
1782,2963,8528,39,5,4,1,2,0,2
1783,2963,10260,61,4,1,3,0,0,0
1784,2964,9850,36,3,3,0,1,1,0
1785,2964,8586,64,8,4,4,0,0,0
1786,2965,10194,49,3,1,2,1,1,0
1787,2965,10252,51,3,1,2,0,0,0
1788,2966,8668,43,2,2,0,1,0,1
1789,2966,8472,57,8,5,3,1,0,1
1790,2967,10172,44,5,3,2,3,1,2
1791,2967,10003,56,3,1,2,1,0,1
1792,2968,8456,57,8,4,4,8,3,5
1793,2968,8659,43,2,2,0,3,2,1
1794,2969,10172,38,5,2,3,5,2,3
1795,2969,9825,62,10,4,6,1,0,1
1796,2971,8455,62,4,3,1,3,2,1
1797,2971,10252,38,6,3,3,0,0,0
1798,2972,8650,55,5,4,1,2,2,0
1799,2972,10261,45,1,0,1,1,0,1
1800,2974,9879,40,6,4,2,1,1,0
1801,2974,9850,60,9,4,5,0,0,0
1802,2975,8528,49,4,4,0,1,1,0
1803,2975,10194,51,1,0,1,2,2,0
1804,2978,8668,55,7,3,4,1,0,1
1805,2978,8659,45,1,1,0,1,0,1
1806,2980,10252,57,3,2,1,3,1,2
1807,2980,8655,43,3,1,2,1,0,1
1808,2982,8659,33,3,1,2,2,0,2
1809,2982,8455,67,12,4,8,0,0,0
1810,2986,8472,49,5,3,2,1,1,0
1811,2986,10261,51,3,2,1,1,0,1
1812,2987,10003,60,8,2,6,2,2,0
1813,2987,8528,40,2,1,1,1,0,1
1814,2989,10252,49,4,3,1,3,2,1
1815,2989,10003,51,2,1,1,3,1,2
1816,2993,8650,51,8,4,4,2,1,1
1817,2993,8456,49,5,4,1,0,0,0
1818,2995,9850,60,5,2,3,2,1,1
1819,2995,10172,40,5,1,4,1,1,0
1820,2997,8528,56,8,5,3,3,1,2
1821,2997,8472,44,3,1,2,1,0,1
1822,2998,8602,37,4,1,3,2,0,2
1823,2998,8455,63,8,7,1,0,0,0
1824,2999,10252,55,8,3,5,2,0,2
1825,2999,8668,45,5,1,4,3,0,3
1826,3000,8655,41,8,5,3,1,0,1
1827,3000,9879,59,8,1,7,0,0,0
1828,3002,10194,40,1,1,0,3,2,1
1829,3002,8650,60,7,2,5,0,0,0
1830,3004,10172,44,6,4,2,2,0,2
1831,3004,10261,56,2,1,1,1,0,1
1832,3011,8655,55,10,7,3,1,1,0
1833,3011,8668,45,9,4,5,1,0,1
1834,3013,8456,57,4,2,2,2,1,1
1835,3013,8586,43,5,2,3,2,1,1
1836,3016,8659,47,3,1,2,2,1,1
1837,3016,10194,53,4,2,2,0,0,0
1838,3017,10003,68,9,4,5,1,1,0
1839,3017,8472,32,5,0,5,2,0,2
1840,3018,8602,48,7,6,1,1,1,0
1841,3018,10252,52,3,2,1,1,0,1
1842,3022,10003,42,3,3,0,3,2,1
1843,3022,8455,58,8,5,3,3,2,1
1844,3025,10172,41,2,1,1,4,1,3
1845,3025,10252,59,15,4,11,0,0,0
1846,3028,8659,44,9,5,4,2,1,1
1847,3028,9879,56,6,4,2,1,1,0
1848,3031,8586,48,5,4,1,2,1,1
1849,3031,8650,52,13,4,9,0,0,0
1850,3032,8456,51,7,4,3,3,2,1
1851,3032,9879,49,6,1,5,0,0,0
1852,3033,10261,51,6,3,3,4,1,3
1853,3033,10252,49,8,5,3,1,0,1
1854,3034,8559,55,6,3,3,2,1,1
1855,3034,9850,45,8,4,4,0,0,0
1856,3035,10172,53,7,2,5,1,1,0
1857,3035,8602,47,4,0,4,0,0,0
1858,3037,10003,47,7,2,5,6,2,4
1859,3037,8659,53,11,5,6,1,0,1
1860,3038,8668,48,4,2,2,1,1,0
1861,3038,8528,52,5,1,4,1,1,0
1862,3041,8528,55,4,2,2,1,0,1
1863,3041,8559,45,4,0,4,2,0,2
1864,3042,8668,44,6,2,4,1,0,1
1865,3042,8455,56,8,7,1,0,0,0
1866,3044,8650,49,4,1,3,4,1,3
1867,3044,10260,51,4,3,1,4,1,3
1868,3045,9825,47,8,4,4,1,1,0
1869,3045,8472,53,4,0,4,0,0,0
1870,3046,10003,55,7,3,4,6,4,2
1871,3046,9850,45,6,3,3,1,0,1
1872,3047,10261,38,6,3,3,3,2,1
1873,3047,8586,62,4,3,1,0,0,0
1874,3051,8650,52,8,5,3,1,1,0
1875,3051,8668,48,6,2,4,1,1,0
1876,3052,8456,68,12,8,4,2,1,1
1877,3052,8655,32,4,1,3,0,0,0
1878,3053,8602,49,7,4,3,4,4,0
1879,3053,10261,51,7,4,3,0,0,0
1880,3054,10260,48,7,3,4,3,1,2
1881,3054,9850,52,7,4,3,3,2,1
1882,3055,10172,45,8,6,2,1,1,0
1883,3055,9879,55,2,2,0,1,0,1
1884,3057,8659,61,10,5,5,1,0,1
1885,3057,8472,39,6,1,5,0,0,0
1886,3064,10172,47,9,4,5,2,1,1
1887,3064,8668,53,3,3,0,4,3,1
1888,3068,10003,47,5,4,1,2,2,0
1889,3068,8528,53,7,1,6,0,0,0
1890,3069,9825,59,9,2,7,2,0,2
1891,3069,10261,41,3,1,2,0,0,0
1892,3073,8668,39,7,6,1,1,0,1
1893,3073,8586,61,8,2,6,0,0,0
1894,3075,9850,45,7,3,4,2,2,0
1895,3075,8528,55,6,4,2,1,0,1
1896,3078,8655,49,7,4,3,1,0,1
1897,3078,8602,51,7,1,6,0,0,0
1898,3080,8655,49,4,2,2,2,1,1
1899,3080,8472,51,1,0,1,0,0,0
1900,3081,9825,51,7,3,4,3,2,1
1901,3081,8668,49,3,0,3,2,2,0
1902,3084,10261,49,8,4,4,2,1,1
1903,3084,9850,51,3,1,2,3,2,1
1904,3087,8528,57,10,3,7,1,1,0
1905,3087,8659,43,2,2,0,0,0,0
1906,3089,10252,48,7,1,6,6,4,2
1907,3089,8602,52,1,1,0,0,0,0
1908,3091,8455,68,7,4,3,1,1,0
1909,3091,9850,32,6,5,1,1,1,0
1910,3093,10260,59,7,3,4,4,2,2
1911,3093,9825,41,8,3,5,0,0,0
1912,3096,8456,52,8,6,2,2,1,1
1913,3096,8586,48,12,6,6,0,0,0
1914,3099,9825,61,10,7,3,1,1,0
1915,3099,10252,39,1,0,1,3,1,2
1916,3100,8559,54,3,1,2,2,1,1
1917,3100,8655,46,2,1,1,2,0,2
1918,3101,8586,55,5,1,4,3,2,1
1919,3101,8455,45,2,0,2,0,0,0
1920,3103,10260,60,15,7,8,3,2,1
1921,3103,9879,40,5,5,0,0,0,0
1922,3104,8602,36,4,1,3,3,0,3
1923,3104,9850,64,9,6,3,0,0,0
1924,3105,10194,47,4,2,2,4,2,2
1925,3105,8456,53,7,2,5,1,0,1
1926,3106,8472,57,5,3,2,2,0,2
1927,3106,10172,43,5,4,1,0,0,0
1928,3107,10003,54,4,3,1,2,0,2
1929,3107,8668,46,5,1,4,0,0,0
1930,3111,8668,53,7,2,5,1,1,0
1931,3111,8659,47,4,3,1,0,0,0
1932,3112,9879,53,8,4,4,2,2,0
1933,3112,9850,47,6,2,4,1,0,1
1934,3113,8472,47,2,1,1,4,0,4
1935,3113,8456,53,11,3,8,0,0,0
1936,3114,8650,52,6,1,5,6,3,3
1937,3114,10261,48,2,1,1,0,0,0
1938,3115,9825,47,7,2,5,2,2,0
1939,3115,10172,53,6,3,3,2,2,0
1940,3116,8586,42,7,1,6,2,1,1
1941,3116,10003,58,5,1,4,2,1,1
1942,3117,8528,59,10,5,5,3,2,1
1943,3117,10194,41,0,0,0,1,0,1
1944,3118,8602,51,12,8,4,4,1,3
1945,3118,8559,49,9,2,7,1,0,1
1946,3119,9825,60,3,1,2,3,2,1
1947,3119,8456,40,3,1,2,1,1,0
1948,3120,8559,45,8,4,4,2,2,0
1949,3120,9879,55,2,0,2,3,1,2
1950,3121,8455,51,7,4,3,3,1,2
1951,3121,8528,49,4,3,1,1,1,0
1952,3122,8650,53,4,2,2,1,1,0
1953,3122,10252,47,2,1,1,4,3,1
1954,3124,8668,51,6,3,3,2,1,1
1955,3124,9850,49,9,1,8,1,1,0
1956,3127,10003,69,9,4,5,3,1,2
1957,3127,10261,31,2,2,0,1,0,1
1958,3128,8659,48,5,3,2,1,1,0
1959,3128,8655,52,12,5,7,0,0,0
1960,3129,10252,47,4,2,2,1,0,1
1961,3129,10194,53,3,3,0,0,0,0
1962,3130,8650,48,8,4,4,5,2,3
1963,3130,8655,52,6,1,5,0,0,0
1964,3133,8456,64,10,5,5,4,2,2
1965,3133,8659,36,2,1,1,2,0,2
1966,3136,8586,53,9,5,4,4,1,3
1967,3136,9850,47,5,3,2,0,0,0
1968,3137,8528,53,8,5,3,1,1,0
1969,3137,10260,47,3,1,2,0,0,0
1970,3138,9825,73,10,3,7,2,2,0
1971,3138,8602,27,5,0,5,0,0,0
1972,3140,8559,45,6,3,3,2,1,1
1973,3140,8586,55,5,3,2,2,0,2
1974,3141,8455,52,6,1,5,1,1,0
1975,3141,10261,48,3,3,0,1,0,1
1976,3142,9879,42,5,1,4,3,2,1
1977,3142,8650,58,5,3,2,1,0,1
1978,3144,8456,54,9,1,8,1,1,0
1979,3144,9850,46,9,6,3,0,0,0
1980,3152,10003,51,10,5,5,1,0,1
1981,3152,8559,49,3,3,0,0,0,0
1982,3153,9879,53,6,3,3,1,0,1
1983,3153,8528,47,3,2,1,0,0,0
1984,3154,8650,62,19,7,12,4,2,2
1985,3154,8659,38,5,4,1,3,2,1
1986,3155,8668,46,6,4,2,3,1,2
1987,3155,10260,54,8,4,4,2,0,2
1988,3157,8586,56,11,6,5,1,1,0
1989,3157,10172,44,4,2,2,2,0,2
1990,3159,8455,64,11,7,4,1,1,0
1991,3159,10172,36,5,3,2,0,0,0
1992,3162,8650,61,6,2,4,2,1,1
1993,3162,9850,39,2,0,2,5,3,2
1994,3163,9825,57,9,3,6,3,0,3
1995,3163,10194,43,1,0,1,1,0,1
1996,3166,8586,64,7,5,2,3,0,3
1997,3166,8655,36,0,0,0,0,0,0
1998,3168,8528,52,5,3,2,5,1,4
1999,3168,10261,48,3,1,2,0,0,0
2000,3169,9850,40,2,1,1,2,0,2
2001,3169,9825,60,9,1,8,1,0,1
2002,3170,8586,63,9,3,6,1,1,0
2003,3170,10252,37,2,2,0,1,0,1
2004,3171,8528,64,7,3,4,1,1,0
2005,3171,8655,36,4,0,4,0,0,0
2006,3174,8650,48,9,6,3,1,0,1
2007,3174,8455,52,2,1,1,3,0,3
2008,3175,10260,54,16,10,6,1,1,0
2009,3175,10003,46,7,3,4,5,0,5
2010,3176,8456,54,10,8,2,1,1,0
2011,3176,10261,46,7,5,2,0,0,0
2012,3177,10172,53,11,5,6,1,0,1
2013,3177,10194,47,1,0,1,2,0,2
2014,3178,8668,54,9,4,5,3,3,0
2015,3178,8602,46,1,0,1,1,1,0
2016,3179,8655,44,5,2,3,1,1,0
2017,3179,8455,56,5,2,3,1,1,0
2018,3185,10003,63,8,6,2,2,0,2
2019,3185,8650,37,8,2,6,0,0,0
2020,3186,8586,54,7,4,3,1,1,0
2021,3186,9879,46,6,2,4,0,0,0
2022,3187,9825,60,6,5,1,1,1,0
2023,3187,8659,40,7,1,6,1,1,0
2024,3188,8528,56,5,1,4,3,2,1
2025,3188,8602,44,5,3,2,0,0,0
2026,3189,9825,59,7,4,3,2,2,0
2027,3189,10003,41,6,4,2,1,1,0
2028,3190,8559,43,8,4,4,1,1,0
2029,3190,10260,57,6,1,5,3,0,3
2030,3192,8655,45,5,2,3,2,1,1
2031,3192,9879,55,8,1,7,0,0,0
2032,3193,8456,58,6,3,3,1,0,1
2033,3193,8528,42,7,3,4,2,0,2
2034,3194,9850,48,5,4,1,2,1,1
2035,3194,8659,52,5,3,2,1,0,1
2036,3195,10172,52,6,4,2,3,2,1
2037,3195,10261,48,4,2,2,2,0,2
2038,3202,8668,52,6,5,1,1,0,1
2039,3202,8528,48,2,0,2,0,0,0
2040,3203,8456,54,9,4,5,4,3,1
2041,3203,9879,46,8,4,4,4,0,4
2042,3206,10003,54,3,2,1,3,2,1
2043,3206,8659,46,13,5,8,1,0,1
2044,3208,10172,59,9,8,1,3,2,1
2045,3208,8602,41,3,0,3,1,0,1
2046,3209,8559,39,2,1,1,2,1,1
2047,3209,9825,61,13,4,9,0,0,0
2048,3210,8455,49,5,3,2,1,0,1
2049,3210,10003,51,2,0,2,0,0,0
2050,3212,8456,60,8,2,6,4,2,2
2051,3212,8668,40,4,0,4,0,0,0
2052,3215,10172,54,6,3,3,1,0,1
2053,3215,10252,46,4,2,2,0,0,0
2054,3217,8659,43,4,2,2,1,0,1
2055,3217,9879,57,6,5,1,0,0,0
2056,3218,8586,61,7,2,5,1,1,0
2057,3218,8528,39,3,0,3,0,0,0
2058,3220,8456,62,6,4,2,1,1,0
2059,3220,8655,38,3,1,2,5,1,4
2060,3223,10172,43,10,5,5,4,0,4
2061,3223,9879,57,8,5,3,0,0,0
2062,3225,8659,49,3,2,1,2,0,2
2063,3225,8472,51,6,5,1,1,0,1
2064,3229,9825,58,8,1,7,1,1,0
2065,3229,8472,42,2,1,1,0,0,0
2066,3230,8668,39,3,2,1,1,0,1
2067,3230,8455,61,2,0,2,0,0,0
2068,3232,10252,43,5,3,2,1,1,0
2069,3232,8456,57,5,3,2,3,2,1
2070,3234,9850,39,3,1,2,1,0,1
2071,3234,10003,61,5,4,1,0,0,0
2072,3238,8559,54,10,5,5,2,0,2
2073,3238,8528,46,9,3,6,1,0,1
2074,3239,10194,40,2,0,2,7,1,6
2075,3239,9825,60,1,0,1,3,1,2
2076,3240,10252,47,2,1,1,3,1,2
2077,3240,8659,53,5,3,2,0,0,0
2078,3241,8655,63,7,5,2,3,2,1
2079,3241,8586,37,5,3,2,4,1,3
2080,3243,8668,49,4,1,3,1,1,0
2081,3243,9879,51,6,4,2,0,0,0
2082,3247,8455,51,5,1,4,2,2,0
2083,3247,10172,49,4,1,3,4,2,2
2084,3249,8472,48,3,3,0,2,1,1
2085,3249,9825,52,11,4,7,1,0,1
2086,3250,10260,56,9,6,3,3,2,1
2087,3250,8668,44,7,5,2,0,0,0
2088,3251,9850,44,4,1,3,3,1,2
2089,3251,9879,56,8,5,3,0,0,0
2090,3252,8466,31,4,1,3,1,1,0
2091,3252,8456,69,10,5,5,2,1,1
2092,3256,8650,62,7,4,3,2,1,1
2093,3256,8659,38,3,0,3,2,1,1
2094,3257,10252,52,5,2,3,2,1,1
2095,3257,8654,48,4,2,2,1,0,1
2096,3258,8528,53,4,3,1,3,3,0
2097,3258,8455,47,2,0,2,0,0,0
2098,3259,8668,59,14,8,6,1,1,0
2099,3259,9879,41,7,4,3,1,0,1
2100,3260,8650,58,11,4,7,2,1,1
2101,3260,10261,42,2,0,2,1,0,1
2102,3261,10260,48,6,3,3,2,1,1
2103,3261,9825,52,1,0,1,3,0,3
2104,3262,9850,52,11,6,5,3,1,2
2105,3262,10194,48,3,1,2,0,0,0
2106,3264,8472,54,3,1,2,4,2,2
2107,3264,10252,46,4,3,1,1,0,1
2108,3266,8586,49,8,1,7,2,1,1
2109,3266,8528,51,4,3,1,0,0,0
2110,3268,8456,58,11,4,7,1,1,0
2111,3268,8654,42,0,0,0,2,0,2
2112,3269,9825,60,6,1,5,1,1,0
2113,3269,9879,40,3,0,3,1,0,1
2114,3270,10260,66,8,5,3,2,2,0
2115,3270,10252,34,3,1,2,2,0,2
2116,3273,8456,55,5,3,2,1,1,0
2117,3273,8586,45,1,0,1,1,0,1
2118,3274,10261,52,9,4,5,4,4,0
2119,3274,8654,48,4,0,4,1,0,1
2120,3275,9850,44,3,1,2,2,1,1
2121,3275,9798,56,2,1,1,2,0,2
2122,3279,8586,46,4,2,2,2,2,0
2123,3279,9825,54,5,3,2,1,0,1
2124,3280,8472,54,4,1,3,1,1,0
2125,3280,9879,46,9,3,6,1,0,1
2126,3281,8650,56,7,4,3,2,1,1
2127,3281,8528,44,3,2,1,2,0,2
2128,3282,10252,40,8,5,3,3,2,1
2129,3282,8456,60,8,7,1,3,1,2
2130,3283,10261,52,13,5,8,3,1,2
2131,3283,10003,48,6,4,2,2,0,2
2132,3288,10194,46,5,2,3,1,0,1
2133,3288,8654,54,8,3,5,0,0,0
2134,3289,10252,55,5,3,2,1,0,1
2135,3289,9825,45,6,3,3,0,0,0
2136,3292,10260,60,7,3,4,2,1,1
2137,3292,10172,40,7,2,5,2,0,2
2138,3298,8528,58,9,4,5,1,0,1
2139,3298,9798,42,9,4,5,2,0,2
2140,3300,10260,52,11,3,8,2,2,0
2141,3300,8654,48,3,0,3,0,0,0
2142,3302,10261,47,6,1,5,2,0,2
2143,3302,10194,53,3,1,2,1,0,1
2144,3303,10172,51,10,7,3,2,1,1
2145,3303,8472,49,7,4,3,1,1,0
2146,3304,10003,64,4,1,3,1,1,0
2147,3304,8659,36,0,0,0,1,0,1
2148,3308,8668,53,8,3,5,1,0,1
2149,3308,9825,47,9,1,8,2,0,2
2150,3309,10003,49,7,4,3,3,1,2
2151,3309,9825,51,9,2,7,3,2,1
2152,3311,8650,67,13,7,6,3,2,1
2153,3311,8466,33,5,1,4,0,0,0
2154,3312,8456,56,6,3,3,2,1,1
2155,3312,8668,44,4,2,2,1,0,1
2156,3313,8528,46,3,2,1,3,1,2
2157,3313,10261,54,7,4,3,2,1,1
2158,3314,9850,51,2,1,1,1,1,0
2159,3314,8472,49,6,1,5,0,0,0
2160,3318,8455,55,7,2,5,1,1,0
2161,3318,8654,45,8,2,6,0,0,0
2162,3319,9825,52,6,2,4,2,1,1
2163,3319,8659,48,2,0,2,1,1,0
2164,3321,8668,45,8,3,5,1,1,0
2165,3321,8586,55,7,4,3,0,0,0
2166,3322,9879,49,6,3,3,1,0,1
2167,3322,10261,51,11,5,6,0,0,0
2168,3323,8456,53,8,2,6,2,2,0
2169,3323,10260,47,1,1,0,1,0,1
2170,3324,8466,53,9,6,3,3,1,2
2171,3324,9798,47,2,1,1,2,1,1
2172,3326,9850,46,8,5,3,1,0,1
2173,3326,10003,54,2,1,1,0,0,0
2174,3330,10252,42,3,1,2,1,1,0
2175,3330,8650,58,16,5,11,3,1,2
2176,3332,10261,54,6,4,2,3,3,0
2177,3332,8456,46,6,3,3,0,0,0
2178,3336,8668,52,4,3,1,2,1,1
2179,3336,10194,48,8,2,6,2,1,1
2180,3337,8586,61,13,9,4,4,1,3
2181,3337,10003,39,0,0,0,2,2,0
2182,3340,8650,60,5,2,3,3,1,2
2183,3340,9879,40,5,1,4,1,0,1
2184,3341,8456,62,9,4,5,2,2,0
2185,3341,9798,38,1,0,1,2,1,1
2186,3342,10172,43,5,2,3,2,0,2
2187,3342,10261,57,6,0,6,0,0,0
2188,3343,8472,48,5,4,1,2,1,1
2189,3343,8466,52,6,3,3,2,1,1
2190,3349,9825,63,12,5,7,2,1,1
2191,3349,8654,37,2,2,0,3,1,2
2192,3350,8586,62,11,10,1,2,1,1
2193,3350,10252,38,2,0,2,0,0,0
2194,3351,8528,44,8,5,3,2,1,1
2195,3351,8668,56,8,3,5,0,0,0
2196,3354,9850,40,2,1,1,1,1,0
2197,3354,8455,60,8,2,6,0,0,0
2198,3356,10003,73,3,0,3,3,2,1
2199,3356,9798,27,1,0,1,1,1,0
2200,3357,8650,53,9,4,5,2,0,2
2201,3357,10194,47,6,3,3,0,0,0
2202,3358,8456,67,14,4,10,2,1,1
2203,3358,8472,33,5,3,2,1,0,1
2204,3368,8586,59,11,4,7,4,1,3
2205,3368,8659,41,7,0,7,1,0,1
2206,3369,10261,42,5,4,1,1,1,0
2207,3369,9825,58,3,1,2,2,0,2
2208,3370,10252,47,4,2,2,1,1,0
2209,3370,8528,53,3,0,3,0,0,0
2210,3374,8456,49,7,2,5,2,2,0
2211,3374,9850,51,4,0,4,4,2,2
2212,3376,8654,61,7,3,4,4,2,2
2213,3376,9798,39,0,0,0,0,0,0
2214,3377,10194,56,5,1,4,3,2,1
2215,3377,8466,44,5,3,2,1,0,1
2216,3378,8586,54,9,4,5,1,0,1
2217,3378,8472,46,4,2,2,0,0,0
2218,3380,8472,37,6,6,0,3,0,3
2219,3380,8650,63,14,7,7,0,0,0
2220,3381,8456,67,5,3,2,3,2,1
2221,3381,10194,33,1,0,1,2,1,1
2222,3382,8668,45,12,8,4,3,1,2
2223,3382,10261,55,10,0,10,1,0,1
2224,3384,10252,34,5,3,2,2,0,2
2225,3384,10003,66,11,4,7,0,0,0
2226,3386,9879,53,3,1,2,2,1,1
2227,3386,8659,47,7,0,7,0,0,0
2228,3389,8456,55,6,4,2,1,0,1
2229,3389,9825,45,4,1,3,1,0,1
2230,3392,8528,42,8,3,5,2,0,2
2231,3392,9879,58,4,2,2,1,0,1
2232,3393,10260,58,6,2,4,2,1,1
2233,3393,8650,42,5,0,5,0,0,0
2234,3395,8586,60,9,3,6,1,1,0
2235,3395,10172,40,2,2,0,0,0,0
2236,3396,8659,58,3,1,2,1,1,0
2237,3396,9798,42,5,1,4,1,0,1
2238,3398,8472,58,8,3,5,2,1,1
2239,3398,8654,42,4,1,3,0,0,0
2240,3400,9850,40,2,2,0,1,1,0
2241,3400,8650,60,8,6,2,1,1,0
2242,3401,8456,54,8,5,3,6,2,4
2243,3401,9879,46,0,0,0,1,1,0
2244,3402,10261,55,9,8,1,2,2,0
2245,3402,9798,45,0,0,0,0,0,0
2246,3403,8668,42,6,2,4,1,1,0
2247,3403,8466,58,7,5,2,0,0,0
2248,3405,8586,52,16,6,10,6,2,4
2249,3405,10260,48,3,1,2,0,0,0
2250,3406,8659,46,7,4,3,3,1,2
2251,3406,10252,54,5,3,2,0,0,0
2252,3407,8654,60,14,4,10,1,1,0
2253,3407,10172,40,4,1,3,3,1,2
2254,3408,8528,56,9,4,5,1,0,1
2255,3408,8472,44,7,3,4,0,0,0
2256,3409,8650,43,4,3,1,2,0,2
2257,3409,9825,57,7,4,3,1,0,1
2258,3410,10261,56,5,3,2,1,1,0
2259,3410,10252,44,8,3,5,1,0,1
2260,3412,8586,56,8,2,6,2,1,1
2261,3412,9850,44,3,1,2,3,1,2
2262,3414,8455,68,4,1,3,1,1,0
2263,3414,9798,32,0,0,0,2,0,2
2264,3416,10003,54,8,4,4,2,1,1
2265,3416,8472,46,1,0,1,0,0,0
2266,3420,8668,64,8,3,5,2,1,1
2267,3420,10252,36,0,0,0,1,0,1
2268,3423,10261,43,11,8,3,3,1,2
2269,3423,8455,57,6,2,4,1,0,1
2270,3424,9850,48,9,1,8,1,1,0
2271,3424,10172,52,5,0,5,0,0,0
2272,3427,8654,44,5,3,2,3,1,2
2273,3427,10003,56,4,1,3,2,1,1
2274,3428,8466,45,12,4,8,3,1,2
2275,3428,8528,55,2,2,0,0,0,0
2276,3431,8650,59,14,5,9,4,2,2
2277,3431,8659,41,2,0,2,2,0,2
2278,3432,8668,47,8,7,1,3,2,1
2279,3432,10260,53,4,0,4,1,1,0
2280,3433,9850,44,8,2,6,3,3,0
2281,3433,9879,56,4,1,3,4,2,2
2282,3435,10194,57,10,7,3,2,1,1
2283,3435,9798,43,3,0,3,0,0,0
2284,3438,10261,49,5,1,4,5,1,4
2285,3438,8586,51,7,1,6,0,0,0
2286,3440,9879,55,7,5,2,3,1,2
2287,3440,10194,45,2,0,2,1,0,1
2288,3442,8456,49,7,6,1,1,1,0
2289,3442,8455,51,4,0,4,1,1,0
2290,3443,8466,42,3,2,1,1,1,0
2291,3443,10261,58,4,3,1,1,0,1
2292,3446,8528,61,7,3,4,1,0,1
2293,3446,9798,39,1,0,1,0,0,0
2294,3447,8472,51,4,2,2,1,0,1
2295,3447,8659,49,3,1,2,2,0,2
2296,3448,8654,35,8,4,4,1,1,0
2297,3448,8586,65,12,4,8,1,0,1
2298,3449,10252,46,3,2,1,2,1,1
2299,3449,8456,54,10,5,5,1,0,1
2300,3450,8455,53,19,10,9,1,1,0
2301,3450,8659,47,5,1,4,1,0,1
2302,3453,10172,41,3,1,2,1,0,1
2303,3453,8466,59,11,5,6,1,0,1
2304,3454,8654,51,8,5,3,1,1,0
2305,3454,10194,49,7,2,5,3,3,0
2306,3456,10003,52,5,2,3,3,2,1
2307,3456,10261,48,5,2,3,2,0,2
2308,3457,9825,48,6,4,2,4,2,2
2309,3457,8586,52,5,2,3,3,0,3
2310,3461,8586,59,7,4,3,1,0,1
2311,3461,8650,41,3,3,0,0,0,0
2312,3464,8466,54,8,4,4,3,1,2
2313,3464,9850,46,4,4,0,0,0,0
2314,3465,10172,45,5,4,1,3,2,1
2315,3465,8472,55,2,0,2,0,0,0
2316,3466,9798,45,4,1,3,3,1,2
2317,3466,10252,55,4,1,3,1,0,1
2318,3468,8654,43,2,2,0,2,2,0
2319,3468,10260,57,8,1,7,2,0,2
2320,3469,8455,60,9,4,5,1,1,0
2321,3469,9798,40,3,1,2,3,1,2
2322,3471,8456,53,6,5,1,2,2,0
2323,3471,10172,47,5,2,3,2,1,1
2324,3474,10003,59,8,3,5,1,0,1
2325,3474,8472,41,3,1,2,0,0,0
2326,3476,8668,37,7,4,3,1,1,0
2327,3476,8659,63,4,0,4,0,0,0
2328,3478,8528,61,7,3,4,2,1,1
2329,3478,10194,39,9,4,5,0,0,0
2330,3479,10172,41,7,6,1,2,0,2
2331,3479,10252,59,5,1,4,1,0,1
2332,3480,8455,48,11,5,6,4,1,3
2333,3480,8654,52,9,2,7,2,0,2
2334,3481,8668,55,4,3,1,1,0,1
2335,3481,8456,45,13,3,10,2,0,2
2336,3482,10260,58,6,4,2,4,0,4
2337,3482,9798,42,3,0,3,1,0,1
2338,3483,8466,56,9,6,3,3,2,1
2339,3483,8650,44,8,4,4,2,1,1
2340,3486,9825,54,6,3,3,3,3,0
2341,3486,10003,46,1,0,1,2,1,1
2342,3488,10261,48,3,2,1,2,2,0
2343,3488,8528,52,6,2,4,1,0,1
2344,3489,9825,69,8,6,2,2,1,1
2345,3489,9798,31,3,2,1,1,0,1
2346,3490,8650,55,12,9,3,1,1,0
2347,3490,10252,45,6,3,3,4,2,2
2348,3491,10194,46,7,4,3,1,0,1
2349,3491,8668,54,10,6,4,0,0,0
2350,3492,9879,57,3,2,1,1,1,0
2351,3492,10172,43,8,3,5,1,0,1
2352,3493,8456,64,10,4,6,1,0,1
2353,3493,10261,36,1,0,1,0,0,0
2354,3497,8659,52,10,4,6,2,1,1
2355,3497,8654,48,5,2,3,0,0,0
2356,3498,9850,54,5,2,3,2,1,1
2357,3498,8528,46,4,1,3,0,0,0
2358,3501,10260,51,7,2,5,1,0,1
2359,3501,8456,49,5,3,2,0,0,0
2360,3503,10003,65,9,4,5,2,2,0
2361,3503,9850,35,4,1,3,5,2,3
2362,3506,10194,48,6,3,3,2,0,2
2363,3506,10252,52,5,3,2,0,0,0
2364,3510,10252,51,7,3,4,1,1,0
2365,3510,9879,49,3,1,2,1,1,0
2366,3512,8668,60,9,2,7,1,1,0
2367,3512,10172,40,7,2,5,3,2,1
2368,3516,8466,57,13,6,7,1,1,0
2369,3516,8654,43,4,3,1,0,0,0
2370,3522,9850,45,5,2,3,1,1,0
2371,3522,9798,55,5,2,3,3,0,3
2372,3523,10172,54,8,4,4,4,3,1
2373,3523,10194,46,7,5,2,1,0,1
2374,3524,8472,51,4,3,1,3,2,1
2375,3524,8668,49,7,3,4,3,0,3
2376,3527,8659,59,3,1,2,1,1,0
2377,3527,10261,41,5,4,1,0,0,0
2378,3528,8528,56,10,3,7,2,1,1
2379,3528,8654,44,7,5,2,0,0,0
2380,3529,9825,45,9,4,5,2,0,2
2381,3529,10260,55,5,2,3,1,0,1
2382,3530,8472,39,5,3,2,1,0,1
2383,3530,10252,61,6,3,3,0,0,0
2384,3531,8455,60,17,9,8,5,2,3
2385,3531,10003,40,6,2,4,1,1,0
2386,3532,8668,60,10,5,5,2,2,0
2387,3532,9879,40,5,4,1,1,0,1
2388,3534,8650,49,5,2,3,2,2,0
2389,3534,10261,51,4,0,4,2,0,2
2390,3535,9798,54,6,4,2,3,2,1
2391,3535,10172,46,5,0,5,0,0,0
2392,3536,8659,45,6,5,1,1,1,0
2393,3536,8466,55,4,3,1,3,0,3
2394,3538,8586,47,6,1,5,4,1,3
2395,3538,8528,53,2,0,2,0,0,0
2396,3540,8650,51,7,1,6,2,1,1
2397,3540,8668,49,2,0,2,2,1,1
2398,3541,8455,52,6,4,2,3,1,2
2399,3541,10260,48,3,3,0,0,0,0
2400,3542,9850,57,5,5,0,2,1,1
2401,3542,10252,43,5,2,3,1,0,1
2402,3544,10194,41,6,2,4,1,1,0
2403,3544,8472,59,5,1,4,0,0,0
2404,3545,8456,48,7,6,1,2,1,1
2405,3545,10003,52,1,1,0,2,1,1
2406,3547,8659,47,10,4,6,1,0,1
2407,3547,8528,53,5,4,1,0,0,0
2408,3550,8455,56,9,6,3,3,1,2
2409,3550,10252,44,7,3,4,2,0,2
2410,3551,8668,60,11,4,7,4,1,3
2411,3551,8654,40,2,1,1,3,2,1
2412,3553,10260,55,5,4,1,4,2,2
2413,3553,10003,45,3,0,3,1,0,1
2414,3554,9850,48,5,3,2,1,1,0
2415,3554,8659,52,6,1,5,0,0,0
2416,3560,8650,61,19,9,10,1,0,1
2417,3560,10172,39,4,3,1,1,0,1
2418,3561,9850,51,6,5,1,2,2,0
2419,3561,8456,49,3,1,2,0,0,0
2420,3564,10003,66,13,2,11,1,1,0
2421,3564,9879,34,1,0,1,4,0,4
2422,3567,9798,46,4,2,2,1,0,1
2423,3567,8654,54,6,2,4,1,0,1
2424,3568,10252,47,4,4,0,2,1,1
2425,3568,8528,53,8,3,5,3,1,2
2426,3569,8466,40,6,3,3,2,1,1
2427,3569,9825,60,10,5,5,1,1,0
2428,3570,10252,49,10,4,6,2,1,1
2429,3570,10003,51,3,2,1,0,0,0
2430,3573,10260,55,6,4,2,2,2,0
2431,3573,8528,45,4,0,4,1,1,0
2432,3574,8654,48,5,5,0,4,1,3
2433,3574,9850,52,16,8,8,1,0,1
2434,3576,8586,58,8,5,3,1,1,0
2435,3576,9798,42,1,0,1,1,0,1
2436,3577,10194,46,3,2,1,2,1,1
2437,3577,8456,54,9,3,6,1,1,0
2438,3578,8650,55,8,4,4,5,2,3
2439,3578,8472,45,3,0,3,1,0,1
2440,3579,8455,52,10,6,4,3,3,0
2441,3579,10194,48,3,2,1,1,0,1
2442,3580,8650,54,7,4,3,2,0,2
2443,3580,10260,46,4,2,2,1,0,1
2444,3581,9825,47,5,4,1,1,1,0
2445,3581,8456,53,9,5,4,1,0,1
2446,3585,10172,47,5,3,2,1,0,1
2447,3585,8586,53,11,1,10,0,0,0
2448,3587,8654,56,8,3,5,1,1,0
2449,3587,8472,44,0,0,0,0,0,0
2450,3590,8659,49,5,2,3,3,2,1
2451,3590,10252,51,6,2,4,2,2,0
2452,3591,8668,56,5,2,3,1,1,0
2453,3591,8466,44,3,0,3,2,2,0
2454,3593,10260,74,8,3,5,1,1,0
2455,3593,8586,26,1,0,1,6,2,4
2456,3594,8650,57,7,2,5,2,1,1
2457,3594,9850,43,7,4,3,2,0,2
2458,3598,8528,45,4,4,0,1,0,1
2459,3598,8472,55,2,1,1,0,0,0
2460,3601,8472,39,6,3,3,1,0,1
2461,3601,8456,61,10,2,8,0,0,0
2462,3602,10260,56,5,3,2,1,0,1
2463,3602,10261,44,2,0,2,0,0,0
2464,3603,9879,58,5,3,2,3,1,2
2465,3603,8466,42,5,3,2,0,0,0
2466,3604,10003,60,12,4,8,3,1,2
2467,3604,9798,40,11,4,7,3,2,1
2468,3607,9825,55,8,3,5,3,2,1
2469,3607,8654,45,2,1,1,1,0,1
2470,3608,8668,48,10,5,5,1,1,0
2471,3608,8528,52,2,1,1,2,1,1
2472,3609,9879,53,5,3,2,1,1,0
2473,3609,10252,47,2,1,1,2,0,2
2474,3610,9798,44,8,3,5,1,0,1
2475,3610,8650,56,6,2,4,0,0,0
2476,3614,10261,47,4,3,1,1,1,0
2477,3614,8472,53,1,1,0,2,1,1
2478,3615,8528,49,8,3,5,2,1,1
2479,3615,10003,51,7,2,5,1,0,1
2480,3616,8586,47,13,5,8,1,0,1
2481,3616,8455,53,3,1,2,1,0,1
2482,3617,8456,57,10,5,5,1,0,1
2483,3617,8659,43,4,1,3,0,0,0
2484,3618,8654,48,5,2,3,2,2,0
2485,3618,8466,52,3,1,2,1,0,1
2486,3621,10260,49,5,3,2,2,1,1
2487,3621,8455,51,9,6,3,0,0,0
2488,3622,8650,44,4,1,3,2,1,1
2489,3622,8668,56,4,2,2,0,0,0
2490,3626,8586,48,2,1,1,4,2,2
2491,3626,8466,52,5,0,5,1,0,1
2492,3627,10194,52,8,3,5,2,0,2
2493,3627,8472,48,2,1,1,0,0,0
2494,3628,8528,54,13,6,7,2,0,2
2495,3628,8654,46,6,4,2,0,0,0
2496,3629,9825,54,9,4,5,2,1,1
2497,3629,10252,46,3,1,2,1,1,0
2498,3631,9826,46,4,1,3,1,0,1
2499,3631,8586,54,6,2,4,0,0,0
2500,3632,8650,52,14,7,7,1,1,0
2501,3632,10194,48,6,2,4,2,0,2
2502,3635,9879,48,4,3,1,2,0,2
2503,3635,8472,52,8,4,4,0,0,0
2504,3637,8466,53,5,4,1,3,2,1
2505,3637,8659,47,7,2,5,1,0,1
2506,3638,8654,48,6,3,3,1,0,1
2507,3638,8344,52,4,3,1,0,0,0
2508,3640,10003,55,5,3,2,1,0,1
2509,3640,8344,45,6,2,4,0,0,0
2510,3641,8586,48,12,7,5,2,2,0
2511,3641,8668,52,6,1,5,2,1,1
2512,3644,9850,31,4,3,1,2,1,1
2513,3644,8456,69,13,4,9,2,0,2
2514,3645,10261,40,10,4,6,3,2,1
2515,3645,8455,60,9,5,4,1,1,0
2516,3646,10194,39,4,1,3,2,2,0
2517,3646,8466,61,3,0,3,5,4,1
2518,3651,8668,72,4,2,2,1,1,0
2519,3651,9826,28,3,1,2,0,0,0
2520,3652,8650,69,14,7,7,5,3,2
2521,3652,9879,31,1,1,0,0,0,0
2522,3653,10260,41,1,1,0,2,1,1
2523,3653,9825,59,5,1,4,0,0,0
2524,3654,8654,53,8,6,2,2,1,1
2525,3654,9850,47,2,0,2,2,0,2
2526,3655,8667,40,3,2,1,1,0,1
2527,3655,8466,60,4,0,4,1,0,1
2528,3657,10003,65,12,7,5,5,1,4
2529,3657,10194,35,1,0,1,2,1,1
2530,3658,10261,34,5,4,1,2,0,2
2531,3658,8586,66,19,6,13,0,0,0
2532,3659,8466,52,6,2,4,1,1,0
2533,3659,9825,48,2,0,2,1,0,1
2534,3662,10003,66,7,3,4,1,1,0
2535,3662,9879,34,2,1,1,0,0,0
2536,3663,8667,60,5,1,4,3,2,1
2537,3663,9826,40,2,0,2,0,0,0
2538,3664,8456,48,5,5,0,1,1,0
2539,3664,8586,52,6,3,3,1,0,1
2540,3665,9850,51,7,3,4,2,2,0
2541,3665,10261,49,6,3,3,0,0,0
2542,3667,10252,49,9,5,4,2,0,2
2543,3667,8659,51,2,1,1,0,0,0
2544,3668,8455,55,12,4,8,3,2,1
2545,3668,8654,45,4,2,2,0,0,0
2546,3669,10252,51,5,3,2,5,4,1
2547,3669,8472,49,1,0,1,1,0,1
2548,3671,8455,51,9,6,3,2,1,1
2549,3671,8466,49,4,2,2,2,0,2
2550,3672,8668,55,14,6,8,2,2,0
2551,3672,10194,45,4,1,3,2,2,0
2552,3673,8667,40,5,2,3,3,0,3
2553,3673,8650,60,6,3,3,0,0,0
2554,3674,8456,45,3,3,0,1,0,1
2555,3674,10003,55,5,4,1,0,0,0
2556,3675,8659,46,4,3,1,1,0,1
2557,3675,10261,54,4,2,2,0,0,0
2558,3676,9850,60,4,2,2,1,1,0
2559,3676,9826,40,6,3,3,1,0,1
2560,3677,8586,40,5,3,2,3,1,2
2561,3677,10260,60,1,0,1,2,0,2
2562,3681,8668,48,6,2,4,4,2,2
2563,3681,10260,52,7,3,4,1,0,1
2564,3682,8466,77,9,5,4,2,1,1
2565,3682,10252,23,0,0,0,2,0,2
2566,3684,8472,45,6,4,2,4,3,1
2567,3684,8455,55,7,2,5,1,0,1
2568,3686,8456,59,5,3,2,4,2,2
2569,3686,8659,41,4,3,1,0,0,0
2570,3688,8654,62,3,2,1,1,0,1
2571,3688,9826,38,3,0,3,0,0,0
2572,3689,9825,43,7,4,3,2,0,2
2573,3689,8668,57,4,1,3,0,0,0
2574,3691,9879,54,12,5,7,5,4,1
2575,3691,10252,46,6,2,4,2,1,1
2576,3692,8650,65,20,7,13,1,0,1
2577,3692,8654,35,6,4,2,0,0,0
2578,3693,10260,48,6,3,3,1,0,1
2579,3693,10261,52,2,2,0,0,0,0
2580,3695,8455,57,5,3,2,1,1,0
2581,3695,10194,43,2,2,0,1,0,1
2582,3696,8586,53,13,6,7,1,1,0
2583,3696,8472,47,6,2,4,3,2,1
2584,3698,8659,64,14,3,11,3,0,3
2585,3698,9850,36,1,1,0,1,0,1
2586,3701,8455,70,9,2,7,4,2,2
2587,3701,9826,30,6,2,4,1,0,1
2588,3702,8668,59,10,7,3,3,1,2
2589,3702,9879,41,4,1,3,0,0,0
2590,3705,8466,61,7,3,4,3,1,2
2591,3705,10261,39,7,2,5,0,0,0
2592,3710,9826,33,6,4,2,1,0,1
2593,3710,10261,67,4,1,3,0,0,0
2594,3711,9879,46,8,6,2,1,1,0
2595,3711,8456,54,11,6,5,1,0,1
2596,3712,8650,69,11,7,4,1,1,0
2597,3712,8344,31,6,2,4,0,0,0
2598,3715,10194,54,4,3,1,1,1,0
2599,3715,10252,46,8,4,4,3,0,3
2600,3716,8472,59,8,4,4,4,0,4
2601,3716,9850,41,9,6,3,0,0,0
2602,3718,8659,60,6,1,5,1,1,0
2603,3718,8667,40,2,0,2,0,0,0
2604,3719,9826,35,7,2,5,4,0,4
2605,3719,10252,65,5,2,3,0,0,0
2606,3721,8455,48,12,10,2,3,1,2
2607,3721,10003,52,2,1,1,0,0,0
2608,3723,8667,38,5,1,4,1,0,1
2609,3723,10260,62,5,3,2,1,0,1
2610,3724,8456,52,12,5,7,3,1,2
2611,3724,8650,48,8,3,5,0,0,0
2612,3725,10261,58,8,3,5,1,1,0
2613,3725,10194,42,4,4,0,0,0,0
2614,3730,8344,44,7,5,2,1,0,1
2615,3730,8472,56,11,4,7,0,0,0
2616,3734,8456,77,13,11,2,1,0,1
2617,3734,9826,23,4,1,3,0,0,0
2618,3735,9825,54,5,3,2,2,1,1
2619,3735,10261,46,6,4,2,0,0,0
2620,3736,10260,55,4,2,2,1,0,1
2621,3736,9850,45,8,7,1,0,0,0
2622,3737,8586,68,8,4,4,1,1,0
2623,3737,10194,32,1,0,1,2,0,2
2624,3738,8659,54,16,8,8,1,1,0
2625,3738,8654,46,6,3,3,1,0,1
2626,3741,8668,55,16,7,9,2,0,2
2627,3741,8659,45,3,1,2,1,0,1
2628,3742,9825,51,8,5,3,3,0,3
2629,3742,9879,49,7,4,3,0,0,0
2630,3744,8455,43,6,2,4,2,1,1
2631,3744,10260,57,7,1,6,0,0,0
2632,3745,8654,45,3,1,2,4,1,3
2633,3745,10261,55,3,0,3,2,0,2
2634,3746,8466,56,9,2,7,1,1,0
2635,3746,8472,44,3,0,3,0,0,0
2636,3747,10194,51,5,2,3,1,1,0
2637,3747,9826,49,5,2,3,4,3,1
2638,3748,8586,49,9,6,3,3,2,1
2639,3748,10003,51,5,3,2,6,2,4
2640,3751,8654,31,3,2,1,6,4,2
2641,3751,9879,69,11,4,7,0,0,0
2642,3753,10260,60,10,5,5,3,1,2
2643,3753,8586,40,3,1,2,2,1,1
2644,3755,10194,40,5,4,1,3,3,0
2645,3755,8668,60,8,1,7,0,0,0
2646,3758,8659,47,5,2,3,5,1,4
2647,3758,10261,53,6,3,3,0,0,0
2648,3759,9825,65,4,1,3,1,0,1
2649,3759,10252,35,6,1,5,0,0,0
2650,3760,8654,37,2,2,0,2,2,0
2651,3760,8344,63,10,2,8,0,0,0
2652,3761,9850,37,7,4,3,2,2,0
2653,3761,8668,63,7,4,3,3,1,2
2654,3762,9879,59,5,2,3,2,2,0
2655,3762,8472,41,3,2,1,0,0,0
2656,3763,8667,43,5,4,1,1,1,0
2657,3763,8455,57,7,4,3,1,0,1
2658,3764,10003,61,5,2,3,1,0,1
2659,3764,10260,39,4,1,3,0,0,0
2660,3765,8456,46,6,1,5,1,1,0
2661,3765,10261,54,7,2,5,3,1,2
2662,3766,8466,63,8,4,4,1,1,0
2663,3766,8659,37,2,0,2,4,2,2
2664,3768,8586,69,3,3,0,4,1,3
2665,3768,9826,31,3,3,0,0,0,0
2666,3769,9825,59,12,5,7,1,0,1
2667,3769,9879,41,6,2,4,0,0,0
2668,3770,10260,54,5,4,1,2,1,1
2669,3770,8455,46,4,2,2,1,0,1
2670,3771,10194,56,8,5,3,2,0,2
2671,3771,9826,44,6,2,4,1,0,1
2672,3774,9850,56,8,2,6,3,1,2
2673,3774,8667,44,2,1,1,0,0,0
2674,3775,8466,63,14,8,6,5,2,3
2675,3775,8472,37,9,1,8,0,0,0
2676,3776,10003,56,2,1,1,2,2,0
2677,3776,8586,44,6,2,4,1,0,1
2678,3778,10261,53,10,6,4,4,3,1
2679,3778,8654,47,4,3,1,1,1,0
2680,3779,8659,55,3,1,2,4,1,3
2681,3779,10252,45,4,2,2,0,0,0
2682,3780,8667,62,6,3,3,1,1,0
2683,3780,9826,38,3,2,1,0,0,0
2684,3781,8650,38,8,6,2,2,1,1
2685,3781,8668,62,15,6,9,1,1,0
2686,3782,10260,46,7,3,4,1,0,1
2687,3782,8344,54,4,2,2,0,0,0
2688,3783,10261,56,12,9,3,3,1,2
2689,3783,9850,44,4,1,3,1,0,1
2690,3784,8466,52,10,3,7,1,0,1
2691,3784,9825,48,2,1,1,0,0,0
2692,3786,10003,61,7,3,4,1,1,0
2693,3786,9879,39,7,6,1,0,0,0
2694,3787,8654,29,1,1,0,1,0,1
2695,3787,8455,71,19,6,13,0,0,0
2696,3788,8586,35,2,1,1,4,4,0
2697,3788,8456,65,8,3,5,3,1,2
2698,3789,9825,73,5,3,2,1,1,0
2699,3789,9826,27,4,1,3,2,1,1
2700,3793,8586,61,8,3,5,2,2,0
2701,3793,8667,39,3,0,3,0,0,0
2702,3794,8455,36,7,5,2,3,3,0
2703,3794,8456,64,8,3,5,1,1,0
2704,3795,10261,51,15,5,10,1,1,0
2705,3795,8472,49,5,3,2,2,1,1
2706,3797,8650,49,6,1,5,3,2,1
2707,3797,8659,51,5,1,4,2,0,2
2708,3798,10003,64,7,2,5,3,1,2
2709,3798,8654,36,2,2,0,2,1,1
2710,3800,10252,68,4,3,1,1,0,1
2711,3800,8654,32,5,4,1,0,0,0
2712,3801,8455,58,6,3,3,3,2,1
2713,3801,10261,42,7,5,2,0,0,0
2714,3802,8650,41,8,2,6,2,2,0
2715,3802,9825,59,6,0,6,0,0,0
2716,3803,10260,76,16,7,9,2,1,1
2717,3803,9879,24,2,0,2,0,0,0
2718,3805,10194,39,1,1,0,4,1,3
2719,3805,8466,61,7,3,4,0,0,0
2720,3807,10003,62,8,4,4,4,2,2
2721,3807,8344,38,2,2,0,0,0,0
2722,3808,8586,46,4,2,2,1,1,0
2723,3808,8668,54,4,4,0,0,0,0
2724,3809,10260,43,2,1,1,1,1,0
2725,3809,9825,57,11,6,5,0,0,0
2726,3811,8466,63,9,3,6,4,4,0
2727,3811,8667,37,5,3,2,0,0,0
2728,3813,8455,61,6,1,5,2,1,1
2729,3813,8659,39,2,0,2,3,2,1
2730,3815,8668,68,4,2,2,1,1,0
2731,3815,9826,32,1,0,1,0,0,0
2732,3816,9879,30,5,2,3,3,1,2
2733,3816,8650,70,6,3,3,0,0,0
2734,3817,8456,57,3,1,2,1,0,1
2735,3817,8472,43,1,0,1,0,0,0
2736,3819,9825,65,6,4,2,1,1,0
2737,3819,8472,35,2,0,2,1,1,0
2738,3820,8344,56,13,9,4,3,1,2
2739,3820,8667,44,2,1,1,0,0,0
2740,3821,8455,47,14,8,6,2,1,1
2741,3821,8668,53,7,5,2,2,0,2
2742,3822,9826,34,11,4,7,3,1,2
2743,3822,10260,66,8,5,3,0,0,0
2744,3823,8650,54,10,3,7,2,1,1
2745,3823,10003,46,5,3,2,0,0,0
2746,3825,10261,54,8,2,6,2,2,0
2747,3825,10252,46,5,3,2,1,1,0
2748,3826,9850,41,7,3,4,2,1,1
2749,3826,8586,59,4,1,3,1,0,1
2750,3827,8659,64,11,2,9,2,1,1
2751,3827,9879,36,2,1,1,1,0,1
2752,3828,8654,32,2,2,0,1,1,0
2753,3828,8466,68,6,0,6,0,0,0
2754,3831,8455,58,8,3,5,1,1,0
2755,3831,9879,42,3,2,1,1,0,1
2756,3832,10261,53,7,2,5,2,1,1
2757,3832,8667,47,5,3,2,0,0,0
2758,3833,8456,48,5,2,3,3,1,2
2759,3833,10260,52,7,2,5,1,0,1
2760,3834,8466,58,7,2,5,2,1,1
2761,3834,8650,42,3,1,2,2,2,0
2762,3835,10194,44,6,3,3,3,2,1
2763,3835,9825,56,6,2,4,1,1,0
2764,3837,9826,31,4,1,3,2,0,2
2765,3837,10003,69,4,2,2,0,0,0
2766,3838,8586,61,8,4,4,2,1,1
2767,3838,8344,39,5,2,3,0,0,0
2768,3839,9825,61,5,4,1,1,0,1
2769,3839,10003,39,2,1,1,0,0,0
2770,3841,8586,47,3,2,1,4,2,2
2771,3841,8455,53,2,0,2,1,0,1
2772,3842,8466,65,6,5,1,2,2,0
2773,3842,9826,35,3,2,1,3,1,2
2774,3844,8456,75,9,4,5,1,1,0
2775,3844,10252,25,1,0,1,1,1,0
2776,3845,10261,55,11,7,4,3,1,2
2777,3845,8668,45,3,2,1,0,0,0
2778,3846,10194,48,3,3,0,2,1,1
2779,3846,9850,52,5,2,3,3,0,3
2780,3847,10260,55,5,2,3,2,1,1
2781,3847,8659,45,6,2,4,3,0,3
2782,3853,8650,43,6,4,2,2,0,2
2783,3853,10260,57,8,3,5,2,0,2
2784,3855,10261,54,13,5,8,3,0,3
2785,3855,9879,46,2,0,2,0,0,0
2786,3856,9850,41,9,5,4,1,1,0
2787,3856,8466,59,4,1,3,0,0,0
2788,3857,10003,57,7,2,5,3,2,1
2789,3857,8659,43,5,3,2,1,0,1
2790,3858,10194,54,5,5,0,2,0,2
2791,3858,8654,46,3,3,0,1,0,1
2792,3859,8659,37,7,2,5,1,1,0
2793,3859,10003,63,7,4,3,1,0,1
2794,3860,8455,62,7,4,3,2,2,0
2795,3860,10252,38,5,3,2,1,0,1
2796,3861,8668,68,12,6,6,2,1,1
2797,3861,8344,32,5,3,2,3,2,1
2798,3862,10261,61,5,4,1,3,1,2
2799,3862,9879,39,5,1,4,1,0,1
2800,3863,8667,54,7,2,5,2,1,1
2801,3863,8456,46,1,0,1,0,0,0
2802,3865,8466,64,4,2,2,1,1,0
2803,3865,9850,36,2,1,1,2,0,2
2804,3867,8472,66,6,4,2,3,0,3
2805,3867,9826,34,6,1,5,0,0,0
2806,3868,8586,58,8,3,5,1,1,0
2807,3868,9825,42,2,1,1,1,0,1
2808,3869,10252,51,4,3,1,4,1,3
2809,3869,10194,49,1,0,1,1,0,1
2810,3870,8344,33,3,2,1,2,1,1
2811,3870,8650,67,6,4,2,0,0,0
2812,3871,9825,47,8,4,4,1,1,0
2813,3871,8455,53,9,6,3,4,1,3
2814,3872,10003,59,11,5,6,2,1,1
2815,3872,8668,41,3,0,3,1,1,0
2816,3873,8667,43,3,2,1,1,1,0
2817,3873,8659,57,7,3,4,1,0,1
2818,3874,8456,68,10,4,6,2,1,1
2819,3874,9879,32,1,1,0,2,1,1
2820,3875,10261,73,10,7,3,2,0,2
2821,3875,9826,27,3,2,1,2,0,2
2822,3876,9850,54,7,4,3,3,1,2
2823,3876,8472,46,6,2,4,1,0,1
2824,3877,8586,51,4,3,1,1,1,0
2825,3877,8466,49,4,3,1,2,0,2
2826,3878,10260,55,5,4,1,2,1,1
2827,3878,8654,45,5,4,1,1,0,1
2828,3879,8456,53,8,2,6,2,2,0
2829,3879,9825,47,3,0,3,3,1,2
2830,3880,8455,67,11,4,7,0,0,0
2831,3880,9826,33,5,2,3,0,0,0
2832,3882,8586,41,6,5,1,2,2,0
2833,3882,8650,59,2,1,1,0,0,0
2834,3883,10260,55,4,1,3,2,1,1
2835,3883,10252,45,2,1,1,1,0,1
2836,3884,8466,54,7,4,3,1,0,1
2837,3884,10261,46,5,0,5,0,0,0
2838,3885,10194,56,8,2,6,1,1,0
2839,3885,8667,44,4,1,3,2,1,1
2840,3886,8472,60,10,2,8,1,1,0
2841,3886,8654,40,5,1,4,3,3,0
2842,3889,10252,51,4,1,3,2,2,0
2843,3889,9879,49,10,4,6,2,1,1
2844,3890,9826,34,7,3,4,2,1,1
2845,3890,8344,66,6,3,3,1,0,1
2846,3891,8455,49,8,7,1,2,1,1
2847,3891,10194,51,3,1,2,1,0,1
2848,3892,8668,42,11,7,4,2,1,1
2849,3892,9825,58,8,5,3,0,0,0
2850,3894,8466,57,1,1,0,1,0,1
2851,3894,8456,43,4,1,3,1,0,1
2852,3895,10261,44,6,3,3,3,0,3
2853,3895,10260,56,0,0,0,0,0,0
2854,3896,8659,29,5,4,1,1,1,0
2855,3896,9850,71,4,4,0,2,0,2
2856,3898,8654,35,2,2,0,2,1,1
2857,3898,8650,65,7,1,6,1,0,1
2858,3900,10252,56,5,2,3,4,1,3
2859,3900,9826,44,3,1,2,0,0,0
2860,3903,10260,55,9,1,8,1,1,0
2861,3903,8667,45,1,0,1,0,0,0
2862,3904,8344,33,3,1,2,1,0,1
2863,3904,8466,67,9,5,4,0,0,0
2864,3905,10261,51,7,4,3,1,0,1
2865,3905,10194,49,2,0,2,0,0,0
2866,3906,8668,53,9,5,4,1,0,1
2867,3906,8472,47,14,5,9,0,0,0
2868,3908,8659,32,2,2,0,1,1,0
2869,3908,8586,68,9,3,6,2,1,1
2870,3911,8455,62,23,12,11,1,0,1
2871,3911,8472,38,1,1,0,0,0,0
2872,3912,10260,62,7,2,5,1,1,0
2873,3912,8668,38,8,4,4,3,1,2
2874,3914,8456,69,8,2,6,2,0,2
2875,3914,8659,31,4,1,3,0,0,0
2876,3915,10003,53,4,3,1,1,0,1
2877,3915,10261,47,5,2,3,2,0,2
2878,3916,8650,58,4,2,2,2,2,0
2879,3916,9850,42,7,4,3,1,0,1
2880,3917,9879,37,4,2,2,2,1,1
2881,3917,8586,63,4,3,1,0,0,0
2882,3918,8654,66,7,4,3,2,0,2
2883,3918,9826,34,8,4,4,1,0,1
2884,3919,10261,38,4,2,2,1,1,0
2885,3919,9825,62,5,4,1,1,0,1
2886,3920,9826,46,2,1,1,2,2,0
2887,3920,8456,54,5,1,4,0,0,0
2888,3922,8455,27,7,4,3,1,1,0
2889,3922,8650,73,18,6,12,3,1,2
2890,3923,10260,64,12,7,5,2,1,1
2891,3923,9850,36,4,0,4,1,0,1
2892,3926,8472,58,7,3,4,1,1,0
2893,3926,8344,42,2,1,1,2,0,2
2894,3928,8654,56,6,5,1,1,1,0
2895,3928,8659,44,10,3,7,2,1,1
2896,3929,8659,39,2,2,0,1,0,1
2897,3929,9825,61,5,4,1,0,0,0
2898,3930,8667,54,5,2,3,2,2,0
2899,3930,10252,46,5,3,2,1,1,0
2900,3933,8456,41,7,4,3,1,1,0
2901,3933,8668,59,1,0,1,1,0,1
2902,3934,10260,63,4,2,2,1,0,1
2903,3934,8472,37,1,0,1,0,0,0
2904,3935,10261,54,10,5,5,3,2,1
2905,3935,8344,46,5,1,4,0,0,0
2906,3937,10003,39,8,2,6,1,1,0
2907,3937,8466,61,9,6,3,1,1,0
2908,3938,8654,49,9,3,6,1,1,0
2909,3938,8586,51,6,3,3,2,2,0
2910,3939,8455,63,12,5,7,1,0,1
2911,3939,8344,37,5,3,2,0,0,0
2912,3940,9879,66,6,4,2,1,0,1
2913,3940,9826,34,7,4,3,0,0,0
2914,3942,10261,36,3,2,1,1,0,1
2915,3942,8650,64,9,6,3,0,0,0
2916,3943,8456,68,14,6,8,1,1,0
2917,3943,8654,32,0,0,0,1,0,1
2918,3947,8586,54,8,8,0,4,2,2
2919,3947,10252,46,2,1,1,0,0,0
2920,3948,8659,42,11,8,3,2,1,1
2921,3948,10194,58,7,3,4,1,1,0
2922,3949,10261,45,8,1,7,2,0,2
2923,3949,10252,55,3,2,1,0,0,0
2924,3950,8668,44,4,2,2,1,1,0
2925,3950,8455,56,8,3,5,0,0,0
2926,3951,8659,45,5,3,2,1,1,0
2927,3951,9879,55,2,0,2,2,2,0
2928,3953,10260,60,10,2,8,3,2,1
2929,3953,9826,40,0,0,0,0,0,0
2930,3954,8654,41,3,2,1,1,1,0
2931,3954,8466,59,10,3,7,1,0,1
2932,3956,8472,30,6,2,4,1,1,0
2933,3956,9825,70,9,8,1,4,2,2
2934,3957,10003,56,9,6,3,1,1,0
2935,3957,8650,44,5,3,2,2,1,1
2936,3959,9825,49,9,5,4,1,1,0
2937,3959,10194,51,4,0,4,0,0,0
2938,3961,9879,35,2,1,1,1,1,0
2939,3961,8455,65,12,5,7,0,0,0
2940,3962,9826,44,5,3,2,2,0,2
2941,3962,10003,56,5,1,4,1,0,1
2942,3963,8650,57,8,5,3,2,0,2
2943,3963,8466,43,8,1,7,0,0,0
2944,3964,8456,42,3,2,1,2,1,1
2945,3964,10260,58,3,0,3,1,1,0
2946,3965,10261,60,5,4,1,4,3,1
2947,3965,8667,40,7,5,2,2,0,2
2948,3966,10252,36,3,2,1,1,1,0
2949,3966,9850,64,3,0,3,3,1,2
2950,3967,8472,48,4,3,1,5,2,3
2951,3967,8659,52,3,3,0,1,0,1
2952,3968,8668,62,3,1,2,1,0,1
2953,3968,8654,38,2,2,0,1,0,1
2954,3969,8456,66,9,3,6,2,1,1
2955,3969,10252,34,1,0,1,0,0,0
2956,3973,10260,59,10,7,3,1,1,0
2957,3973,8659,41,2,0,2,1,1,0
2958,3974,8466,62,4,3,1,2,2,0
2959,3974,9826,38,3,2,1,2,0,2
2960,3975,9850,43,4,3,1,3,2,1
2961,3975,10194,57,3,0,3,0,0,0
2962,3976,8650,53,7,1,6,1,1,0
2963,3976,8472,47,10,6,4,1,1,0
2964,3977,9825,43,3,1,2,2,1,1
2965,3977,10003,57,3,0,3,1,0,1
2966,3978,8586,53,3,2,1,1,1,0
2967,3978,8455,47,7,2,5,1,0,1
2968,3979,10261,43,11,8,3,1,1,0
2969,3979,8344,57,3,1,2,0,0,0
2970,3981,10252,55,8,4,4,2,1,1
2971,3981,8667,45,2,1,1,2,1,1
2972,3983,8456,54,6,2,4,3,0,3
2973,3983,8668,46,4,1,3,1,0,1
2974,3984,8455,55,12,3,9,1,0,1
2975,3984,9850,45,7,4,3,0,0,0
2976,3985,10003,58,9,6,3,2,2,0
2977,3985,8466,42,5,5,0,3,1,2
2978,3986,10260,63,5,3,2,1,1,0
2979,3986,8472,37,4,3,1,2,0,2
2980,3987,8586,61,7,1,6,2,1,1
2981,3987,8654,39,5,0,5,0,0,0
2982,3988,8659,44,4,2,2,2,2,0
2983,3988,9825,56,4,2,2,1,1,0
2984,3989,9825,56,8,4,4,2,1,1
2985,3989,9850,44,6,4,2,0,0,0
2986,3990,8586,62,7,3,4,3,2,1
2987,3990,10252,38,7,3,4,1,0,1
2988,3991,8455,66,9,4,5,1,0,1
2989,3991,8344,34,6,1,5,0,0,0
2990,3993,8667,33,2,2,0,2,1,1
2991,3993,8668,67,7,5,2,0,0,0
2992,3994,8466,53,9,4,5,3,1,2
2993,3994,10260,47,6,3,3,1,0,1
2994,3995,10261,37,4,4,0,3,2,1
2995,3995,8650,63,6,3,3,1,0,1
2996,3996,8659,49,6,2,4,1,1,0
2997,3996,10194,51,4,2,2,3,1,2
2998,3997,10003,63,8,4,4,1,1,0
2999,3997,8472,37,3,1,2,0,0,0
3000,3998,8456,63,11,5,6,3,3,0
3001,3998,8654,37,0,0,0,1,0,1
3002,3999,8668,53,10,8,2,1,1,0
3003,3999,10252,47,9,4,5,0,0,0
3004,4000,8455,46,3,2,1,2,1,1
3005,4000,8456,54,9,4,5,3,1,2
3006,4003,10194,34,6,5,1,1,1,0
3007,4003,10260,66,5,3,2,1,1,0
3008,4004,8344,39,7,4,3,1,1,0
3009,4004,9850,61,17,10,7,0,0,0
3010,4005,8466,66,6,6,0,2,1,1
3011,4005,9879,34,0,0,0,2,2,0
3012,4006,10261,52,7,2,5,3,2,1
3013,4006,8472,48,5,1,4,1,0,1
3014,4007,8586,67,7,5,2,2,2,0
3015,4007,8667,33,7,6,1,2,0,2
3016,4008,8654,33,7,4,3,1,1,0
3017,4008,10003,67,8,3,5,1,0,1
3018,4009,9825,77,7,4,3,1,1,0
3019,4009,9826,23,3,1,2,1,1,0
3020,4010,8455,62,3,2,1,4,3,1
3021,4010,8191,38,1,0,1,1,0,1
3022,4011,8668,64,7,6,1,2,2,0
3023,4011,8197,36,2,0,2,0,0,0
3024,4012,8650,56,4,2,2,2,2,0
3025,4012,8466,44,5,2,3,2,0,2
3026,4013,10003,42,3,1,2,3,0,3
3027,4013,10260,58,8,5,3,2,0,2
3028,4014,8456,55,7,4,3,2,1,1
3029,4014,10261,45,5,0,5,0,0,0
3030,4015,10172,51,11,5,6,1,1,0
3031,4015,8667,49,5,0,5,1,1,0
3032,4019,9825,69,18,8,10,3,1,2
3033,4019,8191,31,3,1,2,5,3,2
3034,4020,10252,39,4,3,1,1,1,0
3035,4020,8586,61,12,7,5,1,1,0
3036,4021,10172,35,5,1,4,3,2,1
3037,4021,8455,65,9,4,5,0,0,0
3038,4022,8472,47,5,4,1,3,2,1
3039,4022,9826,53,8,0,8,1,1,0
3040,4023,8668,67,7,5,2,2,1,1
3041,4023,10003,33,4,3,1,0,0,0
3042,4024,8667,46,3,2,1,1,0,1
3043,4024,8466,54,3,1,2,2,0,2
3044,4025,8197,58,7,2,5,1,0,1
3045,4025,8659,42,6,2,4,1,0,1
3046,4026,8456,52,8,4,4,1,1,0
3047,4026,10260,48,3,0,3,0,0,0
3048,4027,10261,35,7,5,2,1,0,1
3049,4027,8650,65,4,0,4,0,0,0
3050,4030,8650,59,7,3,4,1,1,0
3051,4030,8455,41,9,7,2,0,0,0
3052,4031,10260,72,9,5,4,2,1,1
3053,4031,9826,28,2,0,2,0,0,0
3054,4032,8456,57,13,5,8,1,0,1
3055,4032,10172,43,10,5,5,0,0,0
3056,4033,8466,65,8,4,4,2,1,1
3057,4033,8197,35,1,0,1,0,0,0
3058,4035,10003,48,5,4,1,1,1,0
3059,4035,9825,52,6,2,4,0,0,0
3060,4036,8586,60,6,4,2,2,1,1
3061,4036,10194,40,5,3,2,0,0,0
3062,4037,8659,57,4,4,0,2,0,2
3063,4037,10261,43,1,0,1,0,0,0
3064,4038,8654,57,14,7,7,5,4,1
3065,4038,10252,43,6,5,1,0,0,0
3066,4039,9825,62,13,6,7,2,2,0
3067,4039,10260,38,1,0,1,2,0,2
3068,4040,10252,36,4,3,1,3,0,3
3069,4040,8466,64,9,4,5,0,0,0
3070,4041,8455,76,12,9,3,5,1,4
3071,4041,8659,24,1,1,0,0,0,0
3072,4042,8650,65,5,1,4,1,1,0
3073,4042,9826,35,7,3,4,1,1,0
3074,4043,8668,56,5,4,1,1,1,0
3075,4043,8654,44,6,2,4,0,0,0
3076,4044,8586,74,12,6,6,3,1,2
3077,4044,8667,26,2,2,0,1,1,0
3078,4045,8197,40,6,2,4,2,0,2
3079,4045,8472,60,8,3,5,0,0,0
3080,4046,8456,59,11,4,7,2,2,0
3081,4046,10003,41,3,0,3,2,1,1
3082,4047,10261,56,10,5,5,1,0,1
3083,4047,10172,44,9,5,4,0,0,0
3084,4048,8191,28,2,1,1,3,2,1
3085,4048,10194,72,6,4,2,1,1,0
3086,4049,8191,47,7,4,3,3,2,1
3087,4049,10252,53,14,10,4,0,0,0
3088,4050,10194,52,10,2,8,2,2,0
3089,4050,8650,48,7,0,7,2,1,1
3090,4051,10260,77,5,3,2,1,0,1
3091,4051,8667,23,3,1,2,0,0,0
3092,4054,8472,34,9,4,5,1,1,0
3093,4054,8455,66,15,6,9,1,0,1
3094,4055,10003,64,5,2,3,1,0,1
3095,4055,9826,36,5,2,3,1,0,1
3096,4056,8668,61,6,3,3,1,0,1
3097,4056,8586,39,6,3,3,1,0,1
3098,4057,9825,54,10,6,4,2,1,1
3099,4057,8659,46,3,0,3,1,1,0
3100,4058,8654,47,5,2,3,1,1,0
3101,4058,10261,53,1,0,1,2,0,2
3102,4059,9825,58,10,3,7,1,0,1
3103,4059,8466,42,3,1,2,1,0,1
3104,4060,8191,43,4,2,2,2,2,0
3105,4060,10261,57,5,2,3,1,0,1
3106,4061,8650,54,4,3,1,2,1,1
3107,4061,8197,46,11,3,8,0,0,0
3108,4062,10260,64,1,1,0,3,2,1
3109,4062,10194,36,3,0,3,1,1,0
3110,4063,10003,58,11,7,4,1,1,0
3111,4063,10172,42,2,1,1,1,0,1
3112,4064,9826,45,11,9,2,2,2,0
3113,4064,10252,55,2,1,1,0,0,0
3114,4065,8659,57,12,4,8,1,1,0
3115,4065,8654,43,10,8,2,2,1,1
3116,4066,8586,62,4,2,2,2,2,0
3117,4066,8455,38,6,4,2,1,0,1
3118,4067,8667,41,3,2,1,1,0,1
3119,4067,8668,59,7,5,2,3,0,3
3120,4068,8472,35,7,3,4,2,1,1
3121,4068,8456,65,1,0,1,1,1,0
3122,4069,8197,34,4,2,2,5,3,2
3123,4069,10252,66,8,2,6,0,0,0
3124,4070,8659,51,3,1,2,2,1,1
3125,4070,8667,49,4,1,3,0,0,0
3126,4071,8650,52,9,1,8,1,1,0
3127,4071,8472,48,2,0,2,0,0,0
3128,4072,8456,52,16,8,8,1,1,0
3129,4072,8668,48,6,1,5,2,1,1
3130,4073,8455,66,11,5,6,2,1,1
3131,4073,10261,34,3,2,1,0,0,0
3132,4074,10172,51,9,6,3,1,0,1
3133,4074,8191,49,5,3,2,0,0,0
3134,4075,8466,51,5,2,3,1,1,0
3135,4075,10260,49,0,0,0,3,0,3
3136,4076,9825,57,7,3,4,2,1,1
3137,4076,10194,43,3,2,1,1,1,0
3138,4078,8654,56,9,6,3,3,0,3
3139,4078,10003,44,5,1,4,0,0,0
3140,4079,10261,48,8,4,4,2,1,1
3141,4079,9825,52,3,0,3,1,0,1
3142,4080,8191,40,4,2,2,1,1,0
3143,4080,8466,60,4,1,3,0,0,0
3144,4081,8667,39,1,1,0,3,1,2
3145,4081,8455,61,6,0,6,1,0,1
3146,4082,10194,57,4,2,2,2,1,1
3147,4082,9826,43,5,1,4,1,0,1
3148,4083,10172,47,6,2,4,1,1,0
3149,4083,8668,53,7,3,4,1,0,1
3150,4085,8650,46,11,5,6,1,0,1
3151,4085,10260,54,5,0,5,0,0,0
3152,4086,8654,43,12,6,6,1,1,0
3153,4086,8472,57,8,2,6,0,0,0
3154,4087,10003,53,7,2,5,2,1,1
3155,4087,8586,47,3,0,3,0,0,0
3156,4089,10260,65,11,4,7,2,1,1
3157,4089,10252,35,6,1,5,0,0,0
3158,4090,10003,44,4,1,3,1,0,1
3159,4090,8667,56,6,2,4,0,0,0
3160,4091,8650,63,12,3,9,2,1,1
3161,4091,9825,37,4,1,3,0,0,0
3162,4092,9826,26,1,1,0,3,1,2
3163,4092,8456,74,3,1,2,2,1,1
3164,4093,10261,51,9,3,6,3,1,2
3165,4093,8472,49,4,3,1,0,0,0
3166,4094,8659,58,6,4,2,1,0,1
3167,4094,10172,42,8,2,6,0,0,0
3168,4095,8668,55,7,1,6,1,1,0
3169,4095,8466,45,3,1,2,1,1,0
3170,4096,10194,49,6,2,4,3,3,0
3171,4096,8455,51,9,0,9,1,0,1
3172,4097,8586,66,10,3,7,3,1,2
3173,4097,8191,34,5,0,5,0,0,0
3174,4098,8654,49,4,4,0,3,3,0
3175,4098,8197,51,8,3,5,0,0,0
3176,4099,9825,58,5,3,2,4,4,0
3177,4099,10172,42,6,0,6,0,0,0
3178,4100,8191,47,4,2,2,1,0,1
3179,4100,8650,53,6,3,3,0,0,0
3180,4101,8455,66,11,6,5,2,2,0
3181,4101,8654,34,0,0,0,0,0,0
3182,4102,9826,42,7,5,2,2,2,0
3183,4102,8466,58,4,1,3,1,0,1
3184,4105,10261,38,4,3,1,5,2,3
3185,4105,10260,62,2,1,1,5,2,3
3186,4106,8667,53,5,2,3,1,1,0
3187,4106,8472,47,5,1,4,1,1,0
3188,4107,10003,43,2,0,2,1,0,1
3189,4107,10252,57,5,0,5,0,0,0
3190,4108,8456,53,2,2,0,3,1,2
3191,4108,8659,47,9,2,7,3,1,2
3192,4109,10252,48,6,2,4,1,1,0
3193,4109,8472,52,7,2,5,0,0,0
3194,4110,8667,63,11,4,7,3,2,1
3195,4110,8197,37,1,1,0,0,0,0
3196,4113,10261,53,9,4,5,3,1,2
3197,4113,8668,47,1,1,0,0,0,0
3198,4114,10172,54,8,4,4,1,1,0
3199,4114,9826,46,4,1,3,3,1,2
3200,4115,8455,60,5,1,4,1,0,1
3201,4115,8466,40,1,1,0,0,0,0
3202,4117,8586,47,7,3,4,3,2,1
3203,4117,10260,53,7,6,1,2,2,0
3204,4118,9825,44,14,4,10,3,1,2
3205,4118,8654,56,7,4,3,1,0,1
3206,4119,10252,40,4,3,1,3,2,1
3207,4119,10261,60,4,2,2,0,0,0
3208,4121,9826,45,7,3,4,2,1,1
3209,4121,8654,55,7,6,1,1,0,1
3210,4122,9825,55,4,2,2,1,1,0
3211,4122,8668,45,2,1,1,1,0,1
3212,4123,8667,43,5,4,1,1,1,0
3213,4123,10194,57,4,0,4,2,2,0
3214,4125,8466,59,3,2,1,4,3,1
3215,4125,8659,41,3,0,3,4,1,3
3216,4126,8472,45,4,2,2,1,0,1
3217,4126,10260,55,4,0,4,0,0,0
3218,4128,8586,66,6,3,3,4,3,1
3219,4128,10172,34,1,0,1,1,0,1
3220,4129,10252,70,7,5,2,2,1,1
3221,4129,9826,30,2,0,2,1,1,0
3222,4130,8668,56,5,2,3,2,1,1
3223,4130,8667,44,9,5,4,1,0,1
3224,4131,8197,41,5,1,4,1,1,0
3225,4131,8650,59,7,1,6,0,0,0
3226,4132,8456,64,18,8,10,3,2,1
3227,4132,8472,36,2,1,1,1,1,0
3228,4135,9825,59,7,5,2,3,1,2
3229,4135,8466,41,5,3,2,1,0,1
3230,4136,10194,35,4,1,3,1,1,0
3231,4136,10260,65,2,0,2,0,0,0
3232,4137,8586,46,4,2,2,3,2,1
3233,4137,8455,54,7,2,5,1,0,1
3234,4138,8659,54,4,2,2,2,1,1
3235,4138,8654,46,3,2,1,0,0,0
3236,4139,9825,53,4,3,1,2,1,1
3237,4139,10194,47,2,1,1,4,2,2
3238,4140,8191,46,5,1,4,1,0,1
3239,4140,10172,54,8,2,6,0,0,0
3240,4141,10261,37,6,4,2,4,0,4
3241,4141,8455,63,4,1,3,1,0,1
3242,4142,8586,58,4,1,3,1,1,0
3243,4142,9826,42,12,2,10,1,0,1
3244,4143,8668,38,7,4,3,1,1,0
3245,4143,8456,62,7,4,3,0,0,0
3246,4144,10252,62,5,1,4,3,1,2
3247,4144,8197,38,5,0,5,3,2,1
3248,4145,10260,61,1,1,0,1,1,0
3249,4145,8466,39,1,0,1,0,0,0
3250,4146,8650,53,7,2,5,2,1,1
3251,4146,8472,47,2,0,2,0,0,0
3252,4147,10003,60,11,6,5,1,1,0
3253,4147,8654,40,7,1,6,0,0,0
3254,4148,8667,47,5,3,2,1,1,0
3255,4148,8659,53,3,2,1,1,1,0
3256,4149,10252,49,5,2,3,3,1,2
3257,4149,8650,51,7,2,5,1,0,1
3258,4151,8668,68,9,5,4,2,0,2
3259,4151,8659,32,2,1,1,1,0,1
3260,4153,9825,34,2,1,1,3,2,1
3261,4153,8456,66,6,0,6,0,0,0
3262,4155,10260,64,9,4,5,3,1,2
3263,4155,10172,36,7,4,3,2,0,2
3264,4156,10003,46,3,2,1,2,1,1
3265,4156,8455,54,7,3,4,3,1,2
3266,4157,8472,34,4,1,3,2,1,1
3267,4157,8586,66,14,5,9,0,0,0
3268,4158,8667,46,5,2,3,2,1,1
3269,4158,8654,54,6,3,3,2,1,1
3270,4159,10252,52,4,2,2,1,1,0
3271,4159,9825,48,3,1,2,1,1,0
3272,4160,8456,57,4,2,2,3,3,0
3273,4160,8455,43,1,1,0,1,0,1
3274,4161,9826,54,7,5,2,3,2,1
3275,4161,8668,46,5,1,4,0,0,0
3276,4162,8667,53,9,3,6,3,1,2
3277,4162,10261,47,3,2,1,1,0,1
3278,4163,8650,66,10,6,4,1,0,1
3279,4163,8654,34,4,3,1,1,0,1
3280,4164,10260,72,7,3,4,2,1,1
3281,4164,8197,28,0,0,0,1,1,0
3282,4165,8466,63,10,2,8,2,0,2
3283,4165,10003,37,2,0,2,0,0,0
3284,4166,10194,52,2,1,1,1,1,0
3285,4166,10172,48,5,1,4,0,0,0
3286,4168,8586,62,6,4,2,1,0,1
3287,4168,8659,38,7,4,3,0,0,0
3288,4170,8191,55,7,2,5,1,1,0
3289,4170,8659,45,4,2,2,0,0,0
3290,4172,9826,37,6,2,4,1,1,0
3291,4172,8197,63,12,6,6,1,1,0
3292,4173,8667,26,3,2,1,2,1,1
3293,4173,8456,74,10,4,6,1,0,1
3294,4174,10261,42,3,3,0,1,0,1
3295,4174,10194,58,4,1,3,0,0,0
3296,4175,10172,45,6,3,3,2,2,0
3297,4175,8466,55,5,4,1,0,0,0
3298,4176,10003,61,10,5,5,6,2,4
3299,4176,8472,39,2,0,2,1,1,0
3300,4177,8586,56,10,4,6,1,1,0
3301,4177,9825,44,4,0,4,4,1,3
3302,4178,8654,41,8,4,4,2,1,1
3303,4178,10260,59,10,3,7,0,0,0
3304,4179,8197,42,5,1,4,1,1,0
3305,4179,9825,58,10,8,2,2,0,2
3306,4180,8667,37,4,1,3,6,5,1
3307,4180,10252,63,4,0,4,1,1,0
3308,4181,10260,57,4,1,3,4,2,2
3309,4181,8191,43,3,2,1,2,1,1
3310,4182,8466,67,11,2,9,2,0,2
3311,4182,8654,33,4,3,1,0,0,0
3312,4183,9826,54,3,1,2,3,1,2
3313,4183,10261,46,0,0,0,0,0,0
3314,4188,10172,47,7,4,3,4,4,0
3315,4188,8472,53,8,1,7,1,0,1
3316,4189,10194,48,6,4,2,1,1,0
3317,4189,10252,52,2,1,1,0,0,0
3318,4191,9826,53,9,2,7,1,1,0
3319,4191,9825,47,7,3,4,3,1,2
3320,4192,8197,41,7,5,2,1,1,0
3321,4192,8668,59,5,2,3,0,0,0
3322,4193,8667,55,4,2,2,2,2,0
3323,4193,10172,45,3,2,1,0,0,0
3324,4194,10261,43,2,1,1,2,1,1
3325,4194,8456,57,4,1,3,0,0,0
3326,4195,8466,60,13,7,6,2,0,2
3327,4195,8650,40,2,0,2,0,0,0
3328,4196,8659,39,2,2,0,6,5,1
3329,4196,8472,61,6,2,4,1,0,1
3330,4197,10003,36,5,2,3,2,1,1
3331,4197,10260,64,7,2,5,2,0,2
3332,4199,8668,52,5,1,4,1,0,1
3333,4199,9825,48,7,4,3,0,0,0
3334,4200,8191,46,7,4,3,3,2,1
3335,4200,10003,54,3,1,2,2,0,2
3336,4201,8455,62,5,4,1,1,1,0
3337,4201,8197,38,2,2,0,0,0,0
3338,4202,8650,48,3,3,0,4,3,1
3339,4202,8456,52,0,0,0,0,0,0
3340,4203,8472,27,2,2,0,4,2,2
3341,4203,10260,73,11,4,7,0,0,0
3342,4205,10172,37,11,7,4,3,1,2
3343,4205,8586,63,6,3,3,1,1,0
3344,4207,8659,36,3,3,0,2,2,0
3345,4207,8466,64,3,1,2,1,1,0
3346,4208,9826,35,4,4,0,2,1,1
3347,4208,8654,65,5,0,5,3,1,2
3348,4209,10252,58,7,3,4,1,0,1
3349,4209,8659,42,1,1,0,1,0,1
3350,4210,8667,41,7,3,4,1,0,1
3351,4210,8472,59,3,0,3,0,0,0
3352,4212,8466,63,7,3,4,2,1,1
3353,4212,9826,37,7,2,5,0,0,0
3354,4213,8654,45,12,2,10,1,0,1
3355,4213,8455,55,7,2,5,1,0,1
3356,4214,8650,65,11,6,5,3,1,2
3357,4214,8191,35,4,2,2,0,0,0
3358,4215,8456,70,13,8,5,2,0,2
3359,4215,8197,30,4,2,2,0,0,0
3360,4216,10260,69,5,2,3,5,3,2
3361,4216,10261,31,2,0,2,1,1,0
3362,4217,10194,44,4,2,2,1,0,1
3363,4217,8668,56,7,3,4,1,0,1
3364,4218,8586,61,10,8,2,2,2,0
3365,4218,10003,39,4,0,4,2,1,1
3366,4219,9825,68,8,6,2,2,0,2
3367,4219,8654,32,2,1,1,1,0,1
3368,4220,8456,70,12,4,8,1,1,0
3369,4220,8191,30,2,1,1,0,0,0
3370,4221,8455,60,9,1,8,4,2,2
3371,4221,8466,40,6,4,2,0,0,0
3372,4222,10172,57,4,0,4,2,1,1
3373,4222,9826,43,2,0,2,0,0,0
3374,4223,10261,47,8,5,3,2,0,2
3375,4223,8668,53,9,4,5,0,0,0
3376,4225,10260,52,2,1,1,2,2,0
3377,4225,8586,48,2,0,2,2,1,1
3378,4226,10252,60,5,3,2,3,2,1
3379,4226,8472,40,4,0,4,1,1,0
3380,4227,8650,54,6,2,4,2,1,1
3381,4227,10003,46,8,5,3,2,1,1
3382,4228,8659,43,9,3,6,1,1,0
3383,4228,10194,57,4,1,3,0,0,0
3384,4229,10252,45,2,1,1,1,1,0
3385,4229,8667,55,2,0,2,1,0,1
3386,4230,8191,37,4,3,1,2,1,1
3387,4230,10260,63,4,1,3,1,0,1
3388,4231,8668,61,10,4,6,3,1,2
3389,4231,8455,39,5,2,3,0,0,0
3390,4232,9825,70,16,12,4,5,3,2
3391,4232,8197,30,5,2,3,2,1,1
3392,4233,8456,73,11,2,9,3,0,3
3393,4233,10194,27,2,2,0,2,0,2
3394,4234,9826,33,5,1,4,1,1,0
3395,4234,10261,67,4,2,2,2,1,1
3396,4235,10172,39,5,3,2,2,1,1
3397,4235,8472,61,8,2,6,2,0,2
3398,4236,10003,55,6,2,4,3,2,1
3399,4236,8659,45,7,1,6,1,1,0
3400,4237,8650,41,6,2,4,1,0,1
3401,4237,8586,59,3,1,2,1,0,1
3402,4238,8654,37,2,2,0,2,1,1
3403,4238,8466,63,9,2,7,0,0,0
3404,4239,10003,59,8,4,4,1,1,0
3405,4239,10252,41,7,3,4,0,0,0
3406,4240,8667,41,9,6,3,2,1,1
3407,4240,8455,59,4,0,4,0,0,0
3408,4241,10260,58,3,2,1,1,1,0
3409,4241,8650,42,2,1,1,2,0,2
3410,4242,8456,79,20,12,8,2,2,0
3411,4242,8659,21,0,0,0,2,0,2
3412,4244,8668,47,3,3,0,2,1,1
3413,4244,10172,53,4,2,2,1,0,1
3414,4245,8191,40,4,4,0,2,1,1
3415,4245,8466,60,8,3,5,2,0,2
3416,4246,9826,43,3,1,2,4,3,1
3417,4246,10194,57,6,1,5,2,0,2
3418,4247,8197,33,3,2,1,1,1,0
3419,4247,8586,67,2,1,1,0,0,0
3420,4248,8472,45,4,2,2,2,1,1
3421,4248,8654,55,8,2,6,2,1,1
3422,4249,9825,48,6,2,4,3,1,2
3423,4249,8650,52,4,1,3,2,0,2
3424,4250,8191,40,9,4,5,3,2,1
3425,4250,8586,60,5,3,2,0,0,0
3426,4251,8455,61,11,5,6,1,0,1
3427,4251,10194,39,2,0,2,2,0,2
3428,4252,8456,74,10,5,5,1,1,0
3429,4252,9826,26,1,1,0,5,3,2
3430,4253,8466,55,5,3,2,1,0,1
3431,4253,8668,45,5,5,0,0,0,0
3432,4254,8654,49,8,5,3,2,1,1
3433,4254,8197,51,6,2,4,0,0,0
3434,4255,10260,77,8,7,1,3,1,2
3435,4255,10252,23,2,2,0,0,0,0
3436,4256,8472,54,10,6,4,2,1,1
3437,4256,10261,46,4,1,3,2,1,1
3438,4257,10003,60,3,1,2,1,1,0
3439,4257,8667,40,4,1,3,3,1,2
3440,4260,8650,61,9,5,4,5,2,3
3441,4260,10261,39,4,2,2,3,1,2
3442,4261,8456,42,4,3,1,3,0,3
3443,4261,10260,58,6,1,5,1,0,1
3444,4262,10172,38,10,3,7,2,2,0
3445,4262,8455,62,3,2,1,0,0,0
3446,4264,9826,47,8,5,3,3,0,3
3447,4264,8472,53,3,1,2,0,0,0
3448,4265,10003,51,3,2,1,3,2,1
3449,4265,8668,49,8,4,4,1,0,1
3450,4266,10252,42,3,1,2,2,1,1
3451,4266,8586,58,5,3,2,0,0,0
3452,4270,10252,64,9,6,3,2,1,1
3453,4270,10172,36,4,2,2,3,0,3
3454,4271,8455,29,4,2,2,1,1,0
3455,4271,10260,71,5,0,5,1,0,1
3456,4272,9826,68,6,3,3,1,1,0
3457,4272,8659,32,2,0,2,0,0,0
3458,4274,8650,68,12,5,7,2,0,2
3459,4274,8667,32,5,4,1,0,0,0
3460,4276,8456,66,11,4,7,1,0,1
3461,4276,8654,34,7,4,3,0,0,0
3462,4277,10261,37,7,3,4,1,0,1
3463,4277,8586,63,7,2,5,0,0,0
3464,4279,8455,43,4,3,1,1,0,1
3465,4279,9825,57,4,2,2,0,0,0
3466,4281,9826,46,4,3,1,1,1,0
3467,4281,8667,54,7,4,3,1,1,0
3468,4282,10260,64,12,6,6,1,0,1
3469,4282,8668,36,5,3,2,0,0,0
3470,4283,8456,46,6,3,3,1,0,1
3471,4283,10252,54,4,2,2,0,0,0
3472,4284,10003,52,3,2,1,4,3,1
3473,4284,10261,48,1,0,1,0,0,0
3474,4285,10172,54,9,2,7,2,2,0
3475,4285,8654,46,3,2,1,3,2,1
3476,4286,8466,36,4,2,2,3,3,0
3477,4286,8586,64,3,1,2,2,2,0
3478,4287,10194,61,14,7,7,4,2,2
3479,4287,8472,39,6,0,6,1,0,1
3480,4288,8650,80,13,3,10,1,1,0
3481,4288,8659,20,4,0,4,2,0,2
3482,4291,9825,68,13,5,8,3,2,1
3483,4291,8667,32,2,1,1,1,1,0
3484,4292,8197,47,7,2,5,2,1,1
3485,4292,10261,53,5,2,3,3,1,2
3486,4293,8650,63,10,4,6,3,2,1
3487,4293,10172,37,3,1,2,3,0,3
3488,4294,8659,20,3,2,1,1,1,0
3489,4294,10260,80,15,5,10,5,3,2
3490,4295,8472,44,6,5,1,1,1,0
3491,4295,8466,56,3,1,2,1,1,0
3492,4296,10003,47,5,2,3,1,1,0
3493,4296,10194,53,4,2,2,1,1,0
3494,4298,8191,40,4,2,2,2,0,2
3495,4298,8654,60,14,3,11,0,0,0
3496,4299,10003,33,4,4,0,2,1,1
3497,4299,9825,67,20,3,17,0,0,0
3498,4300,10252,59,6,5,1,4,2,2
3499,4300,8654,41,3,1,2,0,0,0
3500,4301,8650,52,5,3,2,1,0,1
3501,4301,8455,48,4,3,1,0,0,0
3502,4302,10260,62,7,4,3,2,2,0
3503,4302,9826,38,5,1,4,0,0,0
3504,4304,8667,54,13,2,11,3,2,1
3505,4304,8191,46,2,1,1,0,0,0
3506,4305,8466,70,5,3,2,3,2,1
3507,4305,8197,30,3,2,1,0,0,0
3508,4306,8456,60,9,3,6,1,1,0
3509,4306,10172,40,4,1,3,1,1,0
3510,4309,8191,45,6,5,1,2,2,0
3511,4309,10194,55,5,2,3,0,0,0
3512,4310,8650,66,8,4,4,2,1,1
3513,4310,9826,34,5,1,4,1,1,0
3514,4311,10260,58,7,4,3,1,1,0
3515,4311,9825,42,4,0,4,0,0,0
3516,4312,10172,47,3,1,2,2,1,1
3517,4312,10261,53,17,7,10,1,0,1
3518,4313,8466,36,9,7,2,2,1,1
3519,4313,10252,64,4,1,3,3,2,1
3520,4315,10003,47,7,2,5,1,1,0
3521,4315,8456,53,11,3,8,1,0,1
3522,4316,8667,45,4,1,3,1,1,0
3523,4316,8586,55,2,0,2,0,0,0
3524,4317,8659,41,3,2,1,1,1,0
3525,4317,8455,59,7,4,3,2,0,2
3526,4319,9825,64,11,9,2,2,2,0
3527,4319,8659,36,7,1,6,1,0,1
3528,4320,8191,37,4,3,1,3,2,1
3529,4320,10252,63,7,4,3,1,0,1
3530,4321,8455,64,12,6,6,3,1,2
3531,4321,8472,36,9,3,6,2,1,1
3532,4323,8586,60,10,7,3,1,1,0
3533,4323,8668,40,3,2,1,1,0,1
3534,4324,8667,40,8,2,6,2,2,0
3535,4324,10260,60,4,2,2,0,0,0
3536,4326,8466,45,8,3,5,2,1,1
3537,4326,8456,55,7,5,2,1,0,1
3538,4327,10261,41,4,2,2,3,2,1
3539,4327,8654,59,1,1,0,0,0,0
3540,4328,10194,45,5,4,1,2,0,2
3541,4328,8650,55,8,1,7,1,0,1
3542,4329,9825,46,4,2,2,1,1,0
3543,4329,8456,54,8,3,5,1,0,1
3544,4331,9826,45,3,2,1,4,1,3
3545,4331,8191,55,7,3,4,1,1,0
3546,4332,8654,60,11,6,5,1,0,1
3547,4332,8667,40,6,2,4,0,0,0
3548,4333,10252,28,2,2,0,5,3,2
3549,4333,8650,72,6,1,5,1,0,1
3550,4334,10260,69,8,2,6,1,0,1
3551,4334,10172,31,4,1,3,0,0,0
3552,4335,8466,47,3,1,2,5,1,4
3553,4335,10261,53,4,2,2,0,0,0
3554,4337,8586,63,10,8,2,2,2,0
3555,4337,8472,37,3,1,2,0,0,0
3556,4339,10252,28,4,3,1,3,2,1
3557,4339,9825,72,4,3,1,0,0,0
3558,4340,8191,43,5,3,2,4,2,2
3559,4340,8472,57,7,4,3,3,1,2
3560,4341,9826,24,4,3,1,2,1,1
3561,4341,8668,76,6,2,4,0,0,0
3562,4343,8456,60,6,2,4,1,0,1
3563,4343,8455,40,3,1,2,0,0,0
3564,4346,10003,46,2,2,0,2,1,1
3565,4346,8466,54,3,0,3,1,1,0
3566,4347,8659,38,5,3,2,1,0,1
3567,4347,8586,62,3,1,2,0,0,0
3568,4349,9825,69,15,8,7,1,1,0
3569,4349,8586,31,6,5,1,0,0,0
3570,4350,8455,62,8,4,4,1,1,0
3571,4350,10252,38,2,1,1,2,1,1
3572,4351,8197,61,4,1,3,1,1,0
3573,4351,9826,39,7,5,2,1,1,0
3574,4352,8456,59,7,3,4,3,1,2
3575,4352,8667,41,4,1,3,0,0,0
3576,4353,8650,48,14,11,3,3,2,1
3577,4353,8668,52,6,3,3,0,0,0
3578,4354,10260,58,3,2,1,3,2,1
3579,4354,8654,42,1,0,1,1,0,1
3580,4355,8466,56,7,3,4,2,1,1
3581,4355,10172,44,0,0,0,0,0,0
3582,4356,10261,56,4,3,1,1,0,1
3583,4356,10194,44,6,1,5,0,0,0
3584,4357,8472,48,5,4,1,3,1,2
3585,4357,10003,52,1,0,1,0,0,0
3586,4358,8191,38,7,3,4,1,1,0
3587,4358,8659,62,10,7,3,1,1,0
3588,4360,8455,47,3,2,1,1,0,1
3589,4360,9825,53,3,0,3,0,0,0
3590,4361,8667,60,7,3,4,2,0,2
3591,4361,9826,40,5,1,4,1,0,1
3592,4362,8197,53,10,6,4,1,0,1
3593,4362,8191,47,3,2,1,0,0,0
3594,4365,10194,60,5,3,2,2,0,2
3595,4365,8472,40,2,0,2,1,0,1
3596,4366,10003,64,4,2,2,2,1,1
3597,4366,10261,36,3,0,3,0,0,0
3598,4367,8586,45,5,4,1,1,0,1
3599,4367,8466,55,5,3,2,0,0,0
3600,4368,8654,49,5,2,3,1,1,0
3601,4368,10172,51,5,1,4,3,0,3
3602,4371,9826,29,3,2,1,3,1,2
3603,4371,8455,71,5,3,2,3,2,1
3604,4372,8668,60,10,6,4,3,2,1
3605,4372,10252,40,6,2,4,3,2,1
3606,4373,8586,38,12,6,6,1,1,0
3607,4373,8456,62,11,4,7,3,1,2
3608,4375,10172,44,9,4,5,3,2,1
3609,4375,8650,56,6,1,5,3,1,2
3610,4377,10003,57,7,3,4,2,0,2
3611,4377,10194,43,6,5,1,2,0,2
3612,4378,8659,37,2,1,1,1,0,1
3613,4378,10260,63,11,4,7,0,0,0
3614,4379,8191,38,7,4,3,2,2,0
3615,4379,8668,62,8,1,7,1,0,1
3616,4380,8650,66,14,5,9,3,1,2
3617,4380,8667,34,3,1,2,0,0,0
3618,4381,10260,52,6,2,4,4,0,4
3619,4381,8455,48,3,1,2,2,0,2
3620,4382,10252,65,10,7,3,1,0,1
3621,4382,10172,35,3,1,2,0,0,0
3622,4383,8466,62,5,5,0,3,2,1
3623,4383,10194,38,2,2,0,0,0,0
3624,4385,10003,49,2,2,0,1,1,0
3625,4385,8197,51,4,0,4,0,0,0
3626,4386,8586,68,8,4,4,1,1,0
3627,4386,10261,32,2,1,1,0,0,0
3628,4387,9826,31,7,5,2,4,1,3
3629,4387,8659,69,7,2,5,0,0,0
3630,4388,8456,69,9,4,5,3,3,0
3631,4388,8654,31,4,2,2,0,0,0
3632,4392,9817,33,6,3,3,3,1,2
3633,4392,8668,67,4,3,1,0,0,0
3634,4393,8472,56,5,3,2,1,0,1
3635,4393,8197,44,8,5,3,0,0,0
3636,4394,8586,49,6,3,3,2,0,2
3637,4394,10260,51,6,5,1,1,0,1
3638,4395,10261,56,4,4,0,2,1,1
3639,4395,8466,44,5,2,3,2,1,1
3640,4396,9826,37,6,4,2,2,0,2
3641,4396,9850,63,7,2,5,0,0,0
3642,4398,8456,67,11,5,6,3,2,1
3643,4398,8659,33,5,0,5,0,0,0
3644,4400,10252,48,4,2,2,1,1,0
3645,4400,10003,52,3,0,3,0,0,0
3646,4401,8586,55,7,2,5,2,0,2
3647,4401,8678,45,4,2,2,0,0,0
3648,4402,8197,48,5,4,1,3,2,1
3649,4402,9826,52,5,2,3,0,0,0
3650,4404,8456,40,3,1,2,1,0,1
3651,4404,10260,60,1,0,1,1,0,1
3652,4406,9817,33,7,3,4,3,1,2
3653,4406,10194,67,2,2,0,0,0,0
3654,4407,10261,61,13,8,5,2,1,1
3655,4407,8472,39,4,2,2,0,0,0
3656,4408,8455,55,5,3,2,2,2,0
3657,4408,8654,45,6,3,3,0,0,0
3658,4409,8650,57,8,4,4,1,0,1
3659,4409,8455,43,5,0,5,1,0,1
3660,4410,9826,45,9,6,3,2,0,2
3661,4410,10260,55,3,1,2,2,0,2
3662,4411,8668,69,4,4,0,3,1,2
3663,4411,8472,31,11,4,7,1,0,1
3664,4412,8456,72,8,5,3,2,2,0
3665,4412,9850,28,4,2,2,0,0,0
3666,4413,10261,52,10,2,8,1,1,0
3667,4413,10194,48,2,0,2,0,0,0
3668,4414,8466,49,3,3,0,1,1,0
3669,4414,8678,51,6,1,5,1,0,1
3670,4415,9825,46,3,2,1,1,1,0
3671,4415,10003,54,7,3,4,2,0,2
3672,4416,10252,38,6,2,4,6,2,4
3673,4416,8586,62,8,1,7,0,0,0
3674,4417,8654,51,3,2,1,3,1,2
3675,4417,9817,49,12,8,4,1,0,1
3676,4418,8197,54,5,5,0,5,3,2
3677,4418,8659,46,7,1,6,1,0,1
3678,4419,8586,45,4,1,3,2,1,1
3679,4419,9825,55,2,0,2,1,1,0
3680,4421,8678,68,12,8,4,1,1,0
3681,4421,10261,32,0,0,0,0,0,0
3682,4424,10260,70,5,3,2,2,0,2
3683,4424,8659,30,1,1,0,1,0,1
3684,4425,9850,33,4,1,3,2,0,2
3685,4425,10003,67,1,1,0,2,0,2
3686,4426,10194,37,2,2,0,1,1,0
3687,4426,8455,63,9,5,4,2,1,1
3688,4427,8466,66,7,3,4,1,0,1
3689,4427,8472,34,2,0,2,0,0,0
3690,4428,8668,49,7,6,1,1,0,1
3691,4428,8654,51,6,1,5,0,0,0
3692,4429,9850,34,3,2,1,4,2,2
3693,4429,8455,66,11,6,5,0,0,0
3694,4430,9826,67,10,3,7,3,2,1
3695,4430,8472,33,5,1,4,2,1,1
3696,4431,8668,59,9,3,6,1,1,0
3697,4431,10252,41,8,1,7,1,1,0
3698,4432,8456,59,5,1,4,1,1,0
3699,4432,8650,41,9,2,7,2,0,2
3700,4435,10003,43,7,4,3,2,0,2
3701,4435,8678,57,6,3,3,1,0,1
3702,4436,8586,56,11,4,7,3,3,0
3703,4436,8654,44,2,1,1,2,0,2
3704,4437,10260,57,6,1,5,1,1,0
3705,4437,9817,43,7,0,7,0,0,0
3706,4438,9825,73,6,1,5,1,1,0
3707,4438,8659,27,1,1,0,2,1,1
3708,4439,10252,66,6,6,0,3,2,1
3709,4439,9817,34,9,5,4,1,0,1
3710,4440,8678,58,12,3,9,2,1,1
3711,4440,8668,42,5,2,3,0,0,0
3712,4441,10261,46,3,2,1,2,2,0
3713,4441,9826,54,7,2,5,1,0,1
3714,4442,10260,68,6,4,2,2,1,1
3715,4442,8197,32,3,1,2,2,0,2
3716,4445,9825,63,3,1,2,1,1,0
3717,4445,9850,37,2,1,1,0,0,0
3718,4446,8472,48,7,4,3,3,2,1
3719,4446,10194,52,3,1,2,0,0,0
3720,4447,8586,56,7,5,2,1,0,1
3721,4447,8455,44,1,0,1,0,0,0
3722,4448,8654,61,8,3,5,1,0,1
3723,4448,8659,39,5,0,5,0,0,0
3724,4449,8472,26,5,1,4,1,1,0
3725,4449,9825,74,8,1,7,1,0,1
3726,4450,8455,63,11,6,5,1,0,1
3727,4450,8678,37,7,5,2,2,0,2
3728,4452,8654,37,5,2,3,3,1,2
3729,4452,10260,63,7,3,4,3,0,3
3730,4455,8456,54,4,2,2,5,0,5
3731,4455,10194,46,2,0,2,0,0,0
3732,4456,8197,40,5,2,3,2,1,1
3733,4456,10003,60,3,0,3,2,0,2
3734,4457,9817,51,8,2,6,1,0,1
3735,4457,9850,49,2,0,2,1,0,1
3736,4458,8659,35,6,2,4,1,0,1
3737,4458,8586,65,6,1,5,0,0,0
3738,4459,10252,46,7,2,5,1,1,0
3739,4459,9825,54,4,2,2,0,0,0
3740,4460,8678,43,4,3,1,1,1,0
3741,4460,10260,57,6,3,3,2,0,2
3742,4461,8466,57,7,4,3,1,0,1
3743,4461,9826,43,10,3,7,1,0,1
3744,4462,8197,34,4,3,1,1,1,0
3745,4462,8455,66,8,1,7,1,1,0
3746,4463,8650,70,15,6,9,1,1,0
3747,4463,8659,30,2,2,0,1,0,1
3748,4465,8668,59,4,1,3,3,2,1
3749,4465,9850,41,1,0,1,3,3,0
3750,4466,9817,53,8,4,4,4,2,2
3751,4466,8472,47,2,0,2,3,0,3
3752,4467,8586,58,12,6,6,2,2,0
3753,4467,10261,42,3,0,3,0,0,0
3754,4468,8654,46,21,8,13,2,1,1
3755,4468,10194,54,4,0,4,0,0,0
3756,4469,8456,63,10,3,7,3,1,2
3757,4469,9825,37,3,0,3,2,1,1
3758,4470,8455,68,7,3,4,1,1,0
3759,4470,8472,32,4,1,3,0,0,0
3760,4471,8668,68,8,3,5,1,1,0
3761,4471,8197,32,1,0,1,1,0,1
3762,4473,10261,47,4,2,2,1,1,0
3763,4473,10252,53,6,2,4,1,0,1
3764,4474,8466,51,10,4,6,2,2,0
3765,4474,8586,49,6,2,4,1,0,1
3766,4475,10194,59,11,2,9,3,2,1
3767,4475,9826,41,4,0,4,0,0,0
3768,4477,8650,66,8,2,6,3,2,1
3769,4477,9817,34,3,2,1,2,0,2
3770,4478,8678,69,7,3,4,2,1,1
3771,4478,8659,31,3,0,3,2,1,1
3772,4479,8654,41,5,2,3,1,1,0
3773,4479,10252,59,8,3,5,0,0,0
3774,4480,9826,45,4,1,3,2,2,0
3775,4480,8678,55,8,3,5,0,0,0
3776,4481,8455,62,8,3,5,1,1,0
3777,4481,9817,38,8,3,5,0,0,0
3778,4482,8650,61,13,12,1,1,1,0
3779,4482,8197,39,3,1,2,1,0,1
3780,4483,8472,34,4,2,2,1,0,1
3781,4483,8456,66,8,4,4,0,0,0
3782,4484,8668,61,11,3,8,3,2,1
3783,4484,10261,39,3,0,3,0,0,0
3784,4485,8466,35,5,1,4,2,1,1
3785,4485,9825,65,5,3,2,1,0,1
3786,4486,10260,58,8,4,4,1,0,1
3787,4486,10194,42,4,3,1,0,0,0
3788,4488,9850,41,4,3,1,4,2,2
3789,4488,8586,59,9,4,5,0,0,0
3790,4491,10194,49,3,2,1,4,2,2
3791,4491,8668,51,3,2,1,0,0,0
3792,4492,8456,61,12,6,6,4,3,1
3793,4492,8197,39,5,2,3,0,0,0
3794,4493,8455,33,3,1,2,1,1,0
3795,4493,10260,67,6,3,3,0,0,0
3796,4494,10252,52,4,2,2,1,0,1
3797,4494,9850,48,3,1,2,1,0,1
3798,4495,8650,59,8,5,3,1,0,1
3799,4495,8472,41,3,1,2,0,0,0
3800,4496,9817,37,5,2,3,4,2,2
3801,4496,8586,63,3,0,3,2,0,2
3802,4497,8659,52,15,10,5,2,1,1
3803,4497,10261,48,4,2,2,2,0,2
3804,4499,10260,54,3,1,2,2,1,1
3805,4499,10252,46,2,0,2,2,2,0
3806,4500,9825,59,14,8,6,2,1,1
3807,4500,9826,41,6,3,3,1,0,1
3808,4501,8650,56,4,2,2,4,2,2
3809,4501,8678,44,5,0,5,2,2,0
3810,4502,8456,49,9,4,5,1,1,0
3811,4502,8455,51,7,2,5,2,1,1
3812,4503,8668,45,5,4,1,3,2,1
3813,4503,8466,55,9,3,6,1,0,1
3814,4504,8472,45,2,1,1,2,0,2
3815,4504,9850,55,9,5,4,0,0,0
3816,4505,10003,67,9,4,5,1,1,0
3817,4505,10261,33,2,2,0,0,0,0
3818,4507,9817,65,10,4,6,3,0,3
3819,4507,8659,35,1,1,0,0,0,0
3820,4509,9825,51,4,1,3,1,1,0
3821,4509,10261,49,7,5,2,1,1,0
3822,4510,9826,39,5,2,3,3,2,1
3823,4510,8455,61,5,2,3,4,2,2
3824,4511,8586,60,11,7,4,1,1,0
3825,4511,8668,40,8,1,7,1,0,1
3826,4512,8678,48,4,1,3,2,2,0
3827,4512,8197,52,6,1,5,1,0,1
3828,4513,10260,56,10,6,4,3,1,2
3829,4513,10003,44,5,2,3,0,0,0
3830,4514,8466,59,5,5,0,1,0,1
3831,4514,9850,41,3,0,3,1,0,1
3832,4517,10194,54,9,8,1,2,1,1
3833,4517,8659,46,6,1,5,2,0,2
3834,4518,8654,35,6,1,5,1,1,0
3835,4518,8650,65,12,6,6,0,0,0
3836,4519,10252,52,6,5,1,3,1,2
3837,4519,9826,48,2,0,2,0,0,0
3838,4520,8654,52,3,2,1,3,1,2
3839,4520,8678,48,7,3,4,0,0,0
3840,4521,10003,52,6,2,4,4,1,3
3841,4521,8472,48,2,1,1,0,0,0
3842,4522,8650,59,11,4,7,1,1,0
3843,4522,9825,41,4,2,2,2,0,2
3844,4523,8659,38,5,2,3,5,3,2
3845,4523,8455,62,6,3,3,2,1,1
3846,4524,8668,45,4,2,2,4,2,2
3847,4524,8456,55,12,2,10,1,1,0
3848,4525,10260,46,3,1,2,4,2,2
3849,4525,10261,54,6,1,5,0,0,0
3850,4527,10194,64,5,3,2,3,2,1
3851,4527,9850,36,1,1,0,2,0,2
3852,4528,8586,62,12,6,6,4,2,2
3853,4528,8197,38,5,1,4,0,0,0
3854,4529,8197,43,6,4,2,3,2,1
3855,4529,10252,57,8,3,5,3,2,1
3856,4530,8678,46,6,1,5,2,1,1
3857,4530,9850,54,7,3,4,0,0,0
3858,4531,8668,46,5,3,2,3,1,2
3859,4531,8455,54,10,2,8,2,0,2
3860,4532,8650,53,10,2,8,1,0,1
3861,4532,10260,47,1,1,0,0,0,0
3862,4535,8466,57,5,4,1,2,2,0
3863,4535,8659,43,2,1,1,2,0,2
3864,4536,10194,45,8,2,6,2,1,1
3865,4536,9825,55,6,2,4,1,1,0
3866,4537,9817,43,5,3,2,1,1,0
3867,4537,10003,57,3,2,1,1,1,0
3868,4539,8455,54,8,7,1,4,2,2
3869,4539,9825,46,2,0,2,2,1,1
3870,4540,8586,65,13,5,8,1,0,1
3871,4540,9826,35,5,1,4,1,0,1
3872,4541,8668,60,8,3,5,3,2,1
3873,4541,10003,40,3,0,3,1,0,1
3874,4542,8197,45,4,3,1,2,1,1
3875,4542,10194,55,4,2,2,3,1,2
3876,4543,10260,56,3,2,1,3,2,1
3877,4543,8466,44,1,0,1,0,0,0
3878,4546,10261,48,2,2,0,2,2,0
3879,4546,9817,52,4,3,1,1,0,1
3880,4547,8659,39,1,1,0,1,1,0
3881,4547,10252,61,8,4,4,2,0,2
3882,4548,8456,53,12,1,11,4,2,2
3883,4548,8654,47,2,1,1,1,0,1
3884,4549,9825,67,15,4,11,2,1,1
3885,4549,8466,33,10,3,7,0,0,0
3886,4550,8197,63,7,6,1,2,1,1
3887,4550,8650,37,9,5,4,2,1,1
3888,4551,8586,59,6,6,0,1,0,1
3889,4551,9850,41,3,1,2,0,0,0
3890,4552,8472,49,6,2,4,2,2,0
3891,4552,8456,51,2,1,1,3,1,2
3892,4553,8455,55,9,2,7,1,1,0
3893,4553,9817,45,7,7,0,2,1,1
3894,4554,10252,32,2,1,1,5,2,3
3895,4554,8654,68,3,1,2,0,0,0
3896,4556,10260,45,6,6,0,3,1,2
3897,4556,10194,55,3,1,2,1,0,1
3898,4557,8659,44,7,2,5,1,0,1
3899,4557,10003,56,8,3,5,1,0,1
3900,4558,8668,55,6,2,4,3,2,1
3901,4558,10261,45,4,0,4,0,0,0
3902,4559,9850,51,8,2,6,4,1,3
3903,4559,10252,49,1,0,1,0,0,0
3904,4560,9825,49,6,3,3,5,2,3
3905,4560,8678,51,11,5,6,1,0,1
3906,4561,10260,52,12,7,5,4,1,3
3907,4561,8455,48,10,3,7,1,0,1
3908,4562,8650,74,6,3,3,1,1,0
3909,4562,8472,26,1,0,1,2,0,2
3910,4563,8197,35,5,3,2,1,1,0
3911,4563,8456,65,8,3,5,1,1,0
3912,4564,10261,69,11,6,5,2,1,1
3913,4564,8659,31,1,1,0,2,0,2
3914,4565,8466,36,3,2,1,1,1,0
3915,4565,8654,64,11,6,5,1,1,0
3916,4567,10003,58,8,2,6,2,1,1
3917,4567,9826,42,2,0,2,2,2,0
3918,4569,8197,27,3,2,1,1,1,0
3919,4569,9825,73,10,1,9,1,0,1
3920,4570,8650,61,3,2,1,2,0,2
3921,4570,10252,39,3,1,2,1,0,1
3922,4571,10194,35,3,3,0,2,0,2
3923,4571,8678,65,5,2,3,0,0,0
3924,4572,10261,47,5,4,1,1,0,1
3925,4572,8455,53,8,5,3,0,0,0
3926,4573,9826,52,7,3,4,1,1,0
3927,4573,9817,48,4,1,3,0,0,0
3928,4574,8668,76,17,9,8,1,0,1
3929,4574,8659,24,1,0,1,2,0,2
3930,4575,8456,44,6,1,5,1,0,1
3931,4575,8586,56,1,1,0,0,0,0
3932,4576,8654,52,5,1,4,2,1,1
3933,4576,9850,48,3,0,3,3,0,3
3934,4577,8472,34,9,2,7,3,0,3
3935,4577,10260,66,8,3,5,1,0,1
3936,4578,8466,45,10,6,4,1,0,1
3937,4578,10003,55,6,2,4,0,0,0
3938,4579,8197,59,6,4,2,1,0,1
3939,4579,9850,41,2,1,1,0,0,0
3940,4580,8650,67,21,11,10,2,1,1
3941,4580,8668,33,1,1,0,0,0,0
3942,4581,9825,61,6,3,3,1,1,0
3943,4581,10260,39,3,1,2,0,0,0
3944,4582,10261,43,2,1,1,1,0,1
3945,4582,8456,57,5,0,5,1,0,1
3946,4583,8455,66,5,2,3,1,0,1
3947,4583,8466,34,4,1,3,1,0,1
3948,4584,10194,56,3,0,3,2,2,0
3949,4584,10252,44,0,0,0,1,1,0
3950,4586,9817,47,6,3,3,2,2,0
3951,4586,8678,53,5,1,4,1,0,1
3952,4587,8659,47,3,2,1,2,1,1
3953,4587,9826,53,5,2,3,3,1,2
3954,4588,8472,46,6,1,5,1,0,1
3955,4588,8654,54,2,1,1,0,0,0
3956,4589,9825,62,9,6,3,2,1,1
3957,4589,10003,38,2,1,1,5,2,3
3958,4590,10252,46,7,5,2,3,1,2
3959,4590,8668,54,4,2,2,0,0,0
3960,4591,8678,46,5,4,1,2,1,1
3961,4591,8466,54,2,1,1,2,0,2
3962,4593,8455,55,5,4,1,2,1,1
3963,4593,9850,45,3,0,3,2,0,2
3964,4594,9826,42,7,3,4,2,1,1
3965,4594,8472,58,8,5,3,1,0,1
3966,4595,8586,66,3,1,2,1,1,0
3967,4595,8654,34,7,5,2,4,1,3
3968,4596,8650,51,5,2,3,1,0,1
3969,4596,8456,49,2,1,1,0,0,0
3970,4597,9817,38,5,4,1,2,1,1
3971,4597,10260,62,7,1,6,3,0,3
3972,4598,10261,45,4,3,1,2,1,1
3973,4598,10194,55,2,1,1,2,1,1
3974,4599,10194,53,9,2,7,3,3,0
3975,4599,8455,47,11,6,5,0,0,0
3976,4600,9826,39,8,3,5,1,0,1
3977,4600,8650,61,8,2,6,0,0,0
3978,4601,8668,41,10,5,5,2,1,1
3979,4601,8654,59,9,4,5,1,1,0
3980,4602,8456,73,7,5,2,1,1,0
3981,4602,10252,27,2,1,1,3,1,2
3982,4603,8678,52,10,3,7,2,0,2
3983,4603,10261,48,7,2,5,0,0,0
3984,4604,8466,65,9,4,5,1,1,0
3985,4604,8472,35,3,0,3,6,1,5
3986,4605,9850,44,6,2,4,2,2,0
3987,4605,10003,56,5,0,5,2,1,1
3988,4609,8650,34,8,5,3,1,1,0
3989,4609,9825,66,10,2,8,3,2,1
3990,4611,8456,55,10,7,3,1,1,0
3991,4611,8668,45,4,1,3,1,0,1
3992,4612,8586,65,8,4,4,3,2,1
3993,4612,8197,35,5,3,2,0,0,0
3994,4613,10260,69,16,9,7,6,4,2
3995,4613,10261,31,3,3,0,1,1,0
3996,4614,9850,42,10,3,7,6,3,3
3997,4614,10194,58,2,0,2,2,2,0
3998,4615,8472,39,6,3,3,2,2,0
3999,4615,10003,61,12,3,9,2,0,2
4000,4616,9817,51,6,1,5,2,1,1
4001,4616,8466,49,7,2,5,0,0,0
4002,4617,8455,56,3,2,1,3,0,3
4003,4617,8659,44,6,0,6,0,0,0
4004,4618,8678,54,4,3,1,1,0,1
4005,4618,8654,46,5,1,4,0,0,0
4006,4619,9825,71,7,2,5,1,1,0
4007,4619,8659,29,2,0,2,1,0,1
4008,4620,8586,63,8,6,2,1,0,1
4009,4620,10252,37,6,2,4,0,0,0
4010,4621,8678,44,5,3,2,2,1,1
4011,4621,10003,56,3,0,3,2,1,1
4012,4622,10261,51,4,2,2,3,2,1
4013,4622,8197,49,3,0,3,2,2,0
4014,4623,8650,55,17,9,8,4,2,2
4015,4623,8455,45,9,4,5,2,1,1
4016,4624,10260,60,12,7,5,2,1,1
4017,4624,9826,40,4,1,3,0,0,0
4018,4625,8456,66,11,6,5,2,0,2
4019,4625,9850,34,0,0,0,0,0,0
4020,4626,10194,61,5,2,3,1,1,0
4021,4626,8466,39,5,3,2,0,0,0
4022,4627,8472,38,8,5,3,1,0,1
4023,4627,8668,62,9,0,9,0,0,0
4024,4628,8654,54,7,3,4,3,1,2
4025,4628,9817,46,3,3,0,2,2,0
4026,4629,8455,57,6,2,4,1,1,0
4027,4629,8654,43,5,1,4,3,2,1
4028,4630,9826,56,8,4,4,2,1,1
4029,4630,8197,44,4,2,2,2,0,2
4030,4631,9825,45,4,2,2,1,0,1
4031,4631,8668,55,5,3,2,0,0,0
4032,4632,8456,55,6,3,3,1,1,0
4033,4632,10260,45,4,1,3,1,0,1
4034,4633,8472,52,5,3,2,1,0,1
4035,4633,10261,48,9,1,8,0,0,0
4036,4635,10252,47,7,4,3,5,2,3
4037,4635,10003,53,3,2,1,1,0,1
4038,4636,8586,61,6,3,3,1,0,1
4039,4636,8678,39,0,0,0,0,0,0
4040,4637,9817,52,3,1,2,3,1,2
4041,4637,10194,48,5,2,3,1,1,0
4042,4638,9850,49,3,2,1,2,1,1
4043,4638,8659,51,4,2,2,1,1,0
4044,4639,9825,64,10,7,3,2,0,2
4045,4639,9817,36,3,1,2,0,0,0
4046,4640,10252,43,9,6,3,2,2,0
4047,4640,8455,57,4,1,3,0,0,0
4048,4641,8456,55,4,2,2,2,0,2
4049,4641,8678,45,5,2,3,1,0,1
4050,4642,8197,47,6,1,5,1,1,0
4051,4642,8466,53,4,2,2,0,0,0
4052,4643,8650,43,10,6,4,2,1,1
4053,4643,8586,57,7,3,4,2,0,2
4054,4644,8668,52,7,2,5,1,1,0
4055,4644,10260,48,5,3,2,2,0,2
4056,4645,9850,43,3,3,0,3,1,2
4057,4645,10261,57,6,0,6,2,0,2
4058,4646,10003,53,5,2,3,2,1,1
4059,4646,10194,47,4,2,2,0,0,0
4060,4647,8659,44,1,1,0,2,2,0
4061,4647,8472,56,9,4,5,0,0,0
4062,4648,9826,33,4,1,3,1,0,1
4063,4648,8654,67,8,5,3,3,0,3
4064,4649,8678,59,4,3,1,3,3,0
4065,4649,10252,41,0,0,0,0,0,0
4066,4651,10194,47,2,1,1,1,1,0
4067,4651,8650,53,5,2,3,2,1,1
4068,4652,8456,61,5,1,4,2,2,0
4069,4652,8659,39,3,1,2,1,0,1
4070,4653,8466,51,7,4,3,1,0,1
4071,4653,10261,49,3,1,2,0,0,0
4072,4654,8197,49,8,3,5,1,1,0
4073,4654,8472,51,5,2,3,1,0,1
4074,4655,8455,60,5,2,3,2,1,1
4075,4655,10003,40,8,4,4,0,0,0
4076,4656,10260,55,2,1,1,1,1,0
4077,4656,8586,45,7,1,6,0,0,0
4078,4657,9817,40,6,3,3,1,0,1
4079,4657,8668,60,7,2,5,0,0,0
4080,4658,8654,38,11,6,5,2,1,1
4081,4658,9825,62,4,3,1,0,0,0
4082,4659,9825,65,9,2,7,1,0,1
4083,4659,9826,35,2,1,1,3,0,3
4084,4660,8650,49,9,8,1,2,1,1
4085,4660,8678,51,11,4,7,3,1,2
4086,4661,8455,51,7,3,4,3,1,2
4087,4661,8456,49,6,3,3,2,0,2
4088,4662,8668,49,4,1,3,2,1,1
4089,4662,8466,51,5,2,3,0,0,0
4090,4663,8654,57,4,2,2,1,1,0
4091,4663,8197,43,0,0,0,1,1,0
4092,4664,10260,65,4,2,2,2,0,2
4093,4664,10252,35,2,1,1,0,0,0
4094,4665,10261,34,4,3,1,2,0,2
4095,4665,10003,66,4,0,4,0,0,0
4096,4666,9850,58,10,6,4,2,2,0
4097,4666,8472,42,0,0,0,0,0,0
4098,4667,8586,48,5,3,2,2,1,1
4099,4667,10194,52,3,2,1,1,1,0
4100,4668,9817,37,5,2,3,1,1,0
4101,4668,8659,63,6,4,2,1,1,0
4102,4669,10252,42,9,4,5,3,1,2
4103,4669,8466,58,6,2,4,0,0,0
4104,4670,8455,55,4,3,1,2,2,0
4105,4670,8678,45,5,3,2,0,0,0
4106,4671,9826,57,10,4,6,1,1,0
4107,4671,8668,43,7,5,2,1,1,0
4108,4672,10003,60,5,2,3,1,1,0
4109,4672,8197,40,8,3,5,2,1,1
4110,4673,8650,67,7,1,6,1,0,1
4111,4673,10261,33,1,0,1,0,0,0
4112,4674,10194,47,3,1,2,2,2,0
4113,4674,8456,53,4,1,3,0,0,0
4114,4675,9817,44,8,2,6,2,1,1
4115,4675,9850,56,9,5,4,1,0,1
4116,4676,9825,70,14,9,5,2,1,1
4117,4676,8472,30,5,2,3,3,1,2
4118,4677,8586,66,7,6,1,2,1,1
4119,4677,8659,34,6,3,3,3,0,3
4120,4678,8654,47,6,3,3,1,0,1
4121,4678,10260,53,1,0,1,1,0,1
4122,4679,9850,31,6,3,3,3,1,2
4123,4679,9825,69,7,3,4,1,0,1
4124,4680,8586,53,6,3,3,1,1,0
4125,4680,8455,47,5,1,4,2,1,1
4126,4681,8668,56,4,1,3,2,1,1
4127,4681,8678,44,6,2,4,3,1,2
4128,4682,10260,67,17,9,8,4,1,3
4129,4682,8197,33,4,0,4,1,0,1
4130,4684,8466,43,4,1,3,1,0,1
4131,4684,8456,57,4,2,2,0,0,0
4132,4685,8472,47,6,3,3,2,1,1
4133,4685,10194,53,4,2,2,0,0,0
4134,4686,10003,47,9,6,3,2,1,1
4135,4686,8650,53,5,3,2,0,0,0
4136,4687,9817,65,8,4,4,1,1,0
4137,4687,10252,35,1,0,1,0,0,0
4138,4688,8659,46,7,5,2,3,3,0
4139,4688,8654,54,1,1,0,1,0,1
4140,4689,10261,53,7,3,4,4,1,3
4141,4689,10252,47,0,0,0,0,0,0
4142,4690,8678,59,6,2,4,3,2,1
4143,4690,8659,41,4,2,2,3,2,1
4144,4691,9826,57,6,4,2,2,2,0
4145,4691,10194,43,3,2,1,1,0,1
4146,4692,8197,47,15,4,11,3,1,2
4147,4692,8668,53,4,1,3,2,0,2
4148,4693,8650,66,9,4,5,1,0,1
4149,4693,9817,34,3,1,2,0,0,0
4150,4694,8456,61,2,1,1,3,1,2
4151,4694,9825,39,1,0,1,0,0,0
4152,4695,9850,33,6,4,2,2,1,1
4153,4695,10260,67,8,7,1,1,0,1
4154,4696,8472,31,7,3,4,1,1,0
4155,4696,8455,69,7,2,5,3,0,3
4156,4697,8586,70,9,4,5,3,2,1
4157,4697,8466,30,3,1,2,0,0,0
4158,4698,8654,52,12,5,7,1,1,0
4159,4698,10003,48,6,2,4,2,1,1
4160,4699,9825,60,7,4,3,1,0,1
4161,4699,10252,40,4,1,3,0,0,0
4162,4700,8455,54,11,9,2,1,0,1
4163,4700,8197,46,10,3,7,0,0,0
4164,4701,8668,47,9,6,3,2,1,1
4165,4701,9850,53,4,3,1,1,0,1
4166,4702,10260,68,5,1,4,1,1,0
4167,4702,8678,32,5,2,3,1,1,0
4168,4703,8586,61,8,4,4,4,1,3
4169,4703,10261,39,11,8,3,0,0,0
4170,4704,9826,51,5,4,1,2,2,0
4171,4704,8466,49,4,3,1,4,2,2
4172,4705,8654,55,10,2,8,2,0,2
4173,4705,10194,45,3,0,3,1,0,1
4174,4706,8456,51,5,4,1,2,1,1
4175,4706,10003,49,1,1,0,0,0,0
4176,4707,9817,49,6,5,1,1,1,0
4177,4707,8472,51,2,1,1,0,0,0
4178,4708,8650,67,3,3,0,2,1,1
4179,4708,8659,33,5,1,4,1,0,1
4180,4709,10252,62,10,4,6,1,1,0
4181,4709,8472,38,2,0,2,3,1,2
4182,4710,8678,57,1,1,0,2,1,1
4183,4710,8197,43,1,0,1,2,0,2
4184,4711,8455,64,17,7,10,1,1,0
4185,4711,9826,36,4,2,2,2,0,2
4186,4713,8456,60,8,4,4,4,3,1
4187,4713,9817,40,4,1,3,1,1,0
4188,4714,9825,74,16,6,10,1,0,1
4189,4714,10261,26,0,0,0,0,0,0
4190,4716,10194,49,7,3,4,2,0,2
4191,4716,8659,51,8,5,3,1,0,1
4192,4717,10260,64,5,3,2,1,0,1
4193,4717,10003,36,3,2,1,0,0,0
4194,4720,9826,41,4,3,1,1,1,0
4195,4720,8456,59,11,6,5,5,2,3
4196,4722,8197,48,7,3,4,2,0,2
4197,4722,10252,52,6,5,1,0,0,0
4198,4723,10260,56,3,0,3,1,1,0
4199,4723,8650,44,3,0,3,0,0,0
4200,4725,8472,43,7,5,2,4,1,3
4201,4725,8586,57,8,4,4,1,0,1
4202,4726,9817,41,8,3,5,1,0,1
4203,4726,10003,59,4,3,1,1,0,1
4204,4727,8466,65,9,3,6,2,1,1
4205,4727,8659,35,2,0,2,0,0,0
4206,4728,10261,61,8,3,5,4,1,3
4207,4728,8654,39,6,0,6,0,0,0
4208,4729,8659,40,7,3,4,2,0,2
4209,4729,10252,60,9,4,5,1,0,1
4210,4731,9825,38,4,2,2,4,1,3
4211,4731,8455,62,16,7,9,1,1,0
4212,4732,8650,60,14,6,8,1,0,1
4213,4732,9850,40,3,0,3,0,0,0
4214,4733,8456,72,14,5,9,1,1,0
4215,4733,8654,28,2,1,1,1,0,1
4216,4734,10261,58,8,4,4,1,1,0
4217,4734,9817,42,5,4,1,0,0,0
4218,4735,8466,41,7,3,4,1,0,1
4219,4735,10260,59,1,0,1,1,0,1
4220,4737,8668,53,9,4,5,1,1,0
4221,4737,10003,47,8,3,5,1,0,1
4222,4738,8586,58,11,4,7,1,1,0
4223,4738,9826,42,8,4,4,0,0,0
4224,4739,9825,59,15,6,9,2,0,2
4225,4739,8197,41,8,3,5,0,0,0
4226,4741,10260,66,8,5,3,1,1,0
4227,4741,8472,34,7,3,4,0,0,0
4228,4742,10261,36,6,6,0,3,1,2
4229,4742,8455,64,5,2,3,1,1,0
4230,4743,10003,58,8,3,5,2,1,1
4231,4743,8466,42,7,2,5,1,0,1
4232,4744,10194,43,4,2,2,1,1,0
4233,4744,8678,57,8,3,5,3,0,3
4234,4745,8586,47,7,5,2,3,1,2
4235,4745,8456,53,15,8,7,3,0,3
4236,4746,9817,55,7,4,3,1,1,0
4237,4746,9826,45,8,5,3,0,0,0
4238,4747,8659,46,3,1,2,2,2,0
4239,4747,8668,54,5,2,3,0,0,0
4240,4748,9850,57,7,2,5,1,0,1
4241,4748,8654,43,8,4,4,1,0,1
4242,4749,9825,38,4,1,3,2,1,1
4243,4749,10260,62,5,1,4,2,0,2
4244,4750,10194,45,7,4,3,2,2,0
4245,4750,10252,55,8,0,8,0,0,0
4246,4751,9817,46,5,2,3,1,0,1
4247,4751,8678,54,8,2,6,0,0,0
4248,4752,8455,59,6,4,2,2,1,1
4249,4752,8466,41,7,2,5,1,0,1
4250,4753,9826,60,15,10,5,1,1,0
4251,4753,8659,40,4,2,2,2,2,0
4252,4755,8456,64,11,6,5,3,1,2
4253,4755,10261,36,4,4,0,0,0,0
4254,4757,8472,44,4,3,1,2,0,2
4255,4757,8654,56,9,1,8,0,0,0
4256,4758,8586,55,14,8,6,3,1,2
4257,4758,10003,45,6,3,3,1,0,1
4258,4759,10252,51,4,3,1,2,0,2
4259,4759,8455,49,5,2,3,2,0,2
4260,4761,8668,47,10,4,6,1,1,0
4261,4761,10260,53,6,4,2,1,1,0
4262,4762,8456,55,6,3,3,1,1,0
4263,4762,8678,45,2,1,1,2,0,2
4264,4763,9850,56,11,3,8,2,1,1
4265,4763,10261,44,2,2,0,0,0,0
4266,4764,8197,49,9,3,6,3,2,1
4267,4764,8466,51,3,2,1,3,0,3
4268,4765,10003,54,4,2,2,1,1,0
4269,4765,10194,46,2,1,1,2,1,1
4270,4767,9825,67,11,7,4,1,0,1
4271,4767,9817,33,4,1,3,0,0,0
4272,4768,8472,43,4,2,2,2,1,1
4273,4768,8659,57,4,1,3,5,2,3
4274,5952,8639,60,4,1,3,1,1,0
4275,5952,4087,40,1,0,1,2,1,1
4276,6067,9941,55,3,3,0,3,2,1
4277,6067,9853,45,8,1,7,1,0,1
4278,6076,10249,48,7,2,5,1,1,0
4279,6076,9847,52,3,1,2,0,0,0
4280,7049,9837,34,2,1,1,2,0,2
4281,7049,9847,66,3,1,2,0,0,0
4282,7050,7794,43,10,5,5,5,3,2
4283,7050,8592,57,6,4,2,2,1,1
4284,7052,9747,49,3,1,2,3,1,2
4285,7052,9853,51,0,0,0,2,0,2
4286,7054,9748,57,11,7,4,1,0,1
4287,7054,9851,43,3,0,3,0,0,0
4288,7056,9827,52,2,2,0,3,1,2
4289,7056,10249,48,7,3,4,0,0,0
4290,7057,9830,53,5,4,1,3,2,1
4291,7057,8588,47,2,2,0,2,0,2
4292,7058,9831,52,3,3,0,3,1,2
4293,7058,9941,48,2,1,1,1,0,1
4294,7060,9847,70,5,4,1,2,0,2
4295,7060,8588,30,5,3,2,1,0,1
4296,7061,8639,63,13,5,8,1,1,0
4297,7061,9747,37,2,1,1,0,0,0
4298,7062,9853,52,6,4,2,1,0,1
4299,7062,8689,48,2,0,2,0,0,0
4300,7064,8550,41,5,2,3,2,0,2
4301,7064,9851,59,4,2,2,0,0,0
4302,7066,9837,62,4,2,2,1,1,0
4303,7066,9830,38,4,0,4,2,1,1
4304,7067,9831,66,9,1,8,2,2,0
4305,7067,7794,34,2,1,1,3,1,2
4306,7068,9748,57,11,7,4,2,1,1
4307,7068,10249,43,2,1,1,1,0,1
4308,7069,8592,57,6,1,5,3,1,2
4309,7069,9748,43,6,1,5,1,0,1
4310,7070,7794,52,7,3,4,2,1,1
4311,7070,9829,48,6,3,3,1,1,0
4312,7071,8689,49,3,1,2,2,0,2
4313,7071,7819,51,5,2,3,1,0,1
4314,7076,8639,45,2,1,1,3,2,1
4315,7076,9851,55,4,2,2,1,0,1
4316,7078,9941,73,7,4,3,4,2,2
4317,7078,8588,27,1,0,1,1,0,1
4318,7079,9827,46,3,1,2,2,1,1
4319,7079,9941,54,2,1,1,3,2,1
4320,7080,9747,43,5,4,1,1,0,1
4321,7080,7794,57,3,0,3,1,0,1
4322,7081,8639,55,8,5,3,1,1,0
4323,7081,9853,45,3,1,2,2,0,2
4324,7082,8689,43,10,8,2,1,0,1
4325,7082,9847,57,6,2,4,0,0,0
4326,7084,7819,56,3,2,1,2,0,2
4327,7084,8550,44,3,2,1,0,0,0
4328,7086,10249,54,5,5,0,3,2,1
4329,7086,4087,46,2,0,2,1,0,1
4330,7087,9830,54,8,5,3,1,1,0
4331,7087,9851,46,1,0,1,0,0,0
4332,7088,9748,61,6,3,3,1,0,1
4333,7088,9831,39,3,1,2,0,0,0
4334,7089,10249,54,1,1,0,1,1,0
4335,7089,7794,46,4,4,0,0,0,0
4336,7090,7819,56,4,1,3,1,1,0
4337,7090,9830,44,4,2,2,0,0,0
4338,7092,8588,54,7,5,2,1,1,0
4339,7092,9827,46,1,0,1,0,0,0
4340,7095,8689,49,5,2,3,2,1,1
4341,7095,9851,51,4,2,2,2,2,0
4342,7096,9829,44,3,1,2,3,1,2
4343,7096,9853,56,5,2,3,1,0,1
4344,7098,8592,53,8,4,4,1,1,0
4345,7098,9847,47,11,3,8,2,0,2
4346,7099,7794,41,5,3,2,1,1,0
4347,7099,9748,59,3,0,3,2,0,2
4348,7100,9747,48,3,2,1,5,2,3
4349,7100,9851,52,4,3,1,3,0,3
4350,7101,4087,38,2,2,0,1,1,0
4351,7101,8639,62,3,1,2,2,0,2
4352,7102,8689,59,16,5,11,1,1,0
4353,7102,8588,41,5,4,1,1,0,1
4354,7103,9827,39,4,3,1,2,1,1
4355,7103,8592,61,11,5,6,1,1,0
4356,7104,8550,29,5,2,3,2,0,2
4357,7104,9847,71,8,2,6,0,0,0
4358,7105,9829,62,13,5,8,2,1,1
4359,7105,7819,38,4,3,1,0,0,0
4360,7106,9941,56,2,1,1,4,2,2
4361,7106,10249,44,5,3,2,1,1,0
4362,7107,9853,55,4,2,2,2,2,0
4363,7107,9830,45,8,5,3,0,0,0
4364,7110,7819,53,7,6,1,1,1,0
4365,7110,10249,47,4,2,2,1,1,0
4366,7111,9747,47,6,1,5,1,1,0
4367,7111,4087,53,1,0,1,2,1,1
4368,7112,8588,61,4,3,1,3,1,2
4369,7112,8550,39,1,0,1,2,1,1
4370,7113,9830,37,5,2,3,1,0,1
4371,7113,8592,63,3,2,1,0,0,0
4372,7115,9837,55,6,2,4,4,2,2
4373,7115,7794,45,2,2,0,0,0,0
4374,7116,9851,44,1,1,0,5,2,3
4375,7116,9829,56,4,0,4,0,0,0
4376,7119,7794,56,4,4,0,2,1,1
4377,7119,4087,44,2,1,1,3,1,2
4378,7121,8639,38,8,3,5,1,1,0
4379,7121,9847,62,7,3,4,1,1,0
4380,7122,8592,56,10,2,8,2,1,1
4381,7122,8689,44,5,1,4,1,1,0
4382,7123,9837,46,5,4,1,2,1,1
4383,7123,9748,54,10,3,7,1,1,0
4384,7124,8550,37,4,0,4,4,2,2
4385,7124,9827,63,0,0,0,0,0,0
4386,7126,9853,48,5,2,3,2,1,1
4387,7126,10249,52,4,1,3,0,0,0
4388,7127,9830,52,7,2,5,2,2,0
4389,7127,9941,48,2,0,2,1,1,0
4390,7129,8689,39,7,3,4,1,1,0
4391,7129,9827,61,13,6,7,2,1,1
4392,7131,9748,71,10,6,4,1,0,1
4393,7131,4087,29,0,0,0,0,0,0
4394,7132,8588,58,4,2,2,1,1,0
4395,7132,8639,42,2,0,2,0,0,0
4396,7133,8592,62,7,1,6,2,1,1
4397,7133,8550,38,7,5,2,1,1,0
4398,7134,9847,67,7,7,0,3,2,1
4399,7134,9830,33,1,0,1,2,0,2
4400,7135,9837,61,7,4,3,2,1,1
4401,7135,9747,39,2,1,1,1,0,1
4402,7136,10249,40,7,2,5,3,2,1
4403,7136,9851,60,6,3,3,2,0,2
4404,7137,7794,36,4,2,2,4,0,4
4405,7137,9853,64,3,2,1,0,0,0
4406,7138,9829,48,6,4,2,4,2,2
4407,7138,9941,52,5,1,4,0,0,0
4408,7139,9851,44,3,2,1,1,0,1
4409,7139,7794,56,6,5,1,2,0,2
4410,7140,9847,72,5,2,3,1,1,0
4411,7140,9747,28,2,1,1,1,0,1
4412,7142,8689,55,7,2,5,1,0,1
4413,7142,8550,45,2,1,1,0,0,0
4414,7143,7819,31,3,3,0,1,1,0
4415,7143,9748,69,10,4,6,4,1,3
4416,7144,8588,47,4,3,1,2,1,1
4417,7144,10249,53,4,1,3,2,1,1
4418,7145,9827,51,4,2,2,2,0,2
4419,7145,9830,49,1,0,1,0,0,0
4420,7146,9831,57,4,1,3,2,1,1
4421,7146,9853,43,2,0,2,1,1,0
4422,7147,9837,59,7,5,2,1,1,0
4423,7147,4087,41,5,5,0,0,0,0
4424,7148,9829,42,6,3,3,2,1,1
4425,7148,8592,58,6,3,3,0,0,0
4426,7151,8588,48,3,2,1,1,0,1
4427,7151,9831,52,2,1,1,0,0,0
4428,7152,9830,43,6,5,1,2,1,1
4429,7152,8689,57,13,3,10,1,0,1
4430,7155,9847,68,7,2,5,1,0,1
4431,7155,10249,32,1,0,1,0,0,0
4432,7156,9837,65,4,3,1,1,0,1
4433,7156,9851,35,3,1,2,0,0,0
4434,7157,9853,60,3,3,0,3,1,2
4435,7157,4087,40,2,0,2,1,1,0
4436,7158,9747,46,3,1,2,3,1,2
4437,7158,9941,54,3,0,3,3,1,2
4438,7160,7819,36,5,0,5,2,1,1
4439,7160,8639,64,0,0,0,1,0,1
4440,7161,9747,49,3,2,1,1,1,0
4441,7161,8588,51,2,0,2,0,0,0
4442,7162,8689,59,7,2,5,2,1,1
4443,7162,9831,41,4,2,2,0,0,0
4444,7163,10249,41,3,1,2,2,2,0
4445,7163,8592,59,10,5,5,1,0,1
4446,7164,8550,46,5,1,4,4,2,2
4447,7164,9830,54,2,1,1,0,0,0
4448,7167,9853,53,10,5,5,1,1,0
4449,7167,9837,47,3,2,1,0,0,0
4450,7169,7794,40,1,1,0,6,3,3
4451,7169,9847,60,3,1,2,0,0,0
4452,7170,9851,54,5,3,2,2,1,1
4453,7170,4087,46,4,3,1,1,0,1
4454,7171,8588,61,5,1,4,1,1,0
4455,7171,9747,39,5,5,0,1,1,0
4456,7172,7819,44,2,2,0,2,0,2
4457,7172,8639,56,8,4,4,1,0,1
4458,7174,9827,48,5,3,2,1,1,0
4459,7174,9829,52,6,3,3,0,0,0
4460,7175,8592,58,7,5,2,2,1,1
4461,7175,10249,42,6,2,4,0,0,0
4462,7177,8689,46,2,1,1,1,1,0
4463,7177,9831,54,12,5,7,1,0,1
4464,7178,9853,46,8,5,3,2,0,2
4465,7178,9837,54,12,8,4,1,0,1
4466,7179,9827,49,3,1,2,1,0,1
4467,7179,9831,51,0,0,0,1,0,1
4468,7180,7819,41,7,5,2,1,0,1
4469,7180,9837,59,6,1,5,1,0,1
4470,7182,8639,49,5,1,4,2,0,2
4471,7182,8689,51,9,4,5,2,0,2
4472,7183,9747,36,6,3,3,1,0,1
4473,7183,8592,64,9,3,6,2,0,2
4474,7185,9830,47,5,1,4,3,2,1
4475,7185,9829,53,5,1,4,0,0,0
4476,7186,4087,32,2,1,1,2,1,1
4477,7186,9847,68,4,3,1,0,0,0
4478,7187,9851,51,3,0,3,2,0,2
4479,7187,9853,49,1,0,1,0,0,0
4480,7188,9941,62,6,4,2,1,1,0
4481,7188,7794,38,2,0,2,0,0,0
4482,7189,7794,44,6,2,4,1,0,1
4483,7189,9827,56,6,0,6,1,0,1
4484,7190,9941,55,5,3,2,1,0,1
4485,7190,4087,45,4,2,2,0,0,0
4486,7191,8689,56,8,4,4,1,1,0
4487,7191,9747,44,6,4,2,0,0,0
4488,7192,8639,47,3,2,1,1,1,0
4489,7192,9829,53,1,0,1,2,0,2
4490,7193,8550,31,2,1,1,1,1,0
4491,7193,9748,69,3,0,3,2,1,1
4492,7194,9830,55,9,4,5,1,1,0
4493,7194,10249,45,4,2,2,0,0,0
4494,7195,9831,41,4,2,2,2,2,0
4495,7195,8592,59,3,1,2,1,1,0
4496,7196,9837,61,4,2,2,1,1,0
4497,7196,8588,39,12,3,9,1,0,1
4498,7197,7819,45,3,2,1,3,1,2
4499,7197,9851,55,11,4,7,0,0,0
4500,7198,9853,38,4,1,3,4,1,3
4501,7198,9847,62,4,1,3,1,0,1
4502,7199,9827,66,4,2,2,2,1,1
4503,7199,9747,34,4,3,1,0,0,0
4504,7200,7819,34,6,2,4,1,0,1
4505,7200,9853,66,2,0,2,0,0,0
4506,7201,8588,56,8,2,6,2,1,1
4507,7201,7794,44,0,0,0,1,0,1
4508,7204,8550,48,4,3,1,3,1,2
4509,7204,9831,52,1,0,1,1,0,1
4510,7205,9748,57,4,4,0,1,1,0
4511,7205,9829,43,2,1,1,0,0,0
4512,7206,8639,37,6,3,3,2,1,1
4513,7206,9830,63,13,6,7,0,0,0
4514,7207,9851,45,4,1,3,2,1,1
4515,7207,9847,55,3,1,2,2,0,2
4516,7209,7794,65,9,6,3,1,0,1
4517,7209,8550,35,5,1,4,0,0,0
4518,7211,4087,49,5,1,4,1,0,1
4519,7211,9827,51,0,0,0,0,0,0
4520,7213,9748,36,4,1,3,2,0,2
4521,7213,9847,64,8,1,7,1,0,1
4522,7214,10249,52,6,5,1,1,1,0
4523,7214,8639,48,4,1,3,1,1,0
4524,7216,8689,48,4,3,1,1,0,1
4525,7216,9837,52,5,2,3,0,0,0
4526,7218,9853,54,4,3,1,2,1,1
4527,7218,8588,46,5,4,1,1,0,1
4528,7219,9853,46,5,3,2,1,1,0
4529,7219,9827,54,6,2,4,3,2,1
4530,7220,4087,35,3,3,0,2,0,2
4531,7220,8588,65,7,3,4,1,0,1
4532,7222,8689,44,9,7,2,4,1,3
4533,7222,9748,56,7,3,4,1,0,1
4534,7223,9837,35,6,2,4,3,1,2
4535,7223,8592,65,5,3,2,0,0,0
4536,7224,9747,44,3,2,1,2,1,1
4537,7224,8550,56,4,0,4,1,0,1
4538,7225,10249,47,2,2,0,5,2,3
4539,7225,9829,53,7,3,4,0,0,0
4540,7228,9851,45,3,1,2,1,1,0
4541,7228,9941,55,6,2,4,2,1,1
4542,7229,7794,46,4,1,3,2,2,0
4543,7229,8639,54,6,3,3,1,0,1
4544,7232,9747,63,4,2,2,2,1,1
4545,7232,10249,37,9,5,4,1,0,1
4546,7233,9748,71,7,3,4,2,1,1
4547,7233,9830,29,1,1,0,0,0,0
4548,7235,9941,38,3,1,2,1,1,0
4549,7235,9847,62,2,0,2,1,0,1
4550,7236,8550,41,9,2,7,2,2,0
4551,7236,9837,59,6,5,1,0,0,0
4552,7238,9853,45,9,3,6,1,1,0
4553,7238,8592,55,4,1,3,1,1,0
4554,7239,9837,33,4,2,2,4,3,1
4555,7239,9827,67,8,1,7,3,1,2
4556,7241,8639,35,6,3,3,3,1,2
4557,7241,9748,65,4,1,3,3,2,1
4558,7242,8689,56,11,7,4,3,0,3
4559,7242,7794,44,6,4,2,0,0,0
4560,7243,8592,65,8,3,5,1,0,1
4561,7243,7819,35,8,4,4,0,0,0
4562,7246,9831,55,11,6,5,2,1,1
4563,7246,10249,45,5,2,3,1,1,0
4564,7247,9830,61,2,1,1,1,0,1
4565,7247,9747,39,1,0,1,1,0,1
4566,7249,9748,64,3,2,1,2,1,1
4567,7249,10249,36,6,0,6,0,0,0
4568,7250,7794,56,9,2,7,3,1,2
4569,7250,9831,44,1,1,0,0,0,0
4570,7252,4087,45,5,2,3,1,0,1
4571,7252,9829,55,4,2,2,0,0,0
4572,7256,8550,53,7,1,6,2,1,1
4573,7256,9851,47,4,2,2,0,0,0
4574,7257,8689,44,2,2,0,2,1,1
4575,7257,9853,56,2,1,1,2,0,2
4576,7258,9941,43,3,2,1,3,2,1
4577,7258,8592,57,4,1,3,0,0,0
4578,7259,9827,55,5,3,2,1,1,0
4579,7259,9847,45,3,1,2,1,0,1
4580,7260,8588,54,6,4,2,2,1,1
4581,7260,9941,46,5,3,2,3,0,3
4582,7261,9851,48,5,4,1,1,1,0
4583,7261,8639,52,4,1,3,1,0,1
4584,7263,8592,55,7,3,4,3,1,2
4585,7263,9748,45,6,2,4,0,0,0
4586,7264,8550,46,5,1,4,1,1,0
4587,7264,9853,54,1,0,1,1,1,0
4588,7266,9837,53,5,2,3,1,0,1
4589,7266,10249,47,5,3,2,0,0,0
4590,7268,9747,34,4,2,2,1,1,0
4591,7268,9831,66,4,1,3,2,0,2
4592,7269,7794,44,2,1,1,1,0,1
4593,7269,9941,56,5,2,3,1,0,1
4594,7270,9847,77,3,2,1,5,2,3
4595,7270,4087,23,5,1,4,1,1,0
4596,7271,9747,45,3,1,2,1,1,0
4597,7271,8592,55,5,5,0,1,0,1
4598,7272,8639,61,6,3,3,1,1,0
4599,7272,8689,39,1,0,1,1,0,1
4600,7274,8550,40,4,1,3,1,0,1
4601,7274,10249,60,4,1,3,1,0,1
4602,7276,9831,49,7,2,5,2,1,1
4603,7276,9827,51,4,4,0,1,0,1
4604,7279,7794,49,7,4,3,2,0,2
4605,7279,9747,51,5,4,1,0,0,0
4606,7280,7819,53,9,5,4,1,1,0
4607,7280,8550,47,4,0,4,0,0,0
4608,7283,9831,35,5,4,1,1,0,1
4609,7283,9748,65,10,4,6,0,0,0
4610,7284,9847,63,7,3,4,1,1,0
4611,7284,8689,37,6,4,2,1,0,1
4612,7286,9851,60,9,5,4,1,1,0
4613,7286,9830,40,3,1,2,0,0,0
4614,7288,9941,40,5,3,2,1,0,1
4615,7288,9827,60,8,5,3,0,0,0
4616,7289,9827,57,8,5,3,1,0,1
4617,7289,8588,43,3,2,1,0,0,0
4618,7290,9748,75,4,2,2,1,0,1
4619,7290,9747,25,1,0,1,1,0,1
4620,7291,8639,55,4,3,1,3,1,2
4621,7291,9837,45,3,0,3,3,3,0
4622,7294,8550,55,9,6,3,1,1,0
4623,7294,9941,45,2,1,1,0,0,0
4624,7295,9829,58,2,1,1,4,1,3
4625,7295,9853,42,2,2,0,1,0,1
4626,7297,9830,46,4,3,1,2,2,0
4627,7297,7819,54,4,0,4,0,0,0
4628,7301,4087,29,5,2,3,1,1,0
4629,7301,8639,71,1,0,1,3,0,3
4630,7302,8689,52,5,1,4,1,0,1
4631,7302,8588,48,3,2,1,0,0,0
4632,7303,9748,63,9,5,4,3,2,1
4633,7303,7794,37,3,0,3,1,0,1
4634,7304,9847,69,5,0,5,2,0,2
4635,7304,8550,31,2,0,2,0,0,0
4636,7305,9837,54,5,0,5,1,1,0
4637,7305,9831,46,5,0,5,2,0,2
4638,7306,9747,35,1,1,0,1,0,1
4639,7306,9851,65,7,2,5,0,0,0
4640,7307,9830,59,4,2,2,1,0,1
4641,7307,9853,41,2,0,2,0,0,0
4642,7308,10249,52,4,2,2,4,2,2
4643,7308,9941,48,4,1,3,1,1,0
4644,7312,9941,42,3,1,2,3,2,1
4645,7312,8689,58,5,3,2,1,0,1
4646,7313,9748,53,7,6,1,1,1,0
4647,7313,9853,47,7,2,5,2,1,1
4648,7314,8550,47,7,4,3,1,1,0
4649,7314,8588,53,2,0,2,2,2,0
4650,7319,9827,61,6,1,5,1,0,1
4651,7319,8550,39,1,0,1,1,0,1
4652,7321,7794,48,4,3,1,1,0,1
4653,7321,4087,52,4,1,3,1,0,1
4654,7323,8592,66,3,1,2,1,0,1
4655,7323,8689,34,2,1,1,0,0,0
4656,7326,9831,46,6,3,3,2,0,2
4657,7326,9851,54,3,0,3,0,0,0
4658,7328,9941,46,2,2,0,1,1,0
4659,7328,9830,54,2,1,1,0,0,0
4660,7329,7794,54,4,3,1,4,1,3
4661,7329,9853,46,3,1,2,0,0,0
4662,7330,9837,46,3,1,2,1,0,1
4663,7330,9747,54,3,2,1,1,0,1
4664,7334,8550,49,12,4,8,1,0,1
4665,7334,8592,51,7,2,5,0,0,0
4666,7335,9829,53,2,1,1,2,2,0
4667,7335,9941,47,4,3,1,0,0,0
4668,7337,9847,52,7,6,1,2,1,1
4669,7337,9830,48,4,3,1,2,0,2
4670,7338,9831,54,7,3,4,1,1,0
4671,7338,7819,46,8,1,7,1,0,1
4672,7339,9830,42,3,1,2,4,1,3
4673,7339,9827,58,3,3,0,0,0,0
4674,7341,4087,49,5,3,2,1,0,1
4675,7341,9837,51,1,0,1,0,0,0
4676,7342,10249,51,5,4,1,3,1,2
4677,7342,8588,49,2,1,1,0,0,0
4678,7344,8550,57,12,5,7,1,1,0
4679,7344,8689,43,9,6,3,2,1,1
4680,7347,9853,56,6,4,2,1,0,1
4681,7347,9831,44,5,0,5,0,0,0
4682,7348,8639,58,7,5,2,5,3,2
4683,7348,9941,42,8,4,4,1,1,0
4684,7349,7819,39,3,2,1,1,1,0
4685,7349,7794,61,2,0,2,1,0,1
4686,7350,4087,45,5,1,4,2,1,1
4687,7350,9853,55,3,1,2,0,0,0
4688,7351,9747,42,4,1,3,2,1,1
4689,7351,9941,58,10,3,7,3,3,0
4690,7352,8592,52,2,1,1,2,1,1
4691,7352,8639,48,7,2,5,1,0,1
4692,7354,9829,54,5,2,3,4,2,2
4693,7354,8550,46,4,2,2,2,1,1
4694,7355,10249,44,3,2,1,2,2,0
4695,7355,9847,56,6,3,3,1,0,1
4696,7357,9831,46,8,3,5,2,1,1
4697,7357,8588,54,3,1,2,0,0,0
4698,7358,9851,62,5,2,3,1,1,0
4699,7358,9837,38,0,0,0,1,0,1
4700,7361,8588,36,2,1,1,4,3,1
4701,7361,9830,64,9,5,4,1,0,1
4702,7363,8592,64,5,3,2,1,0,1
4703,7363,7794,36,3,0,3,0,0,0
4704,7365,9847,65,5,4,1,1,1,0
4705,7365,9837,35,4,2,2,1,0,1
4706,7367,9853,55,6,3,3,3,3,0
4707,7367,9747,45,4,2,2,2,0,2
4708,7368,9831,47,3,1,2,3,2,1
4709,7368,9941,53,4,0,4,1,0,1
4710,7372,9747,43,3,3,0,3,2,1
4711,7372,8689,57,4,3,1,4,1,3
4712,7373,8592,59,8,3,5,1,1,0
4713,7373,9831,41,6,1,5,0,0,0
4714,7374,9748,55,6,4,2,4,3,1
4715,7374,8550,45,3,1,2,1,1,0
4716,7375,9829,56,2,0,2,1,0,1
4717,7375,8639,44,1,0,1,0,0,0
4718,7376,9830,52,5,4,1,1,0,1
4719,7376,10249,48,2,0,2,1,0,1
4720,7378,9847,65,8,5,3,2,0,2
4721,7378,9853,35,5,2,3,1,0,1
4722,7380,4087,44,4,1,3,2,1,1
4723,7380,8592,56,2,1,1,2,1,1
4724,7382,8639,56,6,1,5,1,1,0
4725,7382,9830,44,4,3,1,0,0,0
4726,7383,9829,42,9,4,5,3,0,3
4727,7383,9748,58,5,3,2,0,0,0
4728,7384,8689,61,10,2,8,2,0,2
4729,7384,10249,39,5,2,3,0,0,0
4730,7386,9837,35,3,3,0,2,2,0
4731,7386,9941,65,3,1,2,1,0,1
4732,7388,7819,39,1,1,0,1,0,1
4733,7388,9853,61,5,1,4,2,0,2
4734,7389,4087,44,3,1,2,1,1,0
4735,7389,9827,56,0,0,0,1,0,1
4736,7390,8588,46,6,3,3,2,0,2
4737,7390,9853,54,4,3,1,0,0,0
4738,7392,9837,33,4,3,1,3,2,1
4739,7392,8689,67,1,1,0,0,0,0
4740,7394,8550,45,12,6,6,1,0,1
4741,7394,7794,55,3,1,2,1,0,1
4742,7397,9941,64,6,4,2,4,3,1
4743,7397,7819,36,5,0,5,2,1,1
4744,7398,9748,37,5,1,4,1,0,1
4745,7398,9847,63,4,1,3,3,0,3
4746,7399,7794,43,2,1,1,4,4,0
4747,7399,9830,57,1,1,0,1,0,1
4748,7400,9847,68,8,4,4,2,1,1
4749,7400,7819,32,4,1,3,1,1,0
4750,7401,4087,56,5,4,1,2,2,0
4751,7401,8588,44,5,1,4,0,0,0
4752,7403,9748,54,9,6,3,1,0,1
4753,7403,8689,46,7,2,5,0,0,0
4754,7405,8639,45,3,3,0,2,1,1
4755,7405,9831,55,3,3,0,1,1,0
4756,7406,8592,61,8,4,4,2,1,1
4757,7406,9837,39,3,1,2,0,0,0
4758,7407,9851,58,9,5,4,1,0,1
4759,7407,9941,42,2,1,1,0,0,0
4760,7408,9853,53,8,4,4,1,1,0
4761,7408,9827,47,1,1,0,1,0,1
4762,7409,9851,55,5,3,2,2,2,0
4763,7409,9827,45,7,1,6,2,1,1
4764,7410,7819,54,5,4,1,2,2,0
4765,7410,8588,46,3,2,1,0,0,0
4766,7411,8639,56,8,4,4,9,3,6
4767,7411,7794,44,3,1,2,1,0,1
4768,7412,8689,63,8,4,4,1,1,0
4769,7412,4087,37,1,0,1,1,0,1
4770,7415,9829,62,2,2,0,2,0,2
4771,7415,9831,38,3,2,1,0,0,0
4772,7416,9747,51,6,5,1,2,0,2
4773,7416,10249,49,5,4,1,0,0,0
4774,7417,9830,44,6,2,4,2,1,1
4775,7417,9748,56,7,3,4,1,0,1
4776,7419,7794,61,3,2,1,3,1,2
4777,7419,8689,39,6,3,3,1,0,1
4778,7420,7819,34,5,2,3,5,3,2
4779,7420,8592,66,12,7,5,1,1,0
4780,7421,8550,47,5,3,2,3,0,3
4781,7421,4087,53,0,0,0,0,0,0
4782,7423,9748,48,5,4,1,1,0,1
4783,7423,8639,52,4,1,3,1,0,1
4784,7425,9827,66,4,1,3,3,1,2
4785,7425,9837,34,1,0,1,0,0,0
4786,7426,9851,47,7,2,5,2,0,2
4787,7426,8588,53,4,1,3,0,0,0
4788,7427,9941,42,1,1,0,1,1,0
4789,7427,9853,58,6,1,5,0,0,0
4790,7428,9829,46,6,2,4,3,1,2
4791,7428,9847,54,5,3,2,1,0,1
4792,7431,9847,49,3,1,2,2,1,1
4793,7431,8639,51,9,4,5,2,1,1
4794,7433,7819,30,4,4,0,1,0,1
4795,7433,8592,70,10,4,6,0,0,0
4796,7436,9831,43,2,0,2,1,1,0
4797,7436,9829,57,5,0,5,3,1,2
4798,7437,9941,49,2,2,0,3,1,2
4799,7437,9853,51,5,2,3,0,0,0
4800,7438,10242,52,4,1,3,2,1,1
4801,7438,6391,48,1,1,0,0,0,0
4802,7440,9827,53,9,2,7,4,2,2
4803,7440,10249,47,2,0,2,1,1,0
4804,7442,8592,59,13,7,6,2,0,2
4805,7442,8689,41,2,0,2,1,0,1
4806,7443,9829,36,6,2,4,3,2,1
4807,7443,9748,64,9,2,7,1,0,1
4808,7444,10242,51,4,2,2,1,1,0
4809,7444,9830,49,6,2,4,1,0,1
4810,7446,9851,45,5,3,2,1,1,0
4811,7446,9831,55,3,1,2,0,0,0
4812,7447,9853,58,7,1,6,1,0,1
4813,7447,6391,42,0,0,0,0,0,0
4814,7449,8121,52,5,4,1,2,0,2
4815,7449,9747,48,6,2,4,0,0,0
4816,7450,10242,51,4,2,2,4,1,3
4817,7450,9827,49,6,1,5,1,0,1
4818,7453,8639,48,8,3,5,3,2,1
4819,7453,8592,52,7,3,4,0,0,0
4820,7455,9941,32,3,1,2,2,1,1
4821,7455,9748,68,7,5,2,1,0,1
4822,7458,9829,45,5,2,3,4,0,4
4823,7458,9837,55,7,2,5,0,0,0
4824,7460,6391,43,2,2,0,2,0,2
4825,7460,9827,57,2,1,1,1,0,1
4826,7461,8689,62,7,6,1,3,0,3
4827,7461,9747,38,4,1,3,1,0,1
4828,7463,9830,46,5,3,2,1,0,1
4829,7463,8592,54,6,1,5,1,0,1
4830,7464,9831,59,6,2,4,2,1,1
4831,7464,8639,41,3,0,3,0,0,0
4832,7465,9847,60,4,4,0,1,1,0
4833,7465,9851,40,2,1,1,1,0,1
4834,7466,9837,47,8,6,2,1,0,1
4835,7466,9853,53,8,5,3,0,0,0
4836,7467,9941,51,7,6,1,3,0,3
4837,7467,10249,49,5,1,4,0,0,0
4838,7468,10242,30,4,2,2,2,0,2
4839,7468,9748,70,14,7,7,0,0,0
4840,7469,8121,46,7,3,4,1,1,0
4841,7469,9851,54,2,1,1,1,0,1
4842,7470,9827,44,1,1,0,3,2,1
4843,7470,9829,56,5,2,3,2,2,0
4844,7471,9747,59,7,2,5,2,1,1
4845,7471,7819,41,7,0,7,0,0,0
4846,7473,8689,55,11,7,4,2,1,1
4847,7473,10242,45,8,2,6,0,0,0
4848,7474,9748,57,8,5,3,1,1,0
4849,7474,9853,43,3,1,2,1,0,1
4850,7476,10249,48,3,1,2,1,1,0
4851,7476,9830,52,2,0,2,0,0,0
4852,7477,9847,66,5,2,3,1,1,0
4853,7477,9941,34,2,1,1,0,0,0
4854,7479,7794,46,5,3,2,3,1,2
4855,7479,6391,54,6,1,5,3,1,2
4856,7482,8689,43,9,4,5,1,0,1
4857,7482,9847,57,2,1,1,0,0,0
4858,7485,9831,47,7,3,4,1,0,1
4859,7485,9748,53,4,2,2,0,0,0
4860,7487,8592,54,6,4,2,2,2,0
4861,7487,9853,46,6,4,2,1,0,1
4862,7488,8639,52,7,1,6,4,0,4
4863,7488,10242,48,4,1,3,0,0,0
4864,7489,8639,53,4,2,2,3,1,2
4865,7489,8121,47,6,1,5,2,0,2
4866,7491,6391,45,6,4,2,3,2,1
4867,7491,8689,55,2,1,1,0,0,0
4868,7492,10249,39,7,3,4,2,2,0
4869,7492,9748,61,4,3,1,1,0,1
4870,7493,9829,40,5,2,3,4,1,3
4871,7493,8592,60,7,3,4,0,0,0
4872,7494,9830,52,9,2,7,2,0,2
4873,7494,7794,48,1,0,1,0,0,0
4874,7497,9853,54,9,4,5,2,0,2
4875,7497,9747,46,6,2,4,0,0,0
4876,7499,9847,76,6,3,3,1,0,1
4877,7499,8121,24,3,2,1,0,0,0
4878,7500,7794,47,4,1,3,1,0,1
4879,7500,9827,53,2,1,1,0,0,0
4880,7501,9747,54,3,1,2,2,1,1
4881,7501,9837,46,2,1,1,4,1,3
4882,7503,8689,49,4,3,1,2,2,0
4883,7503,9831,51,9,3,6,0,0,0
4884,7504,7819,40,4,3,1,1,1,0
4885,7504,9829,60,5,1,4,0,0,0
4886,7505,10249,57,7,3,4,4,2,2
4887,7505,6391,43,1,1,0,1,1,0
4888,7508,10242,61,10,4,6,1,1,0
4889,7508,9941,39,6,2,4,2,0,2
4890,7510,9827,61,7,2,5,4,2,2
4891,7510,9747,39,2,0,2,1,0,1
4892,7513,9748,62,6,1,5,2,1,1
4893,7513,8121,38,6,2,4,1,0,1
4894,7514,8592,66,11,3,8,1,1,0
4895,7514,10249,34,0,0,0,1,0,1
4896,7515,9847,62,6,1,5,3,2,1
4897,7515,9831,38,2,2,0,0,0,0
4898,7516,9837,56,6,3,3,4,2,2
4899,7516,10242,44,6,2,4,0,0,0
4900,7518,9941,55,4,2,2,1,1,0
4901,7518,8689,45,2,1,1,0,0,0
4902,7519,9827,53,1,1,0,3,0,3
4903,7519,8121,47,4,2,2,0,0,0
4904,7520,8639,49,8,2,6,4,1,3
4905,7520,8689,51,4,2,2,1,0,1
4906,7521,8592,54,5,2,3,2,2,0
4907,7521,6391,46,3,2,1,3,0,3
4908,7522,9853,47,3,2,1,2,1,1
4909,7522,9829,53,4,1,3,1,1,0
4910,7523,10249,67,5,3,2,1,1,0
4911,7523,9747,33,2,0,2,0,0,0
4912,7524,9830,59,5,1,4,1,1,0
4913,7524,9941,41,3,0,3,0,0,0
4914,7525,9847,67,3,1,2,1,1,0
4915,7525,9748,33,3,1,2,3,0,3
4916,7526,9831,62,2,1,1,2,1,1
4917,7526,9837,38,6,2,4,0,0,0
4918,7528,10242,52,3,2,1,2,2,0
4919,7528,7794,48,2,0,2,2,1,1
4920,7530,9827,44,5,3,2,3,2,1
4921,7530,8592,56,4,2,2,1,0,1
4922,7532,6391,45,8,4,4,1,1,0
4923,7532,9748,55,4,3,1,3,2,1
4924,7533,9747,49,8,3,5,1,1,0
4925,7533,9851,51,3,2,1,1,0,1
4926,7534,9830,46,7,2,5,3,2,1
4927,7534,8689,54,9,5,4,2,1,1
4928,7535,10249,46,8,4,4,1,0,1
4929,7535,9831,54,6,5,1,2,0,2
4930,7536,9853,56,4,3,1,2,1,1
4931,7536,8121,44,3,1,2,0,0,0
4932,7537,8639,61,9,5,4,1,1,0
4933,7537,9941,39,5,4,1,1,0,1
4934,7538,10242,30,6,2,4,1,1,0
4935,7538,9829,70,8,2,6,0,0,0
4936,7539,9830,52,2,2,0,2,1,1
4937,7539,8121,48,3,2,1,0,0,0
4938,7541,9748,59,5,2,3,1,1,0
4939,7541,9747,41,7,3,4,4,1,3
4940,7546,9851,49,3,1,2,2,1,1
4941,7546,10249,51,2,1,1,5,2,3
4942,7547,9827,49,8,1,7,4,1,3
4943,7547,9853,51,3,0,3,0,0,0
4944,7548,10242,45,5,3,2,1,0,1
4945,7548,9831,55,9,4,5,1,0,1
4946,7553,9827,48,6,3,3,1,1,0
4947,7553,10249,52,5,0,5,0,0,0
4948,7554,8592,68,4,2,2,3,3,0
4949,7554,9747,32,1,0,1,0,0,0
4950,7555,9748,64,9,5,4,3,3,0
4951,7555,10242,36,4,1,3,1,0,1
4952,7556,9847,76,5,2,3,2,1,1
4953,7556,7794,24,0,0,0,0,0,0
4954,7557,9837,49,2,0,2,2,1,1
4955,7557,9941,51,0,0,0,0,0,0
4956,7559,9853,33,3,1,2,1,0,1
4957,7559,9748,67,13,6,7,0,0,0
4958,7560,9830,53,6,2,4,2,2,0
4959,7560,9747,47,4,1,3,0,0,0
4960,7563,8689,55,4,3,1,2,1,1
4961,7563,9829,45,2,0,2,3,3,0
4962,7565,8121,38,5,2,3,1,0,1
4963,7565,9831,62,7,1,6,0,0,0
4964,7566,10249,51,2,0,2,2,1,1
4965,7566,7794,49,0,0,0,1,1,0
4966,7568,9847,71,3,2,1,2,1,1
4967,7568,9941,29,5,3,2,4,2,2
4968,7569,9829,49,2,2,0,2,2,0
4969,7569,9941,51,3,0,3,1,0,1
4970,7571,9830,40,2,1,1,2,2,0
4971,7571,9827,60,5,0,5,1,1,0
4972,7573,7819,36,3,1,2,4,2,2
4973,7573,10249,64,7,3,4,1,0,1
4974,7574,9831,56,2,1,1,2,1,1
4975,7574,8689,44,5,2,3,1,1,0
4976,7575,8592,33,3,2,1,2,0,2
4977,7575,9748,67,14,2,12,0,0,0
4978,7577,9853,52,3,2,1,1,1,0
4979,7577,9837,48,5,1,4,2,0,2
4980,7578,9851,56,3,2,1,3,1,2
4981,7578,6391,44,2,0,2,1,1,0
4982,7580,9853,35,8,4,4,1,0,1
4983,7580,9847,65,6,4,2,2,0,2
4984,7581,10242,52,7,2,5,1,1,0
4985,7581,9830,48,5,2,3,1,0,1
4986,7582,9851,51,4,2,2,1,1,0
4987,7582,9827,49,5,3,2,1,0,1
4988,7585,8592,58,12,6,6,1,1,0
4989,7585,8639,42,5,3,2,1,1,0
4990,7586,7794,38,3,3,0,1,1,0
4991,7586,9748,62,4,1,3,1,0,1
4992,7587,7819,24,4,1,3,2,1,1
4993,7587,9831,76,9,3,6,1,1,0
4994,7588,9941,58,6,2,4,1,1,0
4995,7588,9747,42,2,0,2,3,1,2
4996,7589,7794,46,8,1,7,1,1,0
4997,7589,9829,54,4,1,3,1,0,1
4998,7590,10242,49,7,4,3,2,1,1
4999,7590,9747,51,4,3,1,1,1,0
5000,7593,10249,42,6,2,4,1,1,0
5001,7593,8592,58,1,0,1,1,0,1
5002,7595,9748,58,9,5,4,1,1,0
5003,7595,9827,42,4,2,2,0,0,0
5004,7597,9837,58,9,4,5,4,1,3
5005,7597,8121,42,5,1,4,0,0,0
5006,7598,9851,49,2,1,1,3,1,2
5007,7598,9853,51,6,2,4,4,2,2
5008,7601,9853,39,2,2,0,1,1,0
5009,7601,9827,61,7,3,4,0,0,0
5010,7603,6391,70,4,1,3,1,1,0
5011,7603,9747,30,0,0,0,0,0,0
5012,7604,9851,53,4,2,2,4,1,3
5013,7604,8639,47,9,4,5,0,0,0
5014,7606,7794,40,6,2,4,1,0,1
5015,7606,10242,60,5,3,2,0,0,0
5016,7609,6391,56,7,1,6,2,1,1
5017,7609,10242,44,0,0,0,1,0,1
5018,7610,9853,56,10,8,2,1,1,0
5019,7610,9829,44,2,1,1,0,0,0
5020,7611,9827,52,6,4,2,1,1,0
5021,7611,9747,48,3,2,1,0,0,0
5022,7612,9830,45,2,1,1,4,0,4
5023,7612,8689,55,1,1,0,0,0,0
5024,7613,10249,42,4,3,1,2,2,0
5025,7613,9941,58,5,4,1,0,0,0
5026,7614,9831,48,3,1,2,3,2,1
5027,7614,8592,52,5,2,3,1,1,0
5028,7615,7819,43,8,4,4,2,2,0
5029,7615,9748,57,4,1,3,2,2,0
5030,7616,9847,60,6,2,4,3,2,1
5031,7616,8639,40,2,0,2,2,0,2
5032,7617,7794,45,5,3,2,4,2,2
5033,7617,9837,55,6,3,3,2,2,0
5034,7618,9851,65,5,1,4,3,3,0
5035,7618,8121,35,1,1,0,0,0,0
5036,7619,10249,58,4,2,2,4,2,2
5037,7619,8121,42,2,0,2,0,0,0
5038,7620,10242,52,8,5,3,1,1,0
5039,7620,9829,48,6,3,3,0,0,0
5040,7621,9827,46,6,4,2,3,0,3
5041,7621,9831,54,6,2,4,3,0,3
5042,7622,9747,43,8,4,4,2,1,1
5043,7622,8689,57,8,5,3,2,0,2
5044,7623,8639,52,5,3,2,2,2,0
5045,7623,9748,48,3,0,3,4,1,3
5046,7625,9847,67,6,2,4,2,0,2
5047,7625,9837,33,4,3,1,0,0,0
5048,7626,7794,52,1,1,0,3,3,0
5049,7626,9830,48,3,1,2,0,0,0
5050,7627,7819,39,8,3,5,1,1,0
5051,7627,9851,61,1,1,0,1,0,1
5052,7628,6391,47,6,3,3,1,1,0
5053,7628,9941,53,5,2,3,0,0,0
5054,7629,7819,37,7,2,5,3,2,1
5055,7629,9853,63,7,3,4,3,0,3
5056,7630,9747,56,1,0,1,2,0,2
5057,7630,8121,44,0,0,0,0,0,0
5058,7631,8689,44,10,5,5,2,2,0
5059,7631,10242,56,7,2,5,2,0,2
5060,7632,9830,55,6,5,1,1,1,0
5061,7632,9829,45,2,1,1,0,0,0
5062,7634,10249,52,4,3,1,4,3,1
5063,7634,8639,48,3,0,3,0,0,0
5064,7635,9831,70,7,4,3,1,1,0
5065,7635,7794,30,5,3,2,2,0,2
5066,7636,9748,43,7,4,3,1,1,0
5067,7636,9847,57,3,2,1,1,1,0
5068,7638,9851,54,10,6,4,2,1,1
5069,7638,9941,46,4,1,3,1,1,0
5070,7640,6391,54,2,1,1,2,0,2
5071,7640,9827,46,5,3,2,0,0,0
5072,7641,9837,49,7,3,4,2,1,1
5073,7641,8639,51,3,1,2,0,0,0
5074,7642,9831,67,10,3,7,3,1,2
5075,7642,10242,33,4,3,1,2,0,2
5076,7643,8592,57,10,7,3,2,1,1
5077,7643,9941,43,10,3,7,0,0,0
5078,7644,9748,60,6,1,5,1,0,1
5079,7644,9747,40,4,1,3,0,0,0
5080,7646,7794,51,6,3,3,1,1,0
5081,7646,8689,49,2,0,2,0,0,0
5082,7647,9829,53,6,2,4,3,1,2
5083,7647,7819,47,7,1,6,2,1,1
5084,7648,9851,41,4,2,2,3,3,0
5085,7648,9830,59,5,0,5,1,0,1
5086,7649,9747,54,4,3,1,1,1,0
5087,7649,7794,46,5,3,2,2,0,2
5088,7650,8121,32,4,2,2,2,1,1
5089,7650,6391,68,5,1,4,4,0,4
5090,7651,9827,44,7,3,4,3,1,2
5091,7651,8639,56,6,1,5,2,1,1
5092,7652,9853,63,7,5,2,2,0,2
5093,7652,8689,37,6,4,2,1,0,1
5094,7653,9851,35,1,0,1,2,2,0
5095,7653,9748,65,4,0,4,3,0,3
5096,7655,9847,62,5,2,3,2,1,1
5097,7655,10249,38,3,1,2,1,0,1
5098,7656,9830,48,8,4,4,1,1,0
5099,7656,9837,52,2,1,1,3,1,2
5100,7658,9941,43,3,2,1,2,1,1
5101,7658,9829,57,4,2,2,0,0,0
5102,7659,9837,55,4,2,2,1,1,0
5103,7659,9829,45,8,2,6,2,1,1
5104,7660,9853,69,6,3,3,2,1,1
5105,7660,9747,31,1,1,0,1,0,1
5106,7661,10242,41,8,4,4,2,1,1
5107,7661,9847,59,7,3,4,2,1,1
5108,7662,8689,43,9,6,3,3,2,1
5109,7662,8592,57,5,2,3,0,0,0
5110,7663,8121,46,4,2,2,2,1,1
5111,7663,9830,54,10,7,3,2,0,2
5112,7665,10249,46,7,4,3,1,0,1
5113,7665,9831,54,2,2,0,0,0,0
5114,7666,8639,55,4,2,2,1,0,1
5115,7666,7794,45,1,0,1,2,0,2
5116,7667,9748,57,9,5,4,3,2,1
5117,7667,9851,43,4,1,3,2,0,2
5118,7669,8689,55,2,1,1,4,1,3
5119,7669,8121,45,8,5,3,2,1,1
5120,7670,10249,55,2,2,0,2,0,2
5121,7670,9853,45,4,1,3,1,0,1
5122,7671,9827,45,4,1,3,2,1,1
5123,7671,7794,55,4,1,3,3,0,3
5124,7673,6391,45,5,2,3,3,0,3
5125,7673,9831,55,4,4,0,0,0,0
5126,7676,9847,67,8,5,3,1,1,0
5127,7676,9829,33,5,1,4,2,1,1
5128,7678,9837,74,7,2,5,2,2,0
5129,7678,9747,26,1,0,1,0,0,0
5130,7679,9829,59,8,4,4,1,1,0
5131,7679,9827,41,2,0,2,2,1,1
5132,7680,10249,56,4,3,1,4,2,2
5133,7680,9747,44,3,0,3,2,0,2
5134,7681,8121,49,9,7,2,1,0,1
5135,7681,10242,51,8,1,7,1,0,1
5136,7682,8689,39,3,1,2,3,1,2
5137,7682,9748,61,6,4,2,3,1,2
5138,7683,9830,56,8,4,4,2,1,1
5139,7683,8639,44,4,1,3,0,0,0
5140,7684,6391,55,11,9,2,7,3,4
5141,7684,9853,45,3,2,1,0,0,0
5142,7685,9847,55,4,1,3,2,1,1
5143,7685,9831,45,4,1,3,0,0,0
5144,7686,7794,35,2,2,0,2,0,2
5145,7686,8592,65,4,1,3,0,0,0
5146,7687,9837,55,5,1,4,1,0,1
5147,7687,9851,45,3,2,1,1,0,1
5148,7688,9941,49,4,2,2,3,1,2
5149,7688,7819,51,2,0,2,1,0,1
5150,7689,8121,53,3,1,2,3,3,0
5151,7689,6391,47,1,0,1,0,0,0
5152,7690,10242,40,4,2,2,1,0,1
5153,7690,9853,60,9,4,5,0,0,0
5154,7691,9847,62,4,2,2,3,1,2
5155,7691,9747,38,6,2,4,0,0,0
5156,7692,9829,49,4,2,2,3,1,2
5157,7692,8639,51,2,0,2,1,0,1
5158,7694,9831,56,6,3,3,3,0,3
5159,7694,9851,44,4,0,4,2,0,2
5160,7695,8592,66,5,3,2,2,1,1
5161,7695,9827,34,4,1,3,0,0,0
5162,7696,8689,46,8,3,5,3,1,2
5163,7696,7819,54,5,3,2,1,0,1
5164,7698,9941,48,3,3,0,2,1,1
5165,7698,7794,52,1,0,1,1,1,0
5166,7699,9829,41,4,3,1,2,0,2
5167,7699,8592,59,3,0,3,1,0,1
5168,7701,9827,68,6,3,3,1,0,1
5169,7701,8121,32,1,1,0,0,0,0
5170,7702,9941,44,4,2,2,1,1,0
5171,7702,8689,56,4,3,1,0,0,0
5172,7703,10249,46,5,2,3,3,0,3
5173,7703,9830,54,3,1,2,0,0,0
5174,7705,9831,49,3,0,3,1,1,0
5175,7705,9748,51,3,0,3,0,0,0
5176,7707,9853,51,5,4,1,2,2,0
5177,7707,7794,49,7,4,3,2,2,0
5178,7708,9747,43,6,4,2,3,0,3
5179,7708,9851,57,7,1,6,0,0,0
5180,7709,9853,49,6,2,4,2,1,1
5181,7709,8689,51,3,0,3,1,0,1
5182,7710,9747,56,7,4,3,1,1,0
5183,7710,7819,44,7,2,5,4,4,0
5184,7713,8121,31,5,4,1,2,0,2
5185,7713,8639,69,4,4,0,1,0,1
5186,7714,10242,57,9,6,3,2,1,1
5187,7714,10249,43,6,3,3,0,0,0
5188,7715,9837,35,5,1,4,2,1,1
5189,7715,9831,65,4,2,2,1,0,1
5190,7716,9830,43,3,1,2,4,1,3
5191,7716,8592,57,2,2,0,0,0,0
5192,7717,9829,43,7,3,4,1,1,0
5193,7717,9851,57,5,2,3,3,1,2
5194,7719,8121,52,3,1,2,7,3,4
5195,7719,8592,48,3,0,3,1,1,0
5196,7721,9941,48,6,6,0,5,1,4
5197,7721,9853,52,3,0,3,0,0,0
5198,7722,9827,47,6,5,1,4,1,3
5199,7722,10242,53,8,3,5,0,0,0
5200,7723,8639,46,7,4,3,2,2,0
5201,7723,8689,54,4,1,3,1,1,0
5202,7724,9830,46,8,3,5,1,0,1
5203,7724,9831,54,2,1,1,0,0,0
5204,7725,6391,31,2,0,2,1,1,0
5205,7725,9748,69,0,0,0,1,0,1
5206,7726,9847,59,10,3,7,4,1,3
5207,7726,9851,41,5,1,4,1,1,0
5208,7727,7819,51,5,3,2,3,2,1
5209,7727,7794,49,2,1,1,0,0,0
5210,7728,9837,48,5,2,3,1,0,1
5211,7728,10249,52,4,1,3,1,0,1
5212,7729,9827,54,5,3,2,1,0,1
5213,7729,8689,46,4,3,1,1,0,1
5214,7730,9830,64,7,3,4,2,1,1
5215,7730,7819,36,3,2,1,0,0,0
5216,7731,9847,71,3,0,3,3,1,2
5217,7731,6391,29,3,0,3,0,0,0
5218,7732,8639,65,10,3,7,2,2,0
5219,7732,9747,35,4,3,1,1,0,1
5220,7733,10249,51,5,1,4,3,2,1
5221,7733,9851,49,3,1,2,0,0,0
5222,7734,9853,36,2,2,0,2,1,1
5223,7734,9831,64,2,0,2,2,1,1
5224,7735,9837,43,7,3,4,1,0,1
5225,7735,8592,57,11,8,3,0,0,0
5226,7738,9941,51,8,3,5,2,2,0
5227,7738,10242,49,2,0,2,2,1,1
5228,7739,9941,51,6,3,3,1,0,1
5229,7739,8121,49,0,0,0,0,0,0
5230,7740,9829,41,6,3,3,2,1,1
5231,7740,10249,59,4,0,4,2,0,2
5232,7741,8639,47,5,2,3,3,2,1
5233,7741,9853,53,7,3,4,1,0,1
5234,7742,9747,34,4,1,3,3,2,1
5235,7742,9831,66,3,1,2,0,0,0
5236,7743,8592,59,7,2,5,2,1,1
5237,7743,10242,41,5,2,3,1,0,1
5238,7747,9837,38,3,2,1,2,2,0
5239,7747,9748,62,3,1,2,0,0,0
5240,7748,7794,46,2,2,0,1,1,0
5241,7748,9851,54,11,6,5,0,0,0
5242,7749,9831,67,4,1,3,3,2,1
5243,7749,8121,33,1,0,1,0,0,0
5244,7750,9830,45,5,2,3,1,0,1
5245,7750,9827,55,7,3,4,0,0,0
5246,7751,7819,36,9,6,3,1,1,0
5247,7751,9748,64,2,1,1,0,0,0
5248,7753,8639,54,7,4,3,1,0,1
5249,7753,6391,46,6,2,4,0,0,0
5250,7754,9847,65,9,3,6,1,1,0
5251,7754,9829,35,2,1,1,1,0,1
5252,7755,8689,51,4,3,1,4,2,2
5253,7755,9837,49,7,6,1,2,1,1
5254,7756,9941,46,3,2,1,4,2,2
5255,7756,9851,54,1,0,1,3,1,2
5256,7757,9853,66,10,4,6,1,1,0
5257,7757,7794,34,1,0,1,2,2,0
5258,7758,10249,59,6,4,2,3,0,3
5259,7758,10242,41,6,3,3,0,0,0
5260,7759,9829,48,9,3,6,4,2,2
5261,7759,6391,52,9,4,5,1,0,1
5262,7760,8121,47,3,2,1,3,3,0
5263,7760,8689,53,5,1,4,1,0,1
5264,7761,9748,57,8,3,5,1,1,0
5265,7761,8639,43,4,3,1,0,0,0
5266,7765,9831,60,4,1,3,3,1,2
5267,7765,9747,40,2,1,1,3,0,3
5268,7766,9847,71,11,6,5,3,1,2
5269,7766,9827,29,3,0,3,2,0,2
5270,7768,10242,65,8,2,6,4,1,3
5271,7768,7819,35,6,1,5,0,0,0
5272,7770,9831,47,4,1,3,2,2,0
5273,7770,7794,53,3,1,2,2,0,2
5274,7774,9748,51,5,2,3,2,1,1
5275,7774,8592,49,6,3,3,2,2,0
5276,7775,9829,60,6,3,3,1,0,1
5277,7775,8689,40,5,4,1,1,0,1
5278,7777,8639,51,8,6,2,2,0,2
5279,7777,9851,49,3,2,1,0,0,0
5280,7778,9853,52,6,3,3,1,1,0
5281,7778,9830,48,2,0,2,2,0,2
5282,7779,8121,48,4,1,3,1,1,0
5283,7779,9837,52,2,1,1,1,0,1
5284,7780,9851,52,7,3,4,1,1,0
5285,7780,6391,48,3,1,2,0,0,0
5286,7781,9830,35,2,1,1,3,1,2
5287,7781,8639,65,10,8,2,2,0,2
5288,7783,9748,61,6,5,1,1,0,1
5289,7783,7794,39,3,2,1,0,0,0
5290,7784,9829,55,5,2,3,5,3,2
5291,7784,10249,45,6,3,3,1,1,0
5292,7785,9831,53,8,3,5,1,1,0
5293,7785,9827,47,2,1,1,0,0,0
5294,7786,9847,75,7,2,5,5,4,1
5295,7786,9747,25,7,5,2,0,0,0
5296,7787,9941,42,2,1,1,1,1,0
5297,7787,8592,58,3,1,2,0,0,0
5298,7788,9853,55,8,4,4,2,2,0
5299,7788,10242,45,6,2,4,0,0,0
5300,7789,9941,56,8,2,6,2,1,1
5301,7789,7794,44,4,3,1,0,0,0
5302,7790,9827,47,3,2,1,8,2,6
5303,7790,9748,53,5,2,3,1,0,1
5304,7791,7819,47,9,6,3,4,1,3
5305,7791,6391,53,4,2,2,2,0,2
5306,7796,8639,60,6,2,4,3,1,2
5307,7796,9837,40,4,2,2,1,0,1
5308,7800,7819,39,8,6,2,1,0,1
5309,7800,9853,61,5,3,2,0,0,0
5310,7804,9837,43,5,2,3,1,0,1
5311,7804,9748,57,7,4,3,1,0,1
5312,7806,8592,45,7,5,2,5,2,3
5313,7806,9847,55,8,7,1,0,0,0
5314,7807,9747,47,10,4,6,1,1,0
5315,7807,10242,53,6,3,3,2,0,2
5316,7808,9830,42,6,3,3,3,2,1
5317,7808,9831,58,6,3,3,0,0,0
5318,7831,8697,61,7,5,2,1,1,0
5319,7831,8177,39,1,0,1,2,0,2
5320,7836,9789,54,4,1,3,3,1,2
5321,7836,9790,46,2,2,0,2,0,2
5322,7838,10189,66,7,6,1,1,1,0
5323,7838,9823,34,1,0,1,3,1,2
5324,7848,8697,56,5,1,4,1,0,1
5325,7848,8722,44,2,2,0,0,0,0
5326,7855,9790,37,9,4,5,1,1,0
5327,7855,8697,63,6,3,3,2,1,1
5328,7863,8178,59,9,6,3,3,2,1
5329,7863,9823,41,4,2,2,1,0,1
5330,7865,10189,52,2,2,0,1,0,1
5331,7865,10269,48,3,2,1,0,0,0
5332,7867,8177,49,8,6,2,5,3,2
5333,7867,8722,51,7,4,3,0,0,0
5334,7872,8226,43,4,3,1,1,0,1
5335,7872,9823,57,2,0,2,1,0,1
5336,7873,10189,63,5,2,3,1,1,0
5337,7873,8177,37,2,0,2,2,0,2
5338,7889,10189,49,1,1,0,1,1,0
5339,7889,8226,51,5,1,4,1,1,0
5340,7890,9790,38,6,3,3,3,2,1
5341,7890,9823,62,10,2,8,0,0,0
5342,7891,8178,57,9,2,7,5,2,3
5343,7891,9789,43,4,2,2,1,0,1
5344,7893,8697,73,8,3,5,2,2,0
5345,7893,9912,27,1,0,1,3,2,1
5346,7899,9823,62,14,8,6,1,0,1
5347,7899,9789,38,3,1,2,3,0,3
5348,7909,9789,41,9,4,5,2,2,0
5349,7909,9823,59,3,2,1,1,0,1
5350,7915,9904,67,7,4,3,4,2,2
5351,7915,8398,33,5,2,3,1,1,0
5352,7927,9790,40,4,1,3,1,0,1
5353,7927,8178,60,4,1,3,1,0,1
5354,7945,9911,33,5,2,3,3,2,1
5355,7945,8178,67,11,7,4,0,0,0
5356,7947,10189,61,4,4,0,2,1,1
5357,7947,8722,39,3,1,2,0,0,0
5358,7954,10269,44,7,4,3,3,3,0
5359,7954,8697,56,1,1,0,2,1,1
5360,7956,8721,35,5,2,3,1,1,0
5361,7956,10189,65,1,0,1,1,0,1
5362,7969,9911,39,2,2,0,1,1,0
5363,7969,9788,61,10,2,8,1,0,1
5364,7971,8226,57,8,4,4,4,2,2
5365,7971,9790,43,4,0,4,1,0,1
5366,7976,10189,62,4,2,2,1,1,0
5367,7976,9912,38,6,4,2,2,1,1
5368,7983,10269,53,11,3,8,2,2,0
5369,7983,9790,47,4,1,3,1,1,0
5370,7992,8178,65,3,1,2,3,0,3
5371,7992,8721,35,9,3,6,0,0,0
5372,8006,8226,54,12,5,7,1,1,0
5373,8006,8177,46,3,1,2,0,0,0
5374,8010,10189,51,6,4,2,3,1,2
5375,8010,9911,49,3,1,2,2,1,1
5376,8019,8226,55,5,2,3,5,2,3
5377,8019,8721,45,7,5,2,1,0,1
5378,8023,9904,48,4,4,0,1,0,1
5379,8023,9911,52,7,1,6,0,0,0
5380,8025,8178,66,5,3,2,3,2,1
5381,8025,9912,34,3,1,2,1,0,1
5382,8051,8226,36,5,3,2,3,1,2
5383,8051,9823,64,8,4,4,0,0,0
5384,8052,9823,51,3,2,1,1,1,0
5385,8052,10269,49,5,3,2,4,0,4
5386,8054,8721,42,6,1,5,1,0,1
5387,8054,8697,58,8,2,6,0,0,0
5388,8074,9790,63,6,1,5,1,1,0
5389,8074,8721,37,0,0,0,1,0,1
5390,8080,9789,44,4,2,2,1,0,1
5391,8080,10269,56,7,3,4,1,0,1
5392,8084,8722,43,7,4,3,2,0,2
5393,8084,10189,57,1,0,1,0,0,0
5394,8098,9789,34,3,2,1,1,0,1
5395,8098,8697,66,11,3,8,1,0,1
5396,8103,9911,64,6,4,2,3,3,0
5397,8103,9788,36,3,1,2,0,0,0
5398,8106,9823,67,5,2,3,5,3,2
5399,8106,8721,33,5,3,2,0,0,0
5400,8107,8178,58,4,2,2,3,2,1
5401,8107,8722,42,7,3,4,1,0,1
5402,8114,9790,52,5,1,4,1,0,1
5403,8114,8226,48,7,5,2,0,0,0
5404,8125,8178,68,5,1,4,4,2,2
5405,8125,9789,32,0,0,0,1,0,1
5406,8126,8177,45,7,4,3,3,1,2
5407,8126,8721,55,5,1,4,0,0,0
5408,8127,10189,43,8,4,4,1,0,1
5409,8127,9790,57,3,2,1,0,0,0
5410,8134,8177,46,5,4,1,2,1,1
5411,8134,9789,54,10,3,7,0,0,0
5412,8136,10189,47,6,1,5,2,1,1
5413,8136,8178,53,3,2,1,1,0,1
5414,8138,8226,55,7,4,3,2,0,2
5415,8138,8358,45,2,0,2,0,0,0
5416,8143,8178,52,7,5,2,8,5,3
5417,8143,9810,48,3,3,0,0,0,0
5418,8144,8697,55,7,3,4,3,3,0
5419,8144,9789,45,6,2,4,1,1,0
5420,8151,8178,49,3,2,1,1,1,0
5421,8151,9823,51,4,2,2,0,0,0
5422,8164,9911,40,5,1,4,2,2,0
5423,8164,8722,60,2,2,0,2,1,1
5424,8169,9823,56,9,3,6,6,3,3
5425,8169,9788,44,9,8,1,0,0,0
5426,8173,8177,43,8,2,6,3,2,1
5427,8173,10189,57,6,2,4,0,0,0
5428,8175,9810,46,4,1,3,2,0,2
5429,8175,9905,54,4,3,1,1,0,1
5430,8179,8178,59,4,2,2,4,1,3
5431,8179,8177,41,2,2,0,4,0,4
5432,8196,8226,45,8,4,4,1,0,1
5433,8196,9823,55,9,3,6,0,0,0
5434,8200,8165,47,2,2,0,2,2,0
5435,8200,10189,53,2,1,1,4,1,3
5436,8205,9789,49,6,4,2,3,1,2
5437,8205,9790,51,4,1,3,0,0,0
5438,8208,8721,53,7,2,5,1,1,0
5439,8208,8722,47,4,4,0,1,0,1
5440,8224,8178,58,9,6,3,3,1,2
5441,8224,8358,42,3,2,1,1,0,1
5442,8225,9790,70,12,6,6,5,3,2
5443,8225,8721,30,2,2,0,0,0,0
5444,8226,9789,47,3,2,1,1,1,0
5445,8226,10269,53,2,1,1,1,0,1
5446,8232,9789,56,7,4,3,2,2,0
5447,8232,9810,44,2,2,0,4,0,4
5448,8233,8177,39,1,1,0,1,1,0
5449,8233,8697,61,9,4,5,1,1,0
5450,8234,8721,43,7,2,5,1,1,0
5451,8234,9823,57,9,4,5,4,3,1
5452,8237,8165,58,2,1,1,2,1,1
5453,8237,10269,42,6,0,6,2,0,2
5454,8241,9789,42,9,5,4,2,0,2
5455,8241,9823,58,3,3,0,1,0,1
5456,8245,8722,54,2,2,0,2,1,1
5457,8245,10189,46,2,0,2,0,0,0
5458,8246,8358,45,3,3,0,3,1,2
5459,8246,9810,55,5,3,2,2,0,2
5460,8249,9788,42,6,1,5,1,1,0
5461,8249,8165,58,9,2,7,1,1,0
5462,8252,8178,52,5,4,1,1,0,1
5463,8252,8697,48,4,4,0,0,0,0
5464,8254,8177,55,8,4,4,3,0,3
5465,8254,8358,45,8,5,3,0,0,0
5466,8258,9788,45,5,3,2,1,1,0
5467,8258,8226,55,9,4,5,4,2,2
5468,8259,9823,51,8,5,3,4,1,3
5469,8259,9790,49,3,2,1,1,0,1
5470,8260,8178,62,4,1,3,1,0,1
5471,8260,8722,38,1,1,0,2,0,2
5472,8263,9789,49,2,2,0,2,2,0
5473,8263,10189,51,7,3,4,2,0,2
5474,8275,8165,40,4,1,3,1,1,0
5475,8275,8178,60,8,1,7,2,0,2
5476,8278,8178,56,7,4,3,2,1,1
5477,8278,9790,44,3,1,2,1,1,0
5478,8280,10269,59,4,3,1,3,2,1
5479,8280,10189,41,1,1,0,2,1,1
5480,8286,9790,54,8,2,6,2,0,2
5481,8286,10189,46,8,4,4,0,0,0
5482,8287,8178,61,6,3,3,3,3,0
5483,8287,9789,39,3,0,3,0,0,0
5484,8295,9823,57,3,1,2,2,1,1
5485,8295,10269,43,7,1,6,1,0,1
5486,8296,8178,62,3,2,1,2,1,1
5487,8296,10189,38,1,0,1,0,0,0
5488,8299,9810,64,5,2,3,2,1,1
5489,8299,9911,36,0,0,0,2,0,2
5490,8315,9790,53,8,3,5,2,1,1
5491,8315,8721,47,4,1,3,0,0,0
5492,8321,8226,57,7,4,3,2,1,1
5493,8321,10189,43,0,0,0,2,0,2
5494,8322,8178,45,4,3,1,1,1,0
5495,8322,9823,55,2,0,2,0,0,0
5496,8327,10189,62,3,2,1,1,1,0
5497,8327,9904,38,2,1,1,0,0,0
5498,8329,9788,47,5,2,3,3,2,1
5499,8329,9810,53,2,0,2,1,1,0
5500,8331,9823,66,10,5,5,1,1,0
5501,8331,9904,34,1,0,1,1,0,1
5502,8339,8722,48,6,3,3,4,2,2
5503,8339,9911,52,4,2,2,0,0,0
5504,8354,8697,44,2,2,0,1,0,1
5505,8354,10189,56,4,0,4,0,0,0
5506,8358,8697,48,17,10,7,3,1,2
5507,8358,9790,52,5,2,3,1,1,0
5508,8359,9823,67,7,6,1,2,1,1
5509,8359,8177,33,7,3,4,0,0,0
5510,8363,9911,63,9,4,5,3,1,2
5511,8363,9904,37,3,0,3,0,0,0
5512,8364,10189,61,6,2,4,4,1,3
5513,8364,9905,39,8,5,3,0,0,0
5514,8367,9823,60,5,2,3,4,2,2
5515,8367,8721,40,6,1,5,0,0,0
5516,8369,8722,47,5,2,3,1,1,0
5517,8369,9790,53,5,3,2,3,0,3
5518,8371,8177,43,7,3,4,2,1,1
5519,8371,8697,57,9,6,3,2,1,1
5520,8375,9788,52,6,1,5,3,0,3
5521,8375,9905,48,2,0,2,1,0,1
5522,8376,10269,43,3,1,2,1,0,1
5523,8376,9790,57,11,2,9,0,0,0
5524,8381,8722,60,6,1,5,1,0,1
5525,8381,10189,40,0,0,0,1,0,1
5526,8386,8178,48,4,2,2,2,1,1
5527,8386,8697,52,1,1,0,1,0,1
5528,8389,8721,52,5,3,2,2,2,0
5529,8389,10189,48,5,0,5,2,0,2
5530,8394,9823,56,5,3,2,1,1,0
5531,8394,9790,44,6,3,3,5,1,4
5532,8395,9789,58,5,3,2,1,1,0
5533,8395,10189,42,5,2,3,0,0,0
5534,8398,8358,47,8,7,1,4,2,2
5535,8398,9788,53,3,0,3,3,1,2
5536,8401,8165,65,5,2,3,1,1,0
5537,8401,9911,35,3,2,1,0,0,0
5538,8406,8177,41,4,2,2,4,1,3
5539,8406,9790,59,2,1,1,0,0,0
5540,8407,10189,40,5,3,2,2,1,1
5541,8407,9810,60,4,1,3,0,0,0
5542,8412,9790,62,3,2,1,4,1,3
5543,8412,8178,38,3,1,2,1,1,0
5544,8421,9823,67,7,3,4,1,0,1
5545,8421,8721,33,5,1,4,0,0,0
5546,8422,8226,47,4,3,1,3,1,2
5547,8422,8697,53,5,1,4,0,0,0
5548,8427,9790,51,7,4,3,3,1,2
5549,8427,10189,49,5,3,2,2,1,1
5550,8433,10269,46,9,5,4,3,1,2
5551,8433,8721,54,8,5,3,1,1,0
5552,8434,9789,52,5,4,1,5,1,4
5553,8434,9905,48,4,1,3,2,1,1
5554,8435,9904,41,2,1,1,4,3,1
5555,8435,8226,59,6,4,2,0,0,0
5556,8440,8178,63,10,8,2,2,1,1
5557,8440,8350,37,6,3,3,1,0,1
5558,8441,10269,37,6,3,3,1,1,0
5559,8441,8697,63,3,1,2,2,0,2
5560,8446,9789,52,9,3,6,3,1,2
5561,8446,9904,48,2,0,2,2,0,2
5562,8448,8165,43,4,2,2,1,1,0
5563,8448,9823,57,5,2,3,0,0,0
5564,8458,8178,40,8,4,4,1,1,0
5565,8458,9823,60,3,1,2,0,0,0
5566,8459,10269,54,7,5,2,2,1,1
5567,8459,8722,46,3,0,3,0,0,0
5568,8465,8152,45,10,3,7,2,1,1
5569,8465,8721,55,1,0,1,2,1,1
5570,8466,9823,73,9,3,6,4,2,2
5571,8466,9810,27,3,1,2,1,0,1
5572,8467,8697,40,5,5,0,1,0,1
5573,8467,8152,60,9,2,7,0,0,0
5574,8472,8722,46,10,6,4,2,1,1
5575,8472,8721,54,3,2,1,0,0,0
5576,8478,8721,58,4,3,1,4,3,1
5577,8478,8697,42,11,2,9,4,1,3
5578,8482,9789,56,9,5,4,1,1,0
5579,8482,8165,44,2,2,0,0,0,0
5580,8484,9823,60,11,4,7,3,2,1
5581,8484,8152,40,3,0,3,0,0,0
5582,8487,9905,56,4,3,1,1,1,0
5583,8487,10189,44,4,2,2,1,0,1
5584,8490,8358,55,8,7,1,2,2,0
5585,8490,9788,45,5,3,2,2,1,1
5586,8495,8358,36,3,2,1,2,1,1
5587,8495,8178,64,6,3,3,1,0,1
5588,8502,10189,43,2,2,0,1,1,0
5589,8502,9790,57,3,2,1,0,0,0
5590,8506,8721,35,3,2,1,1,0,1
5591,8506,9823,65,8,4,4,0,0,0
5592,8513,9810,47,3,3,0,2,1,1
5593,8513,9790,53,3,1,2,1,0,1
5594,8515,8152,35,7,5,2,1,1,0
5595,8515,8226,65,4,1,3,0,0,0
5596,8516,9788,34,8,2,6,2,1,1
5597,8516,8178,66,3,1,2,1,1,0
5598,8517,8722,54,4,1,3,1,1,0
5599,8517,8697,46,2,0,2,1,0,1
5600,8520,10189,64,6,2,4,1,0,1
5601,8520,9904,36,2,1,1,1,0,1
5602,8531,9904,47,4,2,2,3,1,2
5603,8531,8178,53,7,5,2,0,0,0
5604,8532,8358,40,3,3,0,1,1,0
5605,8532,10269,60,6,3,3,1,0,1
5606,8533,9789,43,6,3,3,5,1,4
5607,8533,8721,57,4,2,2,1,0,1
5608,8534,9810,61,4,3,1,3,2,1
5609,8534,9788,39,5,0,5,2,0,2
5610,8536,9905,48,10,3,7,1,0,1
5611,8536,8350,52,11,4,7,0,0,0
5612,8538,9789,59,11,6,5,2,2,0
5613,8538,10189,41,2,0,2,0,0,0
5614,8539,9790,66,15,8,7,4,2,2
5615,8539,8152,34,3,1,2,0,0,0
5616,8544,8358,46,6,3,3,2,2,0
5617,8544,9810,54,2,2,0,0,0,0
5618,8549,8697,62,6,3,3,2,2,0
5619,8549,9904,38,2,0,2,2,1,1
5620,8553,8722,47,6,2,4,2,2,0
5621,8553,9905,53,2,1,1,1,1,0
5622,8556,10269,43,4,3,1,2,1,1
5623,8556,8178,57,4,3,1,0,0,0
5624,8561,9788,43,6,4,2,9,3,6
5625,8561,10189,57,0,0,0,1,0,1
5626,8564,8165,51,5,1,4,2,1,1
5627,8564,9810,49,1,0,1,4,0,4
5628,8567,8697,49,8,5,3,5,3,2
5629,8567,8178,51,8,4,4,4,0,4
5630,8568,8721,59,5,3,2,1,0,1
5631,8568,9788,41,3,1,2,0,0,0
5632,8575,9789,62,10,4,6,2,1,1
5633,8575,8722,38,4,2,2,0,0,0
5634,8577,9790,51,1,1,0,3,3,0
5635,8577,9905,49,4,2,2,2,1,1
5636,8580,8697,45,6,2,4,1,1,0
5637,8580,8358,55,1,0,1,1,0,1
5638,8589,9904,55,5,5,0,2,1,1
5639,8589,8722,45,4,2,2,1,1,0
5640,8593,9905,48,2,1,1,2,1,1
5641,8593,9789,52,3,1,2,2,0,2
5642,8598,8358,38,4,2,2,1,1,0
5643,8598,9823,62,7,0,7,1,1,0
5644,8604,9810,34,4,2,2,4,3,1
5645,8604,8721,66,9,4,5,2,1,1
5646,8606,9790,52,4,2,2,1,0,1
5647,8606,8226,48,8,6,2,1,0,1
5648,8619,9823,58,9,4,5,6,2,4
5649,8619,8697,42,4,1,3,0,0,0
5650,8620,9789,61,10,4,6,4,2,2
5651,8620,8721,39,1,0,1,1,1,0
5652,8622,8350,36,8,6,2,2,1,1
5653,8622,9905,64,5,2,3,0,0,0
5654,8623,8226,48,9,5,4,2,0,2
5655,8623,10189,52,4,1,3,0,0,0
5656,8625,8152,56,5,1,4,1,0,1
5657,8625,8722,44,9,5,4,1,0,1
5658,8629,10189,45,7,2,5,2,2,0
5659,8629,8697,55,8,3,5,6,3,3
5660,8633,9905,61,5,3,2,3,2,1
5661,8633,9788,39,5,3,2,1,0,1
5662,8640,8722,55,5,2,3,2,1,1
5663,8640,8721,45,6,3,3,2,0,2
5664,8642,9789,59,10,5,5,1,1,0
5665,8642,9788,41,1,0,1,3,1,2
5666,8644,8165,61,4,2,2,1,1,0
5667,8644,9905,39,2,2,0,0,0,0
5668,8646,9823,56,7,3,4,4,1,3
5669,8646,10189,44,1,0,1,2,0,2
5670,8647,8721,33,3,2,1,3,0,3
5671,8647,8697,67,6,3,3,0,0,0
5672,8648,9789,48,5,3,2,4,2,2
5673,8648,8165,52,3,0,3,0,0,0
5674,8656,8697,42,4,3,1,3,1,2
5675,8656,9789,58,4,1,3,0,0,0
5676,8663,9823,51,5,3,2,2,1,1
5677,8663,8152,49,5,2,3,0,0,0
5678,8667,9789,66,8,4,4,2,1,1
5679,8667,9810,34,3,2,1,0,0,0
5680,8673,9823,77,14,5,9,3,1,2
5681,8673,8722,23,5,1,4,0,0,0
5682,8674,9789,44,11,8,3,2,1,1
5683,8674,10189,56,1,0,1,2,1,1
5684,8679,8358,45,6,4,2,4,2,2
5685,8679,9810,55,3,2,1,1,0,1
5686,8681,9790,60,2,1,1,2,1,1
5687,8681,8152,40,2,2,0,0,0,0
5688,8683,8350,44,3,1,2,1,1,0
5689,8683,9789,56,8,4,4,0,0,0
5690,8686,8226,22,4,4,0,1,1,0
5691,8686,9823,78,3,2,1,1,0,1
5692,8691,9823,70,7,1,6,3,1,2
5693,8691,9905,30,3,2,1,2,1,1
5694,8703,9790,60,4,1,3,2,0,2
5695,8703,8350,40,2,0,2,0,0,0
5696,8714,8226,66,11,4,7,1,0,1
5697,8714,9788,34,3,3,0,3,0,3
5698,8716,8350,43,6,2,4,1,1,0
5699,8716,9810,57,4,1,3,1,0,1
5700,8718,8178,49,3,2,1,3,1,2
5701,8718,9905,51,6,2,4,1,1,0
5702,8719,8226,35,5,2,3,2,0,2
5703,8719,9789,65,3,0,3,0,0,0
5704,8727,9789,57,3,2,1,2,1,1
5705,8727,9790,43,1,0,1,2,0,2
5706,8735,9823,59,10,5,5,1,1,0
5707,8735,9788,41,4,4,0,0,0,0
5708,8736,9789,59,6,3,3,4,2,2
5709,8736,8722,41,2,0,2,0,0,0
5710,8743,8406,33,5,5,0,1,0,1
5711,8743,8697,67,9,4,5,0,0,0
5712,8747,8350,49,6,4,2,1,0,1
5713,8747,9790,51,7,3,4,1,0,1
5714,8750,10269,46,10,3,7,2,1,1
5715,8750,9789,54,6,1,5,0,0,0
5716,8751,8406,49,6,2,4,3,0,3
5717,8751,8722,51,0,0,0,0,0,0
5718,8754,9789,56,9,3,6,5,2,3
5719,8754,8721,44,3,1,2,0,0,0
5720,8756,8178,49,4,2,2,2,1,1
5721,8756,9790,51,5,2,3,1,1,0
5722,8758,10269,58,9,2,7,1,1,0
5723,8758,9905,42,9,4,5,1,0,1
5724,8761,9823,64,6,5,1,1,0,1
5725,8761,8406,36,2,0,2,0,0,0
5726,8770,8721,47,6,4,2,2,1,1
5727,8770,9904,53,5,3,2,0,0,0
5728,8774,9790,61,9,5,4,3,2,1
5729,8774,9904,39,8,5,3,1,0,1
5730,8778,9788,59,8,2,6,3,1,2
5731,8778,8722,41,5,3,2,3,1,2
5732,8781,8178,51,7,5,2,4,1,3
5733,8781,8226,49,3,2,1,1,0,1
5734,8787,10269,59,9,3,6,2,2,0
5735,8787,8722,41,5,2,3,0,0,0
5736,8789,9788,55,3,2,1,3,1,2
5737,8789,9789,45,5,3,2,1,0,1
5738,8790,8350,45,4,4,0,1,0,1
5739,8790,9789,55,10,4,6,0,0,0
5740,8791,8721,48,8,4,4,2,2,0
5741,8791,8697,52,9,5,4,0,0,0
5742,8795,9823,74,7,3,4,2,2,0
5743,8795,10269,26,1,0,1,2,0,2
5744,8798,8177,61,9,7,2,3,2,1
5745,8798,10189,39,3,1,2,2,1,1
5746,8800,9823,68,6,6,0,2,0,2
5747,8800,8722,32,1,0,1,0,0,0
5748,8807,9905,51,7,1,6,2,2,0
5749,8807,9788,49,3,1,2,2,0,2
5750,8808,9905,48,4,2,2,2,1,1
5751,8808,8178,52,2,0,2,1,0,1
5752,8810,9789,45,6,2,4,1,1,0
5753,8810,9790,55,1,0,1,1,1,0
5754,8815,8721,51,10,5,5,2,1,1
5755,8815,8722,49,4,4,0,1,1,0
5756,8816,9823,68,10,7,3,1,1,0
5757,8816,9788,32,2,0,2,2,0,2
5758,8822,10269,53,8,5,3,2,1,1
5759,8822,9788,47,11,4,7,0,0,0
5760,8823,8722,41,4,1,3,2,1,1
5761,8823,10189,59,5,2,3,0,0,0
5762,8826,8178,56,6,3,3,3,0,3
5763,8826,8697,44,6,2,4,0,0,0
5764,8831,8350,65,9,4,5,1,1,0
5765,8831,8406,35,5,3,2,1,0,1
5766,8834,10269,49,8,6,2,3,3,0
5767,8834,9788,51,3,1,2,1,0,1
5768,8840,8350,47,4,2,2,1,1,0
5769,8840,8722,53,6,2,4,1,0,1
5770,8849,9790,67,9,5,4,2,1,1
5771,8849,8722,33,7,2,5,0,0,0
5772,8851,9788,52,2,1,1,3,2,1
5773,8851,10189,48,2,0,2,1,0,1
5774,8852,8406,55,6,4,2,1,0,1
5775,8852,8165,45,5,0,5,0,0,0
5776,8854,8721,44,6,2,4,2,1,1
5777,8854,10189,56,6,2,4,0,0,0
5778,8855,9790,55,6,2,4,2,1,1
5779,8855,8697,45,7,5,2,1,1,0
5780,8858,8358,39,8,4,4,2,0,2
5781,8858,9823,61,5,1,4,0,0,0
5782,8861,9789,56,8,6,2,2,1,1
5783,8861,8177,44,3,1,2,1,1,0
5784,8862,9904,51,1,1,0,2,0,2
5785,8862,9789,49,7,2,5,0,0,0
5786,8863,9823,54,11,8,3,1,1,0
5787,8863,10189,46,4,3,1,2,2,0
5788,8864,8697,65,10,4,6,3,3,0
5789,8864,8165,35,4,1,3,2,1,1
5790,8867,8178,51,8,3,5,1,1,0
5791,8867,8722,49,7,2,5,3,0,3
5792,8871,9789,57,7,3,4,1,1,0
5793,8871,9905,43,2,0,2,2,0,2
5794,8872,9823,55,8,5,3,2,2,0
5795,8872,8178,45,6,3,3,1,1,0
5796,8880,9823,59,8,4,4,2,0,2
5797,8880,8226,41,1,0,1,0,0,0
5798,8881,9790,55,11,7,4,1,1,0
5799,8881,10189,45,6,5,1,3,2,1
5800,8888,8406,38,2,1,1,1,1,0
5801,8888,9789,62,4,1,3,2,1,1
5802,8889,9789,53,5,3,2,2,2,0
5803,8889,8697,47,2,1,1,2,1,1
5804,8895,10269,39,7,4,3,4,2,2
5805,8895,8226,61,7,2,5,1,1,0
5806,8897,9823,71,8,4,4,2,1,1
5807,8897,8177,29,3,2,1,4,2,2
5808,8899,10189,52,9,4,5,2,1,1
5809,8899,8178,48,5,2,3,2,1,1
5810,8905,8721,43,6,3,3,2,1,1
5811,8905,9790,57,0,0,0,0,0,0
5812,8907,9789,49,14,9,5,2,0,2
5813,8907,10269,51,1,1,0,0,0,0
5814,8911,8165,48,5,4,1,1,1,0
5815,8911,9823,52,3,0,3,0,0,0
5816,8914,8721,53,4,3,1,1,1,0
5817,8914,8177,47,6,2,4,0,0,0
5818,8917,10189,53,9,3,6,3,2,1
5819,8917,9904,47,0,0,0,3,1,2
5820,8918,8178,46,9,3,6,1,1,0
5821,8918,9790,54,6,0,6,0,0,0
5822,8923,8721,43,5,2,3,2,1,1
5823,8923,9789,57,2,1,1,1,1,0
5824,8924,9788,70,5,3,2,1,1,0
5825,8924,8177,30,5,1,4,0,0,0
5826,8926,9823,63,11,6,5,2,1,1
5827,8926,9790,37,2,1,1,1,0,1
5828,8928,9904,46,6,1,5,1,1,0
5829,8928,8177,54,4,0,4,1,0,1
5830,8929,9905,46,7,5,2,4,3,1
5831,8929,10189,54,7,2,5,0,0,0
5832,8931,8722,52,8,5,3,2,1,1
5833,8931,8350,48,7,4,3,2,1,1
5834,8932,8721,44,2,1,1,1,0,1
5835,8932,9788,56,9,5,4,0,0,0
5836,8936,9788,65,11,2,9,1,1,0
5837,8936,8697,35,7,2,5,1,1,0
5838,8953,9823,64,4,2,2,2,2,0
5839,8953,8697,36,4,1,3,1,0,1
5840,8955,9905,56,10,6,4,1,1,0
5841,8955,8721,44,4,2,2,4,1,3
5842,8962,10269,52,4,2,2,6,4,2
5843,8962,9823,48,7,2,5,0,0,0
5844,8976,9823,55,8,3,5,2,1,1
5845,8976,8722,45,3,2,1,0,0,0
5846,8979,8178,46,12,8,4,2,2,0
5847,8979,9789,54,5,2,3,1,0,1
5848,8982,9904,55,9,4,5,2,1,1
5849,8982,9905,45,2,1,1,1,0,1
5850,8987,8177,49,6,2,4,3,3,0
5851,8987,10269,51,9,4,5,3,0,3
5852,8990,9790,52,4,2,2,1,0,1
5853,8990,8697,48,8,4,4,0,0,0
5854,8996,8178,60,6,3,3,1,0,1
5855,8996,8406,40,7,1,6,0,0,0
5856,8997,8178,64,8,5,3,3,1,2
5857,8997,8722,36,2,0,2,0,0,0
5858,9000,9789,58,7,7,0,2,1,1
5859,9000,9904,42,8,3,5,0,0,0
5860,9003,8350,44,8,4,4,2,1,1
5861,9003,9905,56,4,1,3,0,0,0
5862,9010,9790,46,6,2,4,3,0,3
5863,9010,10269,54,6,4,2,0,0,0
5864,9017,9790,51,10,5,5,4,1,3
5865,9017,10189,49,2,0,2,5,2,3
5866,9018,8697,57,6,4,2,5,4,1
5867,9018,9904,43,5,1,4,0,0,0
5868,9021,8350,54,8,2,6,1,1,0
5869,9021,10269,46,3,0,3,2,1,1
5870,9023,8177,41,2,1,1,2,2,0
5871,9023,8722,59,2,1,1,2,2,0
5872,9025,8350,46,7,3,4,1,0,1
5873,9025,10189,54,7,4,3,0,0,0
5874,9026,9789,37,5,4,1,1,0,1
5875,9026,8697,63,10,3,7,0,0,0
5876,9028,8358,60,7,5,2,3,1,2
5877,9028,9790,40,5,2,3,2,0,2
5878,9030,8722,41,3,2,1,5,3,2
5879,9030,9904,59,7,3,4,1,0,1
5880,9650,8177,51,6,4,2,3,0,3
5881,9650,8697,49,2,0,2,4,0,4
5882,9651,9810,37,5,2,3,5,3,2
5883,9651,8358,63,9,2,7,0,0,0
5884,9652,9790,53,8,4,4,3,3,0
5885,9652,8722,47,5,2,3,1,0,1
5886,9655,8406,46,11,6,5,1,1,0
5887,9655,10189,54,9,2,7,0,0,0
5888,9656,8226,55,7,5,2,1,0,1
5889,9656,9788,45,6,2,4,0,0,0
5890,9658,9904,60,8,3,5,2,1,1
5891,9658,9810,40,5,1,4,1,1,0
5892,9659,10269,56,4,3,1,1,1,0
5893,9659,8721,44,4,0,4,2,0,2
5894,9661,8358,42,4,2,2,1,0,1
5895,9661,8722,58,5,1,4,1,0,1
5896,9662,8460,48,5,3,2,3,2,1
5897,9662,8177,52,3,2,1,2,1,1
5898,9665,9790,47,7,3,4,2,1,1
5899,9665,8721,53,7,4,3,1,1,0
5900,9668,9904,52,4,3,1,2,0,2
5901,9668,8177,48,2,2,0,1,0,1
5902,9670,9823,63,11,4,7,2,1,1
5903,9670,9810,37,3,2,1,0,0,0
5904,9672,9823,61,6,2,4,3,2,1
5905,9672,8226,39,6,3,3,1,1,0
5906,9674,9788,57,4,2,2,3,2,1
5907,9674,9810,43,11,4,7,1,1,0
5908,9675,8358,38,6,2,4,1,1,0
5909,9675,9905,62,2,1,1,0,0,0
5910,9676,9904,56,6,4,2,1,1,0
5911,9676,8178,44,6,1,5,3,0,3
5912,9677,10269,43,3,1,2,3,1,2
5913,9677,8406,57,10,3,7,3,2,1
5914,9678,9790,59,5,3,2,2,2,0
5915,9678,8697,41,8,4,4,1,0,1
5916,9679,8722,58,4,2,2,3,0,3
5917,9679,8177,42,4,1,3,1,0,1
5918,9680,8460,39,2,1,1,3,1,2
5919,9680,9789,61,4,1,3,1,0,1
5920,9682,8178,59,13,8,5,1,1,0
5921,9682,8722,41,0,0,0,0,0,0
5922,9683,9788,62,7,5,2,1,0,1
5923,9683,8721,38,13,5,8,1,0,1
5924,9685,8226,43,4,1,3,2,1,1
5925,9685,9904,57,2,1,1,1,1,0
5926,9686,9823,72,6,4,2,1,0,1
5927,9686,8177,28,1,0,1,1,0,1
5928,9687,8697,54,10,4,6,1,1,0
5929,9687,8460,46,4,2,2,5,2,3
5930,9688,9789,54,6,3,3,1,1,0
5931,9688,9810,46,2,1,1,1,0,1
5932,9689,8358,57,10,6,4,2,1,1
5933,9689,10269,43,8,2,6,1,0,1
5934,9690,8178,39,1,1,0,2,2,0
5935,9690,9823,61,6,2,4,0,0,0
5936,9691,9789,52,12,3,9,1,1,0
5937,9691,8226,48,4,2,2,0,0,0
5938,9692,8177,46,4,2,2,4,2,2
5939,9692,9788,54,9,4,5,1,1,0
5940,9693,9904,51,8,7,1,1,1,0
5941,9693,8721,49,5,2,3,0,0,0
5942,9694,8697,48,4,2,2,2,1,1
5943,9694,9810,52,7,2,5,3,1,2
5944,9695,10269,51,5,1,4,1,0,1
5945,9695,10189,49,2,1,1,0,0,0
5946,9696,9790,43,5,2,3,1,1,0
5947,9696,9905,57,4,0,4,3,2,1
5948,9697,8722,38,6,4,2,1,1,0
5949,9697,8406,62,3,1,2,2,1,1
5950,9704,9810,49,11,4,7,3,1,2
5951,9704,8226,51,6,1,5,0,0,0
5952,9705,8177,36,2,2,0,1,0,1
5953,9705,9789,64,7,1,6,0,0,0
5954,9707,9790,49,5,2,3,3,1,2
5955,9707,8358,51,5,1,4,0,0,0
5956,9708,9823,76,15,7,8,2,1,1
5957,9708,8358,24,1,0,1,3,0,3
5958,9709,8721,65,6,4,2,1,1,0
5959,9709,9789,35,8,1,7,3,1,2
5960,9710,8697,40,5,3,2,1,1,0
5961,9710,9788,60,4,0,4,1,0,1
5962,9711,8178,56,9,3,6,1,1,0
5963,9711,8226,44,8,4,4,0,0,0
5964,9712,8406,47,6,3,3,3,1,2
5965,9712,9904,53,4,1,3,0,0,0
5966,9713,9810,71,8,1,7,1,0,1
5967,9713,8177,29,1,0,1,1,0,1
5968,9714,10269,38,7,5,2,2,0,2
5969,9714,9790,62,4,0,4,1,0,1
5970,9716,10189,52,9,4,5,1,1,0
5971,9716,8460,48,6,1,5,0,0,0
5972,9717,10189,54,10,6,4,2,1,1
5973,9717,9790,46,10,2,8,0,0,0
5974,9718,8178,56,9,2,7,1,1,0
5975,9718,9810,44,5,4,1,1,0,1
5976,9720,9823,65,7,2,5,2,1,1
5977,9720,9905,35,5,2,3,2,1,1
5978,9723,8697,37,4,3,1,1,1,0
5979,9723,9789,63,8,3,5,1,0,1
5980,9726,10189,40,5,2,3,1,1,0
5981,9726,9904,60,6,1,5,1,1,0
5982,9727,8178,58,5,5,0,4,0,4
5983,9727,9789,42,3,2,1,0,0,0
5984,9733,9788,58,2,2,0,3,2,1
5985,9733,10269,42,4,3,1,0,0,0
5986,9735,10189,43,4,4,0,1,1,0
5987,9735,9823,57,2,1,1,1,0,1
5988,9737,9788,35,4,4,0,4,2,2
5989,9737,8358,65,9,8,1,2,0,2
5990,9738,8697,38,5,2,3,1,1,0
5991,9738,8226,62,5,3,2,0,0,0
5992,9739,9904,54,4,1,3,2,1,1
5993,9739,9905,46,9,2,7,0,0,0
5994,9741,8721,55,3,2,1,2,2,0
5995,9741,9810,45,6,1,5,0,0,0
5996,9743,8460,61,7,5,2,3,2,1
5997,9743,9790,39,3,1,2,2,1,1
5998,9744,9823,60,4,3,1,3,1,2
5999,9744,10189,40,3,0,3,1,0,1
6000,9745,8178,62,7,6,1,2,1,1
6001,9745,8177,38,1,1,0,1,0,1
6002,9747,9904,48,8,4,4,2,1,1
6003,9747,9905,52,4,0,4,1,0,1
6004,9748,9789,46,12,6,6,1,1,0
6005,9748,8406,54,3,0,3,4,0,4
6006,9750,9788,45,3,3,0,1,1,0
6007,9750,8358,55,5,2,3,1,0,1
6008,9751,10269,55,9,4,5,1,0,1
6009,9751,8722,45,1,1,0,0,0,0
6010,9752,8460,49,3,3,0,1,1,0
6011,9752,9790,51,3,1,2,0,0,0
6012,9755,9905,59,3,1,2,1,0,1
6013,9755,8177,41,3,1,2,1,0,1
6014,9756,9810,55,4,2,2,3,1,2
6015,9756,8406,45,5,3,2,0,0,0
6016,9757,8697,40,3,2,1,1,1,0
6017,9757,8178,60,5,3,2,3,0,3
6018,9759,10269,30,1,1,0,2,0,2
6019,9759,9823,70,2,0,2,0,0,0
6020,9761,8722,55,7,3,4,1,1,0
6021,9761,8460,45,1,0,1,2,1,1
6022,9762,9823,70,12,6,6,2,1,1
6023,9762,9790,30,3,1,2,2,0,2
6024,9763,9789,54,8,5,3,2,1,1
6025,9763,9905,46,2,1,1,2,1,1
6026,9764,8178,46,2,1,1,1,1,0
6027,9764,8721,54,4,1,3,0,0,0
6028,9765,9788,70,15,6,9,3,2,1
6029,9765,8722,30,6,4,2,1,0,1
6030,9768,8177,58,5,2,3,2,1,1
6031,9768,8358,42,2,1,1,1,0,1
6032,9769,8697,41,6,4,2,5,1,4
6033,9769,8406,59,3,0,3,0,0,0
6034,9770,9810,54,3,2,1,2,1,1
6035,9770,10189,46,7,3,4,1,1,0
6036,9772,8721,65,7,3,4,5,2,3
6037,9772,8177,35,1,0,1,1,0,1
6038,9774,8178,43,10,5,5,4,2,2
6039,9774,8406,57,8,2,6,1,1,0
6040,9775,8358,55,6,2,4,1,1,0
6041,9775,8226,45,4,2,2,1,0,1
6042,9776,9789,53,6,4,2,3,2,1
6043,9776,10269,47,0,0,0,1,1,0
6044,9777,9790,43,4,2,2,2,1,1
6045,9777,9788,57,3,2,1,0,0,0
6046,9779,8460,28,4,2,2,1,1,0
6047,9779,9823,72,6,2,4,0,0,0
6048,9780,9823,71,11,6,5,3,1,2
6049,9780,8722,29,5,1,4,0,0,0
6050,9783,8460,47,6,2,4,2,1,1
6051,9783,9788,53,11,5,6,0,0,0
6052,9784,8226,53,8,5,3,3,1,2
6053,9784,9905,47,9,1,8,3,1,2
6054,9785,9904,51,6,4,2,2,0,2
6055,9785,10269,49,1,0,1,1,0,1
6056,9787,8721,59,3,3,0,1,0,1
6057,9787,8697,41,5,2,3,1,0,1
6058,9789,8226,45,6,3,3,3,2,1
6059,9789,10189,55,4,3,1,1,1,0
6060,9790,9905,46,7,2,5,2,1,1
6061,9790,9788,54,2,0,2,0,0,0
6062,9792,9823,73,3,1,2,1,1,0
6063,9792,9904,27,0,0,0,3,1,2
6064,9793,8358,58,8,4,4,1,1,0
6065,9793,8697,42,4,0,4,0,0,0
6066,9795,9790,37,2,1,1,2,0,2
6067,9795,9789,63,4,3,1,1,0,1
6068,9796,8722,38,2,1,1,1,1,0
6069,9796,9810,62,4,0,4,0,0,0
6070,9797,8178,60,3,1,2,3,0,3
6071,9797,8460,40,6,3,3,2,0,2
6072,9798,9789,68,5,2,3,3,1,2
6073,9798,8722,32,4,2,2,0,0,0
6074,9799,10269,48,8,4,4,5,1,4
6075,9799,8178,52,4,0,4,0,0,0
6076,9800,8721,51,11,7,4,3,0,3
6077,9800,8358,49,7,4,3,0,0,0
6078,9801,9788,62,11,6,5,1,0,1
6079,9801,9904,38,3,1,2,1,0,1
6080,9802,9905,39,8,4,4,2,2,0
6081,9802,8406,61,4,1,3,4,2,2
6082,9803,8226,64,8,2,6,2,1,1
6083,9803,9790,36,6,1,5,2,2,0
6084,9804,10189,63,5,2,3,2,0,2
6085,9804,8177,37,8,1,7,2,0,2
6086,9805,9823,67,4,4,0,1,0,1
6087,9805,8697,33,4,1,3,1,0,1
6088,9807,9823,65,11,6,5,2,1,1
6089,9807,9788,35,2,0,2,2,0,2
6090,9808,10189,54,6,2,4,1,1,0
6091,9808,8178,46,9,5,4,2,0,2
6092,9809,9905,41,8,2,6,2,0,2
6093,9809,8721,59,2,0,2,0,0,0
6094,9810,9789,48,5,2,3,2,1,1
6095,9810,9904,52,7,3,4,2,1,1
6096,9811,8406,55,10,4,6,1,0,1
6097,9811,8358,45,9,6,3,0,0,0
6098,9812,9810,55,6,3,3,1,0,1
6099,9812,10269,45,2,0,2,0,0,0
6100,9814,8697,44,4,2,2,3,1,2
6101,9814,8722,56,4,1,3,1,1,0
6102,9815,8226,52,2,1,1,1,0,1
6103,9815,8460,48,7,0,7,2,0,2
6104,9818,10269,44,5,3,2,3,0,3
6105,9818,8721,56,10,4,6,0,0,0
6106,9819,8406,44,9,3,6,3,2,1
6107,9819,10189,56,6,1,5,0,0,0
6108,9821,8177,51,4,1,3,3,0,3
6109,9821,8460,49,3,0,3,0,0,0
6110,9822,8697,49,5,2,3,3,2,1
6111,9822,9905,51,8,2,6,3,1,2
6112,9823,9904,60,10,4,6,2,0,2
6113,9823,9810,40,6,2,4,0,0,0
6114,9824,8722,54,7,1,6,1,1,0
6115,9824,8358,46,5,2,3,2,1,1
6116,9825,9823,60,9,6,3,3,3,0
6117,9825,9810,40,1,1,0,3,0,3
6118,9826,10189,63,11,1,10,2,1,1
6119,9826,8358,37,6,2,4,0,0,0
6120,9829,9904,62,4,2,2,2,2,0
6121,9829,8177,38,5,2,3,2,0,2
6122,9831,8721,52,9,4,5,3,2,1
6123,9831,9790,48,0,0,0,0,0,0
6124,9834,9789,56,8,4,4,2,1,1
6125,9834,8460,44,1,1,0,1,1,0
6126,9835,8178,53,13,9,4,2,0,2
6127,9835,9904,47,2,1,1,0,0,0
6128,9837,10269,43,8,4,4,2,2,0
6129,9837,8406,57,4,2,2,2,0,2
6130,9838,8226,28,3,3,0,1,1,0
6131,9838,9823,72,13,3,10,1,0,1
6132,9839,8177,49,5,2,3,5,2,3
6133,9839,8722,51,3,1,2,1,0,1
6134,9840,8697,55,8,5,3,5,2,3
6135,9840,9790,45,4,2,2,3,2,1
6136,9841,9788,54,6,3,3,2,2,0
6137,9841,9810,46,9,5,4,2,0,2
6138,9843,9823,63,5,3,2,1,1,0
6139,9843,10269,37,1,0,1,2,1,1
6140,9844,8358,38,2,1,1,1,0,1
6141,9844,9789,62,3,2,1,0,0,0
6142,9845,8178,53,12,8,4,1,1,0
6143,9845,8697,47,2,0,2,0,0,0
6144,9846,10189,53,7,3,4,1,1,0
6145,9846,9788,47,9,2,7,0,0,0
6146,9848,9904,54,3,1,2,1,1,0
6147,9848,9790,46,3,1,2,2,1,1
6148,9849,9905,48,2,2,0,2,2,0
6149,9849,8177,52,9,5,4,1,1,0
6150,9851,8460,46,5,4,1,3,2,1
6151,9851,8722,54,1,0,1,1,0,1
6152,9854,9788,58,7,3,4,2,1,1
6153,9854,8721,42,4,3,1,3,2,1
6154,9855,10189,58,6,4,2,3,2,1
6155,9855,9905,42,2,1,1,1,0,1
6156,9857,10269,43,3,2,1,1,0,1
6157,9857,8358,57,8,2,6,0,0,0
6158,9858,9790,40,5,2,3,3,2,1
6159,9858,8406,60,1,0,1,2,1,1
6160,9862,9823,55,7,3,4,3,2,1
6161,9862,8178,45,9,4,5,1,1,0
6162,9863,9904,40,8,2,6,1,1,0
6163,9863,8721,60,9,4,5,0,0,0
6164,9864,9905,58,3,2,1,3,2,1
6165,9864,9790,42,7,2,5,0,0,0
6166,9866,8226,51,4,3,1,6,4,2
6167,9866,9789,49,5,1,4,2,1,1
6168,9867,9788,72,6,3,3,3,1,2
6169,9867,8177,28,4,1,3,4,2,2
6170,9869,8460,39,5,4,1,2,2,0
6171,9869,8358,61,9,5,4,1,1,0
6172,9870,8406,30,3,2,1,4,1,3
6173,9870,9823,70,6,3,3,1,0,1
6174,9871,9789,47,7,3,4,3,1,2
6175,9871,8177,53,2,0,2,0,0,0
6176,9872,8178,52,6,4,2,2,0,2
6177,9872,9788,48,4,3,1,0,0,0
6178,9873,8697,47,4,3,1,2,2,0
6179,9873,9904,53,2,0,2,0,0,0
6180,9874,8226,55,6,2,4,1,0,1
6181,9874,9810,45,3,1,2,0,0,0
6182,9876,9790,56,9,3,6,1,1,0
6183,9876,8358,44,9,3,6,3,1,2
6184,9877,10189,57,2,2,0,2,0,2
6185,9877,8722,43,3,1,2,0,0,0
6186,9878,8460,51,5,2,3,1,1,0
6187,9878,8721,49,3,0,3,3,2,1
6188,9879,8460,49,6,4,2,2,1,1
6189,9879,10189,51,6,2,4,0,0,0
6190,9880,8226,43,6,5,1,1,0,1
6191,9880,8178,57,2,2,0,2,0,2
6192,9881,9789,52,9,5,4,1,1,0
6193,9881,8721,48,7,3,4,2,1,1
6194,9882,8722,45,6,4,2,1,1,0
6195,9882,9905,55,7,1,6,1,0,1
6196,9883,9904,36,3,2,1,1,0,1
6197,9883,8406,64,3,2,1,0,0,0
6198,9885,8697,37,10,5,5,3,1,2
6199,9885,9788,63,5,4,1,1,1,0
6200,9887,10269,53,11,5,6,3,1,2
6201,9887,9790,47,3,2,1,0,0,0
6202,9889,9789,67,6,3,3,1,1,0
6203,9889,8697,33,3,1,2,1,0,1
6204,9890,9788,42,5,3,2,5,2,3
6205,9890,8406,58,3,0,3,1,1,0
6206,9892,9904,43,8,3,5,3,1,2
6207,9892,8358,57,4,2,2,0,0,0
6208,9893,8178,57,10,5,5,3,2,1
6209,9893,9810,43,2,1,1,0,0,0
6210,9894,9790,53,6,3,3,1,0,1
6211,9894,10189,47,6,2,4,0,0,0
6212,9895,8722,38,4,4,0,3,1,2
6213,9895,8721,62,3,1,2,0,0,0
6214,9896,10269,48,5,3,2,2,0,2
6215,9896,8460,52,5,1,4,0,0,0
6216,9897,9810,43,6,2,4,3,2,1
6217,9897,10189,57,2,2,0,3,1,2
6218,9898,8178,37,5,3,2,2,1,1
6219,9898,8721,63,7,3,4,1,0,1
6220,9900,8406,52,5,3,2,1,1,0
6221,9900,8697,48,5,2,3,1,0,1
6222,9901,8358,52,9,4,5,2,2,0
6223,9901,8177,48,4,2,2,0,0,0
6224,9902,10269,64,4,2,2,5,1,4
6225,9902,8226,36,4,0,4,1,1,0
6226,9904,9788,62,4,2,2,1,1,0
6227,9904,8722,38,7,3,4,0,0,0
6228,9905,8460,39,8,3,5,3,1,2
6229,9905,9904,61,8,3,5,0,0,0
6230,9908,8406,57,5,1,4,1,1,0
6231,9908,8178,43,3,0,3,1,0,1
6232,9909,9788,49,14,3,11,3,2,1
6233,9909,9790,51,5,2,3,1,0,1
6234,9910,8226,60,6,2,4,2,0,2
6235,9910,8358,40,2,1,1,0,0,0
6236,9912,8721,69,7,4,3,1,0,1
6237,9912,8177,31,2,1,1,0,0,0
6238,9916,8697,43,5,1,4,2,1,1
6239,9916,8721,57,9,4,5,0,0,0
6240,9918,8177,49,4,2,2,2,0,2
6241,9918,8406,51,2,1,1,0,0,0
6242,9919,8358,57,5,3,2,1,0,1
6243,9919,8178,43,7,1,6,1,0,1
6244,9921,9790,68,9,4,5,1,0,1
6245,9921,9810,32,3,1,2,0,0,0
6246,9922,9823,72,12,6,6,2,2,0
6247,9922,8722,28,4,2,2,1,0,1
6248,9924,9823,67,8,3,5,2,0,2
6249,9924,9904,33,3,1,2,0,0,0
6250,9926,8460,41,3,1,2,1,0,1
6251,9926,8178,59,13,2,11,0,0,0
6252,9927,8406,46,2,2,0,1,1,0
6253,9927,8721,54,5,1,4,0,0,0
6254,9928,9788,64,11,3,8,3,2,1
6255,9928,9905,36,3,2,1,2,0,2
6256,9929,8226,43,12,7,5,1,1,0
6257,9929,10189,57,4,4,0,0,0,0
6258,9930,10269,57,4,2,2,3,1,2
6259,9930,8177,43,7,7,0,1,0,1
6260,9933,9823,74,7,3,4,1,0,1
6261,9933,8697,26,0,0,0,0,0,0
6262,9934,8177,54,9,4,5,2,1,1
6263,9934,10189,46,2,0,2,2,2,0
6264,9935,9905,45,6,5,1,2,1,1
6265,9935,8406,55,8,2,6,3,0,3
6266,9937,8358,48,9,5,4,1,0,1
6267,9937,8721,52,9,4,5,0,0,0
6268,9938,10269,52,4,2,2,2,1,1
6269,9938,8178,48,4,1,3,1,1,0
6270,9942,9789,53,5,2,3,1,0,1
6271,9942,9904,47,2,0,2,0,0,0
6272,9943,8178,53,13,7,6,2,0,2
6273,9943,10189,47,3,2,1,1,0,1
6274,9944,9905,45,8,4,4,2,1,1
6275,9944,8721,55,7,3,4,5,0,5
6276,9945,9823,67,13,5,8,4,3,1
6277,9945,9788,33,6,1,5,2,1,1
6278,9946,8406,43,7,2,5,3,2,1
6279,9946,8358,57,6,4,2,3,0,3
6280,9947,8460,45,2,2,0,3,2,1
6281,9947,8226,55,7,3,4,0,0,0
6282,9948,9790,57,4,1,3,4,1,3
6283,9948,8177,43,4,3,1,2,0,2
6284,9950,10269,47,7,5,2,2,1,1
6285,9950,9810,53,12,4,8,1,1,0
6286,9952,9788,41,2,1,1,1,0,1
6287,9952,9789,59,5,4,1,0,0,0
6288,9953,8178,56,12,6,6,1,0,1
6289,9953,8226,44,2,1,1,0,0,0
6290,9954,9810,38,7,1,6,2,1,1
6291,9954,8721,62,2,0,2,2,0,2
6292,9956,8406,47,9,4,5,1,1,0
6293,9956,8177,53,4,2,2,0,0,0
6294,9958,9905,57,7,5,2,1,1,0
6295,9958,8234,43,5,3,2,1,1,0
6296,9959,9904,62,4,3,1,2,2,0
6297,9959,8262,38,4,2,2,0,0,0
6298,9961,9789,58,8,5,3,1,1,0
6299,9961,8406,42,2,2,0,2,0,2
6300,9962,8178,59,4,2,2,2,1,1
6301,9962,10269,41,5,1,4,0,0,0
6302,9963,9788,58,8,4,4,3,2,1
6303,9963,10189,42,8,1,7,4,4,0
6304,9966,9905,58,8,3,5,1,0,1
6305,9966,8697,42,5,1,4,0,0,0
6306,9967,8234,52,6,2,4,1,1,0
6307,9967,8177,48,0,0,0,1,1,0
6308,9968,8721,68,7,3,4,1,1,0
6309,9968,8262,32,3,0,3,4,3,1
6310,9970,8178,49,8,4,4,2,1,1
6311,9970,8721,51,8,3,5,1,0,1
6312,9971,9790,55,7,2,5,1,0,1
6313,9971,9904,45,1,1,0,0,0,0
6314,9972,8262,42,6,2,4,4,2,2
6315,9972,10269,58,5,1,4,0,0,0
6316,9975,9823,68,2,1,1,1,1,0
6317,9975,9810,32,1,0,1,2,0,2
6318,9976,8226,46,7,4,3,1,0,1
6319,9976,8722,54,6,1,5,0,0,0
6320,9979,9789,63,6,1,5,2,1,1
6321,9979,10189,37,3,0,3,1,0,1
6322,9980,8722,48,8,3,5,1,0,1
6323,9980,8178,52,7,5,2,0,0,0
6324,9981,8234,44,4,1,3,2,0,2
6325,9981,9788,56,9,4,5,1,0,1
6326,9982,8697,42,7,2,5,2,1,1
6327,9982,8406,58,11,6,5,0,0,0
6328,9984,9810,49,12,6,6,2,1,1
6329,9984,8226,51,4,3,1,0,0,0
6330,9985,9905,39,4,3,1,2,1,1
6331,9985,8721,61,1,1,0,2,0,2
6332,9991,10269,57,9,5,4,2,1,1
6333,9991,8406,43,7,4,3,0,0,0
6334,9992,8178,58,8,5,3,1,1,0
6335,9992,9810,42,4,1,3,0,0,0
6336,9993,8722,49,3,0,3,3,2,1
6337,9993,9905,51,1,0,1,3,0,3
6338,9994,8226,51,1,1,0,1,0,1
6339,9994,8177,49,0,0,0,1,0,1
6340,9995,8234,56,5,2,3,2,0,2
6341,9995,8262,44,3,2,1,0,0,0
6342,9999,8721,59,9,5,4,1,0,1
6343,9999,8406,41,7,4,3,0,0,0
6344,10002,9788,64,10,7,3,2,1,1
6345,10002,8226,36,8,2,6,0,0,0
6346,10003,9810,47,6,3,3,3,1,2
6347,10003,9905,53,7,3,4,0,0,0
6348,10004,8722,61,6,3,3,3,2,1
6349,10004,8262,39,1,0,1,0,0,0
6350,10005,10189,56,12,7,5,2,1,1
6351,10005,9904,44,2,1,1,0,0,0
6352,10008,9790,57,8,4,4,1,1,0
6353,10008,9905,43,4,1,3,0,0,0
6354,10010,9810,62,8,3,5,1,1,0
6355,10010,8262,38,5,3,2,1,0,1
6356,10011,8406,49,9,6,3,4,1,3
6357,10011,8722,51,10,4,6,1,0,1
6358,10012,8177,58,5,4,1,3,1,2
6359,10012,8178,42,3,1,2,0,0,0
6360,10013,8226,48,2,1,1,4,2,2
6361,10013,8234,52,2,2,0,1,1,0
6362,10015,9789,76,10,6,4,2,1,1
6363,10015,9810,24,1,1,0,1,1,0
6364,10017,9790,41,3,3,0,4,2,2
6365,10017,8721,59,11,3,8,2,1,1
6366,10018,8406,43,10,6,4,2,0,2
6367,10018,10189,57,6,5,1,0,0,0
6368,10020,8226,43,5,2,3,4,2,2
6369,10020,9904,57,5,1,4,2,1,1
6370,10021,9905,57,5,3,2,3,2,1
6371,10021,10269,43,7,4,3,2,1,1
6372,10022,8262,38,3,1,2,3,2,1
6373,10022,8177,62,1,0,1,2,1,1
6374,10023,10189,49,8,3,5,6,3,3
6375,10023,8226,51,6,2,4,1,0,1
6376,10024,8262,43,7,2,5,1,1,0
6377,10024,9788,57,6,3,3,0,0,0
6378,10025,8406,46,6,2,4,3,2,1
6379,10025,9790,54,7,3,4,0,0,0
6380,10026,10269,25,3,2,1,4,1,3
6381,10026,8721,75,10,4,6,1,0,1
6382,10027,9810,51,6,2,4,1,0,1
6383,10027,8697,49,6,3,3,0,0,0
6384,10030,8177,58,2,1,1,2,1,1
6385,10030,9905,42,1,0,1,2,0,2
6386,10031,8234,49,5,2,3,2,0,2
6387,10031,8178,51,3,0,3,0,0,0
6388,10034,9790,29,4,1,3,2,1,1
6389,10034,9823,71,3,0,3,0,0,0
6390,10035,8721,55,12,4,8,3,1,2
6391,10035,9810,45,5,1,4,1,1,0
6392,10036,10269,48,8,4,4,2,1,1
6393,10036,8722,52,5,2,3,1,0,1
6394,10038,8406,39,7,5,2,1,0,1
6395,10038,8177,61,4,3,1,3,0,3
6396,10039,8226,39,1,1,0,1,0,1
6397,10039,8178,61,8,2,6,1,0,1
6398,10040,8234,41,4,4,0,2,1,1
6399,10040,9905,59,4,3,1,3,0,3
6400,10043,8178,57,5,3,2,1,1,0
6401,10043,9904,43,3,1,2,0,0,0
6402,10044,8721,63,6,5,1,4,3,1
6403,10044,8722,37,3,0,3,3,1,2
6404,10045,10269,47,12,3,9,3,1,2
6405,10045,9790,53,5,0,5,3,2,1
6406,10048,9788,59,7,4,3,2,1,1
6407,10048,9905,41,1,1,0,1,0,1
6408,10049,10189,62,6,0,6,3,1,2
6409,10049,8262,38,2,0,2,2,0,2
6410,10050,8262,29,3,3,0,2,1,1
6411,10050,10189,71,7,4,3,2,1,1
6412,10051,9788,65,7,4,3,1,0,1
6413,10051,9905,35,4,2,2,1,0,1
6414,10053,8406,47,5,1,4,6,2,4
6415,10053,9810,53,3,2,1,3,2,1
6416,10056,8177,52,5,2,3,2,0,2
6417,10056,8697,48,3,0,3,0,0,0
6418,10058,8234,39,3,1,2,3,2,1
6419,10058,9789,61,4,1,3,1,0,1
6420,10059,10189,40,2,2,0,2,1,1
6421,10059,8721,60,6,3,3,3,1,2
6422,10062,8722,44,8,2,6,1,1,0
6423,10062,9790,56,4,1,3,1,0,1
6424,10063,9810,58,8,6,2,2,2,0
6425,10063,10269,42,6,5,1,0,0,0
6426,10064,9905,51,3,2,1,1,1,0
6427,10064,9904,49,3,0,3,0,0,0
6428,10065,9789,63,3,3,0,1,1,0
6429,10065,8177,37,6,3,3,0,0,0
6430,10066,8226,65,4,2,2,2,1,1
6431,10066,8262,35,2,0,2,1,0,1
6432,10069,8721,44,4,4,0,4,1,3
6433,10069,8234,56,4,1,3,0,0,0
6434,10070,9788,56,5,1,4,1,0,1
6435,10070,9790,44,6,4,2,1,0,1
6436,10072,9823,66,10,5,5,2,1,1
6437,10072,8406,34,1,0,1,1,0,1
6438,10075,9905,45,5,1,4,5,4,1
6439,10075,10189,55,4,1,3,3,0,3
6440,10076,8262,42,6,3,3,5,2,3
6441,10076,8178,58,5,2,3,1,0,1
6442,10077,9823,73,20,11,9,3,1,2
6443,10077,8262,27,4,2,2,1,0,1
6444,10078,10269,54,11,6,5,2,1,1
6445,10078,10189,46,6,3,3,0,0,0
6446,10079,9789,51,3,1,2,4,3,1
6447,10079,8178,49,8,4,4,3,1,2
6448,10081,9810,49,2,1,1,3,2,1
6449,10081,9790,51,3,2,1,0,0,0
6450,10082,9904,49,10,4,6,3,2,1
6451,10082,8406,51,6,3,3,1,1,0
6452,10083,8177,48,5,2,3,1,0,1
6453,10083,8721,52,7,0,7,0,0,0
6454,10085,8234,46,3,2,1,4,3,1
6455,10085,8697,54,2,2,0,3,2,1
6456,10086,8226,30,5,2,3,2,1,1
6457,10086,9789,70,11,2,9,1,0,1
6458,10087,8721,35,8,5,3,3,1,2
6459,10087,9823,65,4,1,3,0,0,0
6460,10089,9904,40,8,4,4,2,0,2
6461,10089,10269,60,10,4,6,0,0,0
6462,10090,9788,52,5,4,1,3,3,0
6463,10090,8406,48,11,6,5,0,0,0
6464,10091,8262,40,2,1,1,1,0,1
6465,10091,8697,60,10,0,10,0,0,0
6466,10093,8177,52,7,5,2,4,2,2
6467,10093,8722,48,7,3,4,3,0,3
6468,10094,9905,40,5,4,1,1,1,0
6469,10094,8178,60,3,2,1,0,0,0
6470,10095,9823,76,9,4,5,2,0,2
6471,10095,9905,24,1,1,0,0,0,0
6472,10099,9904,39,4,2,2,1,1,0
6473,10099,8721,61,9,4,5,0,0,0
6474,10101,8226,52,6,1,5,2,1,1
6475,10101,8406,48,2,2,0,1,0,1
6476,10107,10269,38,10,8,2,2,0,2
6477,10107,8226,62,7,4,3,0,0,0
6478,10109,9904,52,6,4,2,2,0,2
6479,10109,8697,48,4,3,1,2,0,2
6480,10110,8234,36,5,4,1,1,1,0
6481,10110,9810,64,4,3,1,0,0,0
6482,10111,10189,53,5,4,1,6,3,3
6483,10111,8722,47,8,4,4,2,1,1
6484,10114,9789,62,15,3,12,5,3,2
6485,10114,9905,38,1,1,0,1,0,1
6486,10115,9790,54,7,2,5,1,1,0
6487,10115,8178,46,5,2,3,2,1,1
6488,10116,9788,60,6,3,3,3,2,1
6489,10116,9810,40,0,0,0,4,2,2
6490,10119,8721,61,11,5,6,3,1,2
6491,10119,8226,39,2,1,1,0,0,0
6492,10120,10269,53,5,4,1,2,1,1
6493,10120,8234,47,6,2,4,1,0,1
6494,10122,10189,37,3,3,0,1,0,1
6495,10122,9788,63,13,7,6,0,0,0
6496,10123,8262,30,4,2,2,2,1,1
6497,10123,8721,70,5,2,3,0,0,0
6498,10124,8226,40,6,4,2,2,2,0
6499,10124,9790,60,11,2,9,1,0,1
6500,10125,8178,46,9,4,5,2,0,2
6501,10125,10269,54,5,2,3,2,0,2
6502,10126,8406,26,4,3,1,1,1,0
6503,10126,9789,74,5,2,3,0,0,0
6504,10129,9823,77,3,1,2,4,2,2
6505,10129,8722,23,2,0,2,0,0,0
6506,10130,8234,45,3,1,2,2,1,1
6507,10130,8177,55,1,1,0,1,0,1
6508,10131,9823,69,11,4,7,1,0,1
6509,10131,9810,31,0,0,0,2,0,2
6510,10132,9789,66,9,7,2,1,0,1
6511,10132,8697,34,3,1,2,1,0,1
6512,10133,8721,53,8,3,5,1,1,0
6513,10133,8178,47,3,2,1,1,0,1
6514,10134,8177,48,2,1,1,2,1,1
6515,10134,9788,52,5,2,3,1,1,0
6516,10135,9904,54,8,3,5,1,0,1
6517,10135,9790,46,3,2,1,0,0,0
6518,10136,8226,57,7,1,6,2,2,0
6519,10136,8722,43,0,0,0,0,0,0
6520,10137,8406,51,6,2,4,2,1,1
6521,10137,9905,49,5,1,4,3,1,2
6522,10139,10269,62,2,1,1,4,1,3
6523,10139,8262,38,5,1,4,1,0,1
6524,10140,9789,48,6,2,4,4,3,1
6525,10140,10189,52,4,0,4,2,1,1
6526,10141,9905,49,6,2,4,1,1,0
6527,10141,8721,51,6,5,1,0,0,0
6528,10143,9823,73,5,2,3,3,1,2
6529,10143,10269,27,2,2,0,1,0,1
6530,10144,8697,55,10,6,4,2,1,1
6531,10144,8406,45,2,0,2,1,0,1
6532,10145,8226,48,4,3,1,4,2,2
6533,10145,9810,52,4,3,1,1,0,1
6534,10147,9904,36,3,1,2,1,1,0
6535,10147,8177,64,9,4,5,1,0,1
6536,10148,8234,52,9,5,4,2,1,1
6537,10148,9788,48,3,1,2,3,3,0
6538,10153,8234,34,7,5,2,2,0,2
6539,10153,8406,66,4,1,3,2,0,2
6540,10154,9788,58,5,2,3,1,0,1
6541,10154,8697,42,7,4,3,0,0,0
6542,10155,9790,52,8,4,4,1,0,1
6543,10155,8722,48,1,0,1,3,0,3
6544,10158,10189,37,8,3,5,1,0,1
6545,10158,9823,63,6,2,4,3,0,3
6546,10159,9790,29,2,2,0,3,3,0
6547,10159,9789,71,5,2,3,3,1,2
6548,10160,9810,40,9,4,5,1,1,0
6549,10160,8178,60,6,3,3,1,1,0
6550,10162,8697,44,6,5,1,4,2,2
6551,10162,8721,56,1,0,1,2,1,1
6552,10163,9788,54,3,2,1,1,1,0
6553,10163,9904,46,5,1,4,4,1,3
6554,10164,8177,46,4,1,3,2,0,2
6555,10164,8226,54,9,6,3,0,0,0
6556,10167,10189,54,7,3,4,1,1,0
6557,10167,8178,46,5,2,3,2,0,2
6558,10169,8721,66,9,2,7,3,2,1
6559,10169,8406,34,3,0,3,0,0,0
6560,10170,9790,46,6,4,2,2,0,2
6561,10170,8697,54,9,2,7,0,0,0
6562,10171,9789,55,6,4,2,3,2,1
6563,10171,10269,45,4,2,2,1,1,0
6564,10172,9810,53,4,3,1,3,2,1
6565,10172,9905,47,2,0,2,1,1,0
6566,10174,8177,32,5,4,1,2,1,1
6567,10174,9823,68,4,3,1,1,0,1
6568,10175,9904,67,2,0,2,3,1,2
6569,10175,8234,33,1,0,1,0,0,0
6570,10176,9823,59,4,3,1,2,2,0
6571,10176,9788,41,2,1,1,3,3,0
6572,10177,8721,40,3,2,1,2,2,0
6573,10177,9789,60,8,0,8,1,0,1
6574,10180,8697,47,7,1,6,1,1,0
6575,10180,10269,53,4,1,3,0,0,0
6576,10184,8262,35,4,1,3,2,2,0
6577,10184,9810,65,2,1,1,2,0,2
6578,10186,9788,58,6,3,3,2,1,1
6579,10186,8178,42,8,1,7,2,0,2
6580,10187,9790,45,1,1,0,2,1,1
6581,10187,8721,55,5,1,4,1,0,1
6582,10189,9810,22,2,1,1,4,1,3
6583,10189,9789,78,12,6,6,1,0,1
6584,10191,9904,47,8,5,3,2,1,1
6585,10191,8226,53,8,5,3,0,0,0
6586,10192,8177,68,8,4,4,1,1,0
6587,10192,8262,32,1,0,1,2,0,2
6588,10193,8234,48,6,5,1,2,1,1
6589,10193,9823,52,4,2,2,2,0,2
6590,10194,9823,61,8,4,4,2,1,1
6591,10194,9904,39,6,3,3,2,0,2
6592,10196,8234,55,4,2,2,1,1,0
6593,10196,8178,45,4,0,4,3,2,1
6594,10197,8721,53,6,4,2,1,1,0
6595,10197,10269,47,5,2,3,2,2,0
6596,10199,9810,35,2,2,0,3,2,1
6597,10199,8697,65,5,2,3,1,0,1
6598,10200,8226,46,8,3,5,1,1,0
6599,10200,10189,54,6,2,4,2,0,2
6600,10204,10189,57,10,6,4,1,0,1
6601,10204,9905,43,7,2,5,0,0,0
6602,10205,8262,24,1,1,0,2,1,1
6603,10205,8178,76,6,2,4,0,0,0
6604,10206,9790,44,2,1,1,1,1,0
6605,10206,9788,56,7,6,1,1,0,1
6606,10207,9810,49,8,4,4,1,0,1
6607,10207,8722,51,7,2,5,2,0,2
6608,10208,9789,72,6,3,3,4,3,1
6609,10208,9904,28,3,1,2,3,1,2
6610,10209,8177,53,5,2,3,1,0,1
6611,10209,10269,47,5,4,1,0,0,0
6612,10210,8697,42,6,2,4,2,1,1
6613,10210,8226,58,5,1,4,3,2,1
6614,10211,8721,61,8,2,6,1,0,1
6615,10211,8234,39,4,3,1,1,0,1
6616,10212,9789,56,11,4,7,1,1,0
6617,10212,8178,44,4,1,3,1,0,1
6618,10213,8721,54,3,1,2,1,0,1
6619,10213,8177,46,4,4,0,0,0,0
6620,10214,9810,49,5,1,4,3,2,1
6621,10214,9790,51,2,2,0,0,0,0
6622,10216,8406,52,11,3,8,1,0,1
6623,10216,9904,48,7,4,3,0,0,0
6624,10217,8234,48,4,2,2,2,1,1
6625,10217,8697,52,5,2,3,1,0,1
6626,10219,9905,58,5,2,3,3,2,1
6627,10219,8226,42,6,3,3,1,1,0
6628,10222,10189,52,5,4,1,1,1,0
6629,10222,9810,48,9,2,7,2,0,2
6630,10225,10269,42,11,3,8,2,2,0
6631,10225,9904,58,2,1,1,0,0,0
6632,10226,8177,52,9,4,5,3,3,0
6633,10226,8722,48,6,2,4,1,0,1
6634,10228,8234,48,5,3,2,2,1,1
6635,10228,9790,52,3,1,2,0,0,0
6636,10229,8262,42,3,1,2,3,3,0
6637,10229,8697,58,2,1,1,1,1,0
6638,10231,8721,68,12,6,6,1,0,1
6639,10231,9904,32,6,4,2,1,0,1
6640,10232,10189,51,5,4,1,2,1,1
6641,10232,9790,49,5,1,4,1,1,0
6642,10234,8406,66,17,10,7,1,1,0
6643,10234,8226,34,2,2,0,2,1,1
6644,10235,8697,40,3,1,2,5,3,2
6645,10235,8178,60,5,1,4,0,0,0
6646,10236,8177,56,8,4,4,1,1,0
6647,10236,9810,44,3,2,1,1,1,0
6648,10239,9789,44,5,2,3,1,1,0
6649,10239,9823,56,6,2,4,2,0,2
6650,10240,10189,62,10,6,4,3,1,2
6651,10240,8722,38,3,1,2,0,0,0
6652,10241,8406,39,1,1,0,2,2,0
6653,10241,8178,61,12,6,6,1,0,1
6654,10243,9904,44,8,6,2,1,1,0
6655,10243,8697,56,11,5,6,0,0,0
6656,10244,9790,54,6,3,3,1,1,0
6657,10244,8177,46,5,2,3,0,0,0
6658,10246,8234,40,5,1,4,2,0,2
6659,10246,9810,60,4,0,4,0,0,0
6660,10247,9905,59,8,4,4,1,1,0
6661,10247,8262,41,3,1,2,3,2,1
6662,10248,10189,56,9,1,8,1,0,1
6663,10248,8177,44,5,3,2,0,0,0
6664,10250,9790,49,5,2,3,3,1,2
6665,10250,8178,51,5,4,1,1,0,1
6666,10251,10269,49,5,5,0,1,0,1
6667,10251,8234,51,5,2,3,1,0,1
6668,10252,8406,68,10,3,7,1,0,1
6669,10252,8262,32,4,2,2,0,0,0
6670,10254,9810,49,2,2,0,3,1,2
6671,10254,9788,51,1,1,0,2,0,2
6672,10255,8722,64,10,4,6,1,1,0
6673,10255,9904,36,4,3,1,1,1,0
6674,10256,9905,53,7,2,5,1,1,0
6675,10256,9789,47,6,2,4,0,0,0
6676,10261,9885,48,7,5,2,2,1,1
6677,10261,8535,52,5,1,4,1,0,1
6678,10266,8600,43,4,3,1,4,2,2
6679,10266,8540,57,4,1,3,1,0,1
6680,10272,8564,64,7,3,4,2,2,0
6681,10272,9875,36,4,2,2,5,3,2
6682,10273,8543,58,9,4,5,2,1,1
6683,10273,8530,42,1,1,0,1,0,1
6684,10274,9885,49,9,3,6,1,1,0
6685,10274,8686,51,0,0,0,1,0,1
6686,10277,9857,39,2,1,1,3,1,2
6687,10277,8686,61,5,4,1,1,0,1
6688,10280,9888,29,3,1,2,1,1,0
6689,10280,8564,71,10,7,3,1,1,0
6690,10282,8600,46,4,2,2,2,1,1
6691,10282,8636,54,5,2,3,0,0,0
6692,10284,8524,49,3,1,2,3,2,1
6693,10284,8535,51,8,2,6,1,1,0
6694,10287,8540,46,6,4,2,3,3,0
6695,10287,8636,54,8,1,7,0,0,0
6696,10288,8686,48,4,2,2,2,1,1
6697,10288,8543,52,7,2,5,1,1,0
6698,10292,8564,57,8,1,7,1,1,0
6699,10292,8533,43,6,2,4,0,0,0
6700,10294,9885,47,4,0,4,1,1,0
6701,10294,10233,53,0,0,0,2,0,2
6702,10295,8529,36,6,2,4,3,3,0
6703,10295,8535,64,6,2,4,2,2,0
6704,10301,8543,58,12,6,6,2,1,1
6705,10301,10233,42,5,2,3,2,0,2
6706,10302,8636,47,10,7,3,3,2,1
6707,10302,9885,53,5,3,2,0,0,0
6708,10306,8564,56,7,4,3,1,1,0
6709,10306,9804,44,7,0,7,0,0,0
6710,10311,8564,53,8,2,6,1,1,0
6711,10311,8540,47,8,5,3,1,0,1
6712,10317,8686,65,11,4,7,2,2,0
6713,10317,8533,35,0,0,0,1,0,1
6714,10323,8636,53,2,2,0,2,1,1
6715,10323,8543,47,12,3,9,3,0,3
6716,10324,8564,58,12,9,3,2,1,1
6717,10324,8530,42,4,2,2,1,1,0
6718,10325,9885,65,4,3,1,3,1,2
6719,10325,9888,35,3,0,3,0,0,0
6720,10329,9857,59,7,7,0,1,0,1
6721,10329,9804,41,7,6,1,0,0,0
6722,10330,9885,52,4,3,1,1,1,0
6723,10330,8564,48,3,2,1,1,0,1
6724,10332,8543,63,10,6,4,4,1,3
6725,10332,8600,37,6,2,4,2,2,0
6726,10333,9888,42,7,4,3,3,2,1
6727,10333,9875,58,4,2,2,0,0,0
6728,10336,8636,60,8,4,4,2,1,1
6729,10336,8533,40,4,1,3,1,0,1
6730,10339,8551,47,4,2,2,5,1,4
6731,10339,8636,53,7,4,3,3,1,2
6732,10340,8543,51,5,3,2,2,1,1
6733,10340,8540,49,3,3,0,2,1,1
6734,10341,9875,58,5,3,2,1,1,0
6735,10341,9804,42,6,3,3,0,0,0
6736,10349,8686,48,13,5,8,3,0,3
6737,10349,8564,52,6,2,4,1,0,1
6738,10354,8551,46,6,3,3,3,1,2
6739,10354,9885,54,3,1,2,3,1,2
6740,10362,8543,55,6,5,1,3,1,2
6741,10362,9885,45,5,0,5,1,1,0
6742,10365,8600,63,3,1,2,2,1,1
6743,10365,8529,37,2,1,1,1,0,1
6744,10371,9875,39,6,2,4,1,0,1
6745,10371,8535,61,8,0,8,1,0,1
6746,10374,9885,58,11,7,4,2,1,1
6747,10374,8600,42,4,2,2,2,0,2
6748,10379,8543,61,6,2,4,2,0,2
6749,10379,8529,39,1,0,1,0,0,0
6750,10380,8533,58,3,1,2,2,2,0
6751,10380,8690,42,6,5,1,1,0,1
6752,10381,8535,55,7,3,4,1,0,1
6753,10381,9885,45,6,2,4,2,0,2
6754,10382,9857,39,10,3,7,2,2,0
6755,10382,8564,61,9,4,5,2,2,0
6756,10392,8600,46,8,3,5,3,2,1
6757,10392,9885,54,3,0,3,3,0,3
6758,10400,10233,58,5,4,1,2,0,2
6759,10400,8540,42,1,0,1,0,0,0
6760,10402,8564,64,2,1,1,3,1,2
6761,10402,8543,36,8,4,4,0,0,0
6762,10411,8564,73,10,3,7,2,0,2
6763,10411,8690,27,2,2,0,0,0,0
6764,10412,8535,58,9,3,6,3,0,3
6765,10412,8543,42,8,6,2,0,0,0
6766,10414,9885,45,9,1,8,1,1,0
6767,10414,8530,55,8,5,3,0,0,0
6768,10428,8686,56,5,2,3,2,2,0
6769,10428,8551,44,4,0,4,1,1,0
6770,10431,8636,54,7,4,3,3,1,2
6771,10431,9857,46,5,2,3,1,0,1
6772,10433,8540,62,9,4,5,1,1,0
6773,10433,9885,38,8,6,2,0,0,0
6774,10435,8564,56,3,2,1,1,1,0
6775,10435,8529,44,5,5,0,0,0,0
6776,10440,8564,67,7,2,5,2,2,0
6777,10440,9882,33,3,1,2,0,0,0
6778,10441,8543,48,4,2,2,2,1,1
6779,10441,9857,52,3,2,1,2,0,2
6780,10442,9885,49,5,5,0,2,2,0
6781,10442,9875,51,1,1,0,2,0,2
6782,10444,8686,49,12,7,5,2,0,2
6783,10444,8636,51,7,3,4,0,0,0
6784,10448,8600,49,3,1,2,2,0,2
6785,10448,8686,51,2,0,2,0,0,0
6786,10451,8535,46,6,4,2,7,5,2
6787,10451,8540,54,5,2,3,0,0,0
6788,10453,9885,43,9,4,5,2,1,1
6789,10453,9804,57,8,5,3,1,0,1
6790,10454,10233,57,7,4,3,2,2,0
6791,10454,8636,43,3,1,2,0,0,0
6792,10456,8564,49,6,5,1,3,1,2
6793,10456,8524,51,10,7,3,2,0,2
6794,10465,8533,43,8,2,6,1,0,1
6795,10465,8543,57,8,5,3,0,0,0
6796,10466,8636,54,6,2,4,1,0,1
6797,10466,8535,46,10,5,5,0,0,0
6798,10469,9875,42,5,3,2,2,2,0
6799,10469,8564,58,8,4,4,2,1,1
6800,10470,8543,57,5,1,4,2,0,2
6801,10470,8530,43,2,0,2,0,0,0
6802,10476,8686,48,9,3,6,1,1,0
6803,10476,9885,52,5,2,3,1,0,1
6804,10477,8600,55,15,7,8,1,1,0
6805,10477,9875,45,2,0,2,2,0,2
6806,10480,8690,46,3,1,2,1,1,0
6807,10480,8686,54,7,1,6,3,2,1
6808,10482,8564,56,4,2,2,1,0,1
6809,10482,8543,44,9,4,5,2,0,2
6810,10487,8686,49,4,3,1,1,1,0
6811,10487,9857,51,6,1,5,2,0,2
6812,10490,9885,60,4,1,3,2,0,2
6813,10490,8533,40,1,0,1,1,0,1
6814,10495,9888,30,4,2,2,2,2,0
6815,10495,8564,70,10,3,7,2,1,1
6816,10497,8686,53,10,6,4,1,1,0
6817,10497,8543,47,6,1,5,0,0,0
6818,10501,10233,56,7,2,5,1,0,1
6819,10501,9885,44,4,1,3,0,0,0
6820,10510,8686,57,7,4,3,2,1,1
6821,10510,9888,43,9,4,5,5,0,5
6822,10513,8564,62,4,4,0,2,0,2
6823,10513,9804,38,3,2,1,0,0,0
6824,10518,8524,46,5,2,3,3,1,2
6825,10518,8543,54,6,1,5,0,0,0
6826,10521,8540,45,4,3,1,3,2,1
6827,10521,8564,55,5,2,3,1,1,0
6828,10522,8535,48,5,2,3,2,0,2
6829,10522,8686,52,5,2,3,1,0,1
6830,10523,8636,45,5,2,3,2,1,1
6831,10523,9875,55,6,1,5,0,0,0
6832,10527,9888,33,4,1,3,3,1,2
6833,10527,9885,67,4,1,3,2,0,2
6834,10531,8543,44,6,4,2,2,0,2
6835,10531,8636,56,3,0,3,0,0,0
6836,10532,8564,74,9,6,3,1,1,0
6837,10532,8530,26,5,3,2,2,1,1
6838,10534,10233,48,3,2,1,1,1,0
6839,10534,9882,52,2,1,1,2,2,0
6840,10536,9857,60,8,3,5,1,1,0
6841,10536,8690,40,2,0,2,0,0,0
6842,10539,8600,48,7,2,5,3,2,1
6843,10539,8543,52,3,1,2,1,0,1
6844,10540,9885,38,7,2,5,3,0,3
6845,10540,8564,62,6,2,4,3,0,3
6846,10544,8686,57,10,4,6,2,2,0
6847,10544,8529,43,3,1,2,4,1,3
6848,10547,8535,49,7,4,3,1,0,1
6849,10547,9882,51,1,0,1,0,0,0
6850,10550,8686,58,4,2,2,2,2,0
6851,10550,8530,42,4,1,3,2,0,2
6852,10553,10233,61,7,5,2,1,1,0
6853,10553,8533,39,5,4,1,2,0,2
6854,10556,8600,43,11,5,6,1,1,0
6855,10556,8564,57,2,1,1,1,1,0
6856,10559,8686,43,5,4,1,1,1,0
6857,10559,8564,57,6,3,3,2,0,2
6858,10564,8529,49,10,6,4,2,1,1
6859,10564,8636,51,5,2,3,2,1,1
6860,10566,9888,44,10,6,4,1,0,1
6861,10566,8535,56,8,4,4,0,0,0
6862,10568,8636,51,6,2,4,3,2,1
6863,10568,8524,49,3,1,2,3,2,1
6864,10571,8535,42,5,2,3,1,0,1
6865,10571,8564,58,3,1,2,0,0,0
6866,10572,9857,44,8,6,2,1,0,1
6867,10572,8530,56,7,3,4,1,0,1
6868,10576,8686,51,8,3,5,1,0,1
6869,10576,9804,49,12,2,10,0,0,0
6870,10581,8530,44,4,3,1,4,2,2
6871,10581,9885,56,13,3,10,2,1,1
6872,10589,9885,57,3,2,1,2,0,2
6873,10589,9882,43,6,3,3,0,0,0
6874,10590,8686,43,5,2,3,1,0,1
6875,10590,8524,57,2,0,2,0,0,0
6876,10592,8564,53,11,7,4,1,0,1
6877,10592,8636,47,5,2,3,4,0,4
6878,10598,8551,37,3,1,2,1,1,0
6879,10598,8686,63,10,4,6,0,0,0
6880,10600,8564,68,7,3,4,1,0,1
6881,10600,8529,32,5,3,2,1,0,1
6882,10603,9857,39,7,5,2,1,0,1
6883,10603,8636,61,14,10,4,0,0,0
6884,10609,8686,56,13,7,6,2,2,0
6885,10609,8636,44,6,4,2,2,0,2
6886,10618,8551,64,12,9,3,2,1,1
6887,10618,8530,36,0,0,0,0,0,0
6888,10624,10233,48,6,2,4,4,2,2
6889,10624,8636,52,4,1,3,0,0,0
6890,10649,8535,52,5,2,3,4,2,2
6891,10649,10233,48,5,4,1,1,0,1
6892,10650,8540,46,4,3,1,2,1,1
6893,10650,8636,54,5,2,3,1,0,1
6894,10651,9885,62,8,5,3,1,1,0
6895,10651,9882,38,1,0,1,2,0,2
6896,10659,8530,45,4,3,1,1,1,0
6897,10659,8535,55,5,1,4,0,0,0
6898,10666,8564,56,5,2,3,2,0,2
6899,10666,10167,44,7,4,3,0,0,0
6900,10672,8551,46,6,4,2,2,1,1
6901,10672,10233,54,4,3,1,1,0,1
6902,10674,8543,60,14,7,7,2,1,1
6903,10674,8564,40,4,2,2,1,0,1
6904,10677,8636,64,9,6,3,2,0,2
6905,10677,9857,36,3,1,2,0,0,0
6906,10679,9885,54,11,7,4,1,1,0
6907,10679,8600,46,3,1,2,0,0,0
6908,10681,8529,40,7,4,3,2,1,1
6909,10681,8564,60,3,2,1,1,0,1
6910,10689,9885,68,6,1,5,1,1,0
6911,10689,8529,32,0,0,0,0,0,0
6912,10692,9882,59,5,3,2,1,0,1
6913,10692,10233,41,2,1,1,0,0,0
6914,10693,8636,60,8,4,4,6,4,2
6915,10693,8535,40,6,5,1,1,1,0
6916,10702,8564,70,8,5,3,4,1,3
6917,10702,9882,30,3,1,2,1,0,1
6918,10705,8686,48,6,2,4,1,1,0
6919,10705,8543,52,7,4,3,0,0,0
6920,10709,8529,55,2,2,0,1,0,1
6921,10709,9875,45,7,1,6,0,0,0
6922,10712,10233,48,3,1,2,1,0,1
6923,10712,8543,52,5,3,2,1,0,1
6924,10713,8540,35,4,3,1,2,0,2
6925,10713,8564,65,12,3,9,0,0,0
6926,10720,8636,54,5,4,1,1,0,1
6927,10720,8543,46,5,3,2,0,0,0
6928,10721,9885,67,9,5,4,3,1,2
6929,10721,8530,33,1,1,0,0,0,0
6930,10725,8686,57,8,3,5,3,1,2
6931,10725,10167,43,4,1,3,1,0,1
6932,10729,8529,47,7,3,4,1,1,0
6933,10729,8686,53,2,0,2,0,0,0
6934,10731,8636,58,8,6,2,2,1,1
6935,10731,8533,42,3,2,1,0,0,0
6936,10733,8564,58,5,2,3,1,0,1
6937,10733,10233,42,4,2,2,0,0,0
6938,10736,8551,57,7,1,6,2,0,2
6939,10736,8535,43,6,1,5,0,0,0
6940,10738,8535,58,9,6,3,2,0,2
6941,10738,9976,42,5,1,4,0,0,0
6942,10740,8636,59,4,1,3,4,3,1
6943,10740,8551,41,4,1,3,2,0,2
6944,10741,9885,39,5,1,4,2,0,2
6945,10741,8564,61,3,1,2,1,0,1
6946,10742,10167,43,9,6,3,1,0,1
6947,10742,8537,57,5,2,3,0,0,0
6948,10743,9882,54,3,2,1,1,0,1
6949,10743,9875,46,4,1,3,0,0,0
6950,10745,8533,63,5,3,2,2,1,1
6951,10745,8686,37,4,2,2,2,0,2
6952,10757,9857,41,2,2,0,2,1,1
6953,10757,8535,59,13,1,12,0,0,0
6954,10760,8636,45,8,2,6,3,1,2
6955,10760,9976,55,5,2,3,1,1,0
6956,10764,9875,57,6,6,0,2,0,2
6957,10764,8540,43,4,1,3,0,0,0
6958,10765,8551,22,5,1,4,5,3,2
6959,10765,8564,78,5,1,4,0,0,0
6960,10772,8636,32,8,6,2,4,3,1
6961,10772,8564,68,6,2,4,0,0,0
6962,10775,8686,46,4,0,4,4,1,3
6963,10775,9885,54,3,0,3,1,1,0
6964,10782,9885,63,9,4,5,1,1,0
6965,10782,8543,37,2,1,1,1,1,0
6966,10783,8564,68,9,3,6,1,0,1
6967,10783,8537,32,3,0,3,0,0,0
6968,10785,8686,60,5,3,2,2,0,2
6969,10785,8551,40,2,1,1,0,0,0
6970,10795,8535,48,8,4,4,3,0,3
6971,10795,8686,52,1,0,1,0,0,0
6972,10800,9882,42,4,2,2,5,3,2
6973,10800,8535,58,1,0,1,1,0,1
6974,10801,9885,60,8,4,4,3,1,2
6975,10801,10233,40,0,0,0,1,1,0
6976,10802,9875,53,6,6,0,2,1,1
6977,10802,8636,47,8,2,6,0,0,0
6978,10804,8686,46,3,2,1,4,1,3
6979,10804,8540,54,5,4,1,1,0,1
6980,10806,8600,46,9,4,5,1,1,0
6981,10806,8564,54,6,3,3,0,0,0
6982,10807,8530,49,4,2,2,1,1,0
6983,10807,8686,51,5,2,3,0,0,0
6984,10809,9885,47,6,5,1,2,1,1
6985,10809,9857,53,4,1,3,1,0,1
6986,10812,8564,57,3,2,1,4,2,2
6987,10812,9976,43,2,1,1,2,2,0
6988,10815,9882,59,5,4,1,4,2,2
6989,10815,8636,41,5,2,3,0,0,0
6990,10817,8524,38,6,2,4,3,2,1
6991,10817,8564,62,4,2,2,2,0,2
6992,10821,8543,55,5,2,3,2,2,0
6993,10821,8535,45,9,1,8,0,0,0
6994,10822,8600,48,11,6,5,1,0,1
6995,10822,8636,52,7,5,2,0,0,0
6996,10824,9875,56,5,3,2,1,0,1
6997,10824,8686,44,6,4,2,0,0,0
6998,10829,8636,52,5,2,3,3,2,1
6999,10829,10233,48,6,5,1,0,0,0
7000,10833,8686,43,6,2,4,1,1,0
7001,10833,8564,57,2,0,2,3,1,2
7002,10840,8564,63,8,2,6,1,1,0
7003,10840,8533,37,4,2,2,4,1,3
7004,10841,8535,48,4,3,1,1,0,1
7005,10841,9875,52,4,2,2,0,0,0
7006,10842,8636,55,7,3,4,4,2,2
7007,10842,8530,45,3,2,1,1,1,0
7008,10846,8551,46,7,6,1,4,3,1
7009,10846,9885,54,4,2,2,0,0,0
7010,10854,9875,38,7,4,3,3,2,1
7011,10854,8564,62,7,1,6,1,0,1
7012,10856,8600,57,5,1,4,5,2,3
7013,10856,8686,43,6,3,3,4,2,2
7014,10860,10233,54,6,2,4,5,2,3
7015,10860,9875,46,6,3,3,0,0,0
7016,10861,10167,40,2,2,0,2,1,1
7017,10861,8636,60,14,6,8,3,0,3
7018,10862,9885,45,7,3,4,2,0,2
7019,10862,8543,55,6,4,2,0,0,0
7020,10871,8537,39,6,4,2,1,1,0
7021,10871,8636,61,4,4,0,2,0,2
7022,10874,8686,55,8,6,2,1,1,0
7023,10874,9857,45,4,2,2,1,0,1
7024,10877,9885,46,5,2,3,1,1,0
7025,10877,8524,54,5,3,2,0,0,0
7026,10879,9857,53,4,2,2,2,1,1
7027,10879,8540,47,1,0,1,1,0,1
7028,10883,8686,38,7,3,4,1,1,0
7029,10883,8636,62,6,1,5,2,0,2
7030,10885,10167,56,3,2,1,1,1,0
7031,10885,8533,44,3,3,0,3,2,1
7032,10887,8636,65,7,6,1,1,0,1
7033,10887,9857,35,2,0,2,0,0,0
7034,10891,8529,42,5,0,5,2,2,0
7035,10891,8564,58,1,0,1,0,0,0
7036,10897,8686,54,2,1,1,5,3,2
7037,10897,8524,46,4,1,3,4,1,3
7038,10899,9885,52,8,6,2,3,2,1
7039,10899,8529,48,1,1,0,1,1,0
7040,10900,8530,42,4,3,1,2,1,1
7041,10900,8564,58,4,2,2,5,2,3
7042,10903,8636,61,4,4,0,1,1,0
7043,10903,8535,39,4,3,1,2,0,2
7044,10908,8535,57,5,3,2,2,0,2
7045,10908,8524,43,8,4,4,0,0,0
7046,10909,10233,49,9,4,5,3,1,2
7047,10909,10167,51,12,2,10,1,1,0
7048,10911,8533,49,5,4,1,2,1,1
7049,10911,8537,51,2,0,2,1,1,0
7050,10912,9882,54,5,3,2,3,1,2
7051,10912,8564,46,1,0,1,0,0,0
7052,10914,8540,54,11,3,8,1,0,1
7053,10914,8529,46,6,4,2,0,0,0
7054,10915,8543,47,7,2,5,2,1,1
7055,10915,8686,53,7,1,6,1,0,1
7056,10917,8636,53,9,5,4,1,0,1
7057,10917,8524,47,2,0,2,0,0,0
7058,10922,8543,43,3,2,1,1,1,0
7059,10922,10233,57,5,2,3,3,3,0
7060,10923,8540,40,8,2,6,2,1,1
7061,10923,8564,60,6,5,1,0,0,0
7062,10925,8686,58,12,5,7,3,2,1
7063,10925,9882,42,1,1,0,1,0,1
7064,10928,8535,40,4,2,2,4,2,2
7065,10928,8564,60,5,4,1,0,0,0
7066,10930,8636,57,10,8,2,2,0,2
7067,10930,8543,43,5,3,2,0,0,0
7068,10931,8530,37,4,2,2,2,1,1
7069,10931,9885,63,4,3,1,0,0,0
7070,10939,8686,53,11,3,8,3,1,2
7071,10939,8529,47,2,0,2,2,0,2
7072,10941,8636,70,7,2,5,1,1,0
7073,10941,8533,30,2,1,1,0,0,0
7074,10943,10233,42,9,3,6,1,1,0
7075,10943,8564,58,5,2,3,1,0,1
7076,10944,9885,55,3,2,1,2,0,2
7077,10944,10167,45,1,0,1,0,0,0
7078,10945,9882,41,1,1,0,3,1,2
7079,10945,8540,59,4,1,3,1,0,1
7080,10947,8529,56,7,3,4,3,1,2
7081,10947,9857,44,2,2,0,1,0,1
7082,10950,8636,72,6,3,3,1,0,1
7083,10950,8551,28,2,1,1,3,0,3
7084,10951,8564,60,3,2,1,1,1,0
7085,10951,9885,40,9,4,5,0,0,0
7086,10953,9882,42,6,6,0,1,1,0
7087,10953,9875,58,6,4,2,2,1,1
7088,10954,8524,47,12,5,7,4,2,2
7089,10954,8540,53,11,2,9,0,0,0
7090,10956,8600,39,8,3,5,2,0,2
7091,10956,8543,61,11,4,7,0,0,0
7092,10958,8636,58,7,4,3,1,1,0
7093,10958,8529,42,7,2,5,2,0,2
7094,10961,8537,48,9,7,2,3,1,2
7095,10961,9885,52,4,1,3,0,0,0
7096,10965,8535,47,3,1,2,2,1,1
7097,10965,8686,53,8,3,5,2,1,1
7098,10970,9882,43,3,3,0,2,1,1
7099,10970,8535,57,10,6,4,2,1,1
7100,10972,8636,56,5,4,1,1,1,0
7101,10972,9875,44,4,3,1,0,0,0
7102,10980,8543,58,15,8,7,1,1,0
7103,10980,8540,42,1,0,1,2,1,1
7104,10982,9976,43,7,2,5,4,2,2
7105,10982,8564,57,7,1,6,1,0,1
7106,10991,8543,42,11,5,6,2,1,1
7107,10991,8535,58,11,5,6,1,1,0
7108,10992,8636,56,10,5,5,2,1,1
7109,10992,8600,44,5,1,4,0,0,0
7110,10994,8686,48,7,5,2,1,1,0
7111,10994,9875,52,2,1,1,1,1,0
7112,10999,8636,47,2,1,1,1,1,0
7113,10999,10233,53,5,0,5,0,0,0
7114,11000,9885,57,8,2,6,5,3,2
7115,11000,8535,43,8,3,5,1,0,1
7116,11003,8686,40,12,6,6,2,1,1
7117,11003,8564,60,6,2,4,0,0,0
7118,11011,9875,44,6,4,2,2,1,1
7119,11011,8535,56,9,4,5,0,0,0
7120,11012,8636,62,3,2,1,3,2,1
7121,11012,8530,38,5,1,4,2,2,0
7122,11014,8537,38,2,2,0,2,2,0
7123,11014,8686,62,9,5,4,4,2,2
7124,11017,8636,66,18,6,12,3,1,2
7125,11017,9857,34,5,3,2,0,0,0
7126,11018,9885,44,7,5,2,2,1,1
7127,11018,9976,56,9,1,8,0,0,0
7128,11031,8543,54,4,1,3,7,3,4
7129,11031,8686,46,6,3,3,0,0,0
7130,11032,9880,46,4,3,1,3,2,1
7131,11032,9885,54,10,5,5,0,0,0
7132,11034,8533,48,6,4,2,1,1,0
7133,11034,8535,52,12,8,4,2,2,0
7134,11037,8540,45,9,6,3,1,1,0
7135,11037,8564,55,3,3,0,2,2,0
7136,11038,9888,38,3,1,2,3,1,2
7137,11038,8636,62,4,2,2,0,0,0
7138,11039,10167,63,7,3,4,1,1,0
7139,11039,9882,37,2,0,2,1,0,1
7140,11040,8686,59,7,3,4,2,1,1
7141,11040,8535,41,3,3,0,0,0,0
7142,11049,9885,35,7,1,6,1,1,0
7143,11049,8686,65,6,4,2,1,0,1
7144,11050,8564,42,1,1,0,2,2,0
7145,11050,8636,58,3,0,3,1,0,1
7146,11061,8533,37,5,2,3,4,1,3
7147,11061,8636,63,8,3,5,0,0,0
7148,11065,9875,43,9,6,3,4,2,2
7149,11065,9857,57,4,1,3,1,1,0
7150,11067,10167,42,7,3,4,2,0,2
7151,11067,8636,58,2,1,1,0,0,0
7152,11068,8533,45,4,1,3,2,1,1
7153,11068,9857,55,8,2,6,1,1,0
7154,11070,8564,58,15,7,8,5,2,3
7155,11070,9882,42,3,0,3,2,1,1
7156,11072,8686,60,10,7,3,1,0,1
7157,11072,8540,40,6,3,3,1,0,1
7158,11074,8530,38,5,3,2,1,1,0
7159,11074,8543,62,10,4,6,2,0,2
7160,11075,8535,37,5,3,2,2,2,0
7161,11075,9885,63,11,7,4,0,0,0
7162,11077,9885,53,4,1,3,3,1,2
7163,11077,8530,47,3,0,3,1,1,0
7164,11079,8564,65,7,5,2,1,1,0
7165,11079,9858,35,2,1,1,2,0,2
7166,11080,10167,53,5,5,0,2,1,1
7167,11080,8600,47,6,2,4,2,0,2
7168,11089,9882,61,7,3,4,2,2,0
7169,11089,9858,39,3,2,1,2,0,2
7170,11090,8600,60,4,2,2,2,1,1
7171,11090,8535,40,2,1,1,0,0,0
7172,11093,8636,58,6,4,2,2,2,0
7173,11093,9880,42,1,0,1,0,0,0
7174,11095,8540,53,9,4,5,1,1,0
7175,11095,10167,47,4,1,3,1,0,1
7176,11096,8686,52,9,2,7,3,0,3
7177,11096,9976,48,3,1,2,0,0,0
7178,11098,8529,57,1,1,0,2,1,1
7179,11098,9880,43,3,0,3,0,0,0
7180,11099,9976,40,3,1,2,2,1,1
7181,11099,8540,60,8,2,6,1,0,1
7182,11100,8535,45,9,5,4,1,1,0
7183,11100,8636,55,7,3,4,2,1,1
7184,11101,8543,49,10,7,3,3,3,0
7185,11101,8600,51,3,0,3,4,1,3
7186,11103,8533,52,6,2,4,3,2,1
7187,11103,9885,48,3,1,2,1,0,1
7188,11107,8543,52,8,7,1,1,1,0
7189,11107,10233,48,10,4,6,1,0,1
7190,11108,8540,58,3,1,2,1,0,1
7191,11108,9882,42,5,2,3,0,0,0
7192,11113,8564,53,6,1,5,2,2,0
7193,11113,8529,47,5,3,2,0,0,0
7194,11114,9857,48,5,2,3,2,1,1
7195,11114,8535,52,4,2,2,2,2,0
7196,11115,8686,62,10,4,6,1,0,1
7197,11115,8530,38,5,4,1,1,0,1
7198,11121,9885,51,6,3,3,1,1,0
7199,11121,9875,49,4,3,1,2,0,2
7200,11123,9888,42,7,3,4,3,2,1
7201,11123,8543,58,7,1,6,2,0,2
7202,11124,8564,62,9,3,6,2,1,1
7203,11124,8600,38,0,0,0,2,0,2
7204,11125,8533,47,7,4,3,1,1,0
7205,11125,8540,53,8,5,3,1,0,1
7206,11127,9875,51,6,2,4,3,2,1
7207,11127,9976,49,6,1,5,0,0,0
7208,11128,8535,53,6,2,4,1,1,0
7209,11128,9888,47,4,1,3,2,1,1
7210,11129,8543,52,6,4,2,1,1,0
7211,11129,9857,48,4,2,2,0,0,0
7212,11130,9885,54,10,4,6,1,0,1
7213,11130,9882,46,4,3,1,1,0,1
7214,11131,8636,63,6,5,1,3,3,0
7215,11131,8600,37,7,5,2,1,0,1
7216,11137,9885,53,5,3,2,3,2,1
7217,11137,9976,47,3,2,1,1,0,1
7218,11139,9875,52,6,2,4,3,1,2
7219,11139,8535,48,3,2,1,1,0,1
7220,11144,9888,38,3,1,2,1,1,0
7221,11144,8564,62,6,1,5,1,0,1
7222,11145,8529,45,8,2,6,3,2,1
7223,11145,8540,55,1,1,0,2,1,1
7224,11153,8530,48,8,3,5,2,1,1
7225,11153,10167,52,1,1,0,1,0,1
7226,11154,9888,35,5,2,3,3,1,2
7227,11154,8535,65,10,4,6,3,1,2
7228,11159,8600,47,4,1,3,1,1,0
7229,11159,9885,53,6,4,2,0,0,0
7230,11160,10233,44,6,6,0,1,1,0
7231,11160,10167,56,6,2,4,1,0,1
7232,11161,8636,58,12,9,3,2,0,2
7233,11161,8540,42,5,0,5,0,0,0
7234,11162,8564,48,6,3,3,2,1,1
7235,11162,8530,52,5,1,4,1,0,1
7236,11163,9858,53,5,2,3,1,1,0
7237,11163,8533,47,3,1,2,0,0,0
7238,11164,8535,54,5,3,2,2,1,1
7239,11164,8543,46,10,5,5,0,0,0
7240,11167,8543,43,6,4,2,2,1,1
7241,11167,8564,57,9,3,6,0,0,0
7242,11172,9976,47,5,1,4,1,0,1
7243,11172,8636,53,6,2,4,0,0,0
7244,11174,8535,46,7,4,3,2,0,2
7245,11174,10233,54,5,4,1,0,0,0
7246,11175,9885,60,9,3,6,1,1,0
7247,11175,8540,40,1,0,1,1,0,1
7248,11177,8529,47,5,2,3,2,1,1
7249,11177,9885,53,6,4,2,1,0,1
7250,11181,9857,53,5,2,3,1,0,1
7251,11181,8530,47,4,2,2,0,0,0
7252,11188,9885,35,3,3,0,2,1,1
7253,11188,8636,65,5,0,5,1,1,0
7254,11200,9875,68,9,4,5,2,1,1
7255,11200,8530,32,4,0,4,0,0,0
7256,11201,8535,61,5,1,4,1,1,0
7257,11201,9882,39,2,1,1,2,1,1
7258,11207,8530,51,8,4,4,3,2,1
7259,11207,10233,49,3,3,0,1,0,1
7260,11208,8686,55,5,1,4,1,0,1
7261,11208,10167,45,2,1,1,2,0,2
7262,11210,9882,38,9,7,2,1,1,0
7263,11210,8636,62,8,5,3,2,1,1
7264,11214,9885,57,10,5,5,5,2,3
7265,11214,9857,43,0,0,0,1,0,1
7266,11215,8600,54,8,7,1,2,1,1
7267,11215,8540,46,5,3,2,3,1,2
7268,11217,9888,39,2,1,1,2,1,1
7269,11217,8686,61,1,0,1,0,0,0
7270,11221,8540,62,5,4,1,1,0,1
7271,11221,8543,38,1,0,1,0,0,0
7272,11222,9882,59,4,1,3,4,2,2
7273,11222,9880,41,2,0,2,1,1,0
7274,11225,9875,66,7,5,2,2,1,1
7275,11225,9858,34,4,1,3,1,0,1
7276,11226,9976,40,6,4,2,1,1,0
7277,11226,8600,60,9,3,6,1,1,0
7278,11229,9882,43,1,0,1,3,1,2
7279,11229,8530,57,7,0,7,1,0,1
7280,11230,9880,55,7,2,5,1,1,0
7281,11230,9885,45,3,1,2,1,1,0
7282,11232,8543,49,1,1,0,3,2,1
7283,11232,8686,51,5,2,3,4,2,2
7284,11234,9976,28,3,2,1,3,2,1
7285,11234,8564,72,12,2,10,1,0,1
7286,11236,9858,41,7,2,5,2,2,0
7287,11236,8636,59,6,3,3,1,0,1
7288,11237,9885,53,8,5,3,1,1,0
7289,11237,8600,47,5,2,3,2,2,0
7290,11238,9875,54,5,2,3,2,1,1
7291,11238,9882,46,3,2,1,0,0,0
7292,11241,8636,59,7,6,1,1,1,0
7293,11241,8540,41,4,1,3,1,1,0
7294,11247,9875,57,5,2,3,3,0,3
7295,11247,8529,43,4,0,4,0,0,0
7296,11248,8535,45,3,2,1,1,1,0
7297,11248,8686,55,6,2,4,2,1,1
7298,11251,8540,37,6,2,4,1,1,0
7299,11251,8564,63,7,1,6,1,1,0
7300,11253,8636,69,6,4,2,2,0,2
7301,11253,9888,31,4,2,2,0,0,0
7302,11257,9875,59,6,2,4,2,1,1
7303,11257,8543,41,2,1,1,1,0,1
7304,11260,8686,56,8,6,2,1,0,1
7305,11260,9885,44,7,3,4,0,0,0
7306,11261,8564,56,11,5,6,1,0,1
7307,11261,8636,44,7,5,2,0,0,0
7308,11265,9858,45,14,7,7,2,1,1
7309,11265,9857,55,6,1,5,1,0,1
7310,11267,8600,44,6,4,2,1,0,1
7311,11267,8686,56,3,2,1,1,0,1
7312,11269,8543,56,4,3,1,3,1,2
7313,11269,10167,44,6,3,3,0,0,0
7314,11272,10233,37,3,1,2,1,0,1
7315,11272,9885,63,10,4,6,0,0,0
7316,11274,8636,55,7,3,4,1,1,0
7317,11274,8533,45,2,1,1,2,0,2
7318,11277,8535,47,9,6,3,1,0,1
7319,11277,9885,53,3,0,3,0,0,0
7320,11288,8543,55,6,4,2,2,1,1
7321,11288,8636,45,3,1,2,0,0,0
7322,11291,9875,53,4,2,2,4,1,3
7323,11291,8540,47,5,4,1,0,0,0
7324,11295,8686,55,9,2,7,1,1,0
7325,11295,8533,45,3,1,2,1,0,1
7326,11300,8540,67,7,5,2,3,1,2
7327,11300,10167,33,1,0,1,1,1,0
7328,11301,9882,58,7,2,5,2,0,2
7329,11301,9858,42,2,1,1,2,0,2
7330,11303,8686,45,5,1,4,2,0,2
7331,11303,9976,55,0,0,0,0,0,0
7332,11304,8543,60,5,4,1,1,1,0
7333,11304,9885,40,2,1,1,1,0,1
7334,11309,8600,38,5,3,2,1,0,1
7335,11309,8543,62,7,2,5,0,0,0
7336,11311,10167,49,4,4,0,2,0,2
7337,11311,9857,51,5,3,2,0,0,0
7338,11317,8535,60,6,5,1,1,0,1
7339,11317,9857,40,3,1,2,2,0,2
7340,11320,9875,45,6,4,2,2,1,1
7341,11320,8636,55,2,1,1,0,0,0
7342,11322,8530,56,8,4,4,4,2,2
7343,11322,8686,44,2,1,1,1,1,0
7344,11324,9882,48,10,2,8,2,0,2
7345,11324,8540,52,6,1,5,0,0,0
7346,11325,10167,53,6,6,0,1,0,1
7347,11325,9885,47,5,1,4,1,0,1
7348,11329,8543,54,8,4,4,2,1,1
7349,11329,9888,46,7,3,4,0,0,0
7350,11333,8600,37,7,1,6,2,2,0
7351,11333,8564,63,5,1,4,0,0,0
7352,11339,8564,57,4,2,2,2,1,1
7353,11339,8543,43,6,2,4,0,0,0
7354,11344,9882,47,5,2,3,1,1,0
7355,11344,8529,53,4,2,2,0,0,0
7356,11347,8600,45,6,2,4,2,1,1
7357,11347,9882,55,2,1,1,0,0,0
7358,11348,8636,56,10,6,4,4,3,1
7359,11348,8686,44,7,5,2,3,0,3
7360,11351,9885,53,4,3,1,1,1,0
7361,11351,8529,47,3,1,2,0,0,0
7362,11352,8535,59,11,6,5,4,1,3
7363,11352,10167,41,3,1,2,1,0,1
7364,11353,8543,58,4,3,1,2,1,1
7365,11353,8533,42,1,1,0,1,0,1
7366,11354,9875,65,10,7,3,1,1,0
7367,11354,9880,35,5,1,4,0,0,0
7368,11357,8530,60,4,3,1,1,1,0
7369,11357,9888,40,3,3,0,1,0,1
7370,11358,9875,39,10,5,5,1,0,1
7371,11358,8686,61,11,5,6,0,0,0
7372,11360,8600,66,9,5,4,2,1,1
7373,11360,9880,34,0,0,0,3,0,3
7374,11362,9885,38,11,4,7,1,0,1
7375,11362,8636,62,10,7,3,0,0,0
7376,11364,8535,53,10,4,6,1,0,1
7377,11364,8540,47,8,2,6,1,0,1
7378,11366,9857,57,8,4,4,1,0,1
7379,11366,9882,43,5,4,1,0,0,0
7380,11367,8564,56,9,5,4,1,0,1
7381,11367,8533,44,8,5,3,0,0,0
7382,11368,8540,52,8,2,6,4,3,1
7383,11368,9857,48,2,1,1,0,0,0
7384,11369,8686,44,4,3,1,3,1,2
7385,11369,10233,56,5,0,5,0,0,0
7386,11370,8535,46,2,2,0,2,1,1
7387,11370,9882,54,5,4,1,2,0,2
7388,11374,8636,55,7,3,4,1,0,1
7389,11374,8529,45,3,0,3,0,0,0
7390,11376,9976,58,6,3,3,1,0,1
7391,11376,8543,42,1,0,1,1,0,1
7392,11377,8564,59,8,2,6,2,2,0
7393,11377,9875,41,4,3,1,1,0,1
7394,11378,10167,49,2,1,1,1,0,1
7395,11378,8686,51,2,1,1,0,0,0
7396,11382,8543,56,7,4,3,2,1,1
7397,11382,8529,44,4,1,3,1,1,0
7398,11387,9888,48,7,4,3,1,1,0
7399,11387,8686,52,12,8,4,1,0,1
7400,11389,8540,60,16,5,11,3,2,1
7401,11389,8543,40,5,1,4,1,0,1
7402,11390,8564,63,11,6,5,1,1,0
7403,11390,9885,37,5,4,1,1,0,1
7404,11391,10233,44,7,4,3,1,1,0
7405,11391,8636,56,4,3,1,2,1,1
7406,11392,9882,46,5,1,4,1,1,0
7407,11392,9880,54,7,4,3,0,0,0
7408,11402,9875,54,9,4,5,2,1,1
7409,11402,10233,46,6,2,4,1,0,1
7410,11406,9885,53,10,8,2,4,2,2
7411,11406,8600,47,6,1,5,1,0,1
7412,11415,8533,52,4,3,1,2,0,2
7413,11415,8551,48,4,1,3,2,0,2
7414,11416,8600,47,6,3,3,2,1,1
7415,11416,8540,53,8,2,6,0,0,0
7416,11419,8535,60,3,2,1,3,1,2
7417,11419,8533,40,2,2,0,3,2,1
7418,11420,8636,56,10,5,5,1,0,1
7419,11420,10233,44,2,0,2,1,0,1
7420,11424,8686,67,12,4,8,4,3,1
7421,11424,6269,33,3,1,2,0,0,0
7422,11427,9880,46,3,2,1,2,2,0
7423,11427,9857,54,8,3,5,3,1,2
7424,11428,8564,68,6,2,4,1,1,0
7425,11428,8535,32,2,0,2,0,0,0
7426,11432,8540,40,3,2,1,2,1,1
7427,11432,9885,60,4,2,2,0,0,0
7428,11435,8686,68,8,4,4,1,0,1
7429,11435,9888,32,1,1,0,1,0,1
7430,11440,9885,54,5,3,2,4,1,3
7431,11440,8543,46,11,4,7,0,0,0
7432,11444,8535,59,10,6,4,4,3,1
7433,11444,8540,41,3,2,1,0,0,0
7434,11445,8636,66,4,2,2,1,0,1
7435,11445,8551,34,2,0,2,0,0,0
7436,11451,10233,28,5,4,1,2,1,1
7437,11451,8564,72,8,4,4,4,2,2
7438,11452,9885,74,15,9,6,1,1,0
7439,11452,9880,26,1,0,1,1,0,1
7440,11454,9875,47,6,3,3,3,1,2
7441,11454,9888,53,4,4,0,2,1,1
7442,11455,10167,47,9,4,5,2,2,0
7443,11455,8540,53,2,1,1,2,2,0
7444,11456,8600,43,7,3,4,1,1,0
7445,11456,8636,57,2,2,0,3,1,2
7446,11463,8540,62,7,4,3,4,1,3
7447,11463,9880,38,7,4,3,1,0,1
7448,11468,9880,40,7,3,4,2,2,0
7449,11468,8636,60,3,1,2,3,0,3
7450,11470,8524,59,4,2,2,5,1,4
7451,11470,8535,41,5,1,4,1,0,1
7452,11472,9885,66,13,10,3,2,2,0
7453,11472,6269,34,8,4,4,3,2,1
7454,11473,8600,47,2,1,1,2,0,2
7455,11473,8543,53,11,2,9,0,0,0
7456,11474,8564,64,5,3,2,2,2,0
7457,11474,8551,36,3,1,2,2,1,1
7458,11480,8636,55,2,1,1,1,0,1
7459,11480,10167,45,3,1,2,0,0,0
7460,11485,8543,52,8,5,3,3,2,1
7461,11485,8551,48,4,1,3,2,1,1
7462,11486,9880,40,4,3,1,3,2,1
7463,11486,8600,60,5,3,2,0,0,0
7464,11487,8686,66,5,2,3,1,0,1
7465,11487,8530,34,3,1,2,1,0,1
7466,11494,8564,66,7,4,3,1,0,1
7467,11494,8636,34,6,3,3,0,0,0
7468,11497,8524,37,6,3,3,4,3,1
7469,11497,9885,63,7,4,3,2,1,1
7470,11502,8564,61,11,9,2,3,1,2
7471,11502,6269,39,2,0,2,2,0,2
7472,11504,8686,75,10,5,5,2,0,2
7473,11504,9880,25,4,1,3,1,0,1
7474,11508,9880,44,6,5,1,1,0,1
7475,11508,9875,56,9,4,5,1,0,1
7476,11510,8535,51,5,1,4,1,0,1
7477,11510,9857,49,5,2,3,0,0,0
7478,11512,9885,65,5,1,4,4,0,4
7479,11512,10167,35,2,0,2,3,0,3
7480,11520,8636,64,13,7,6,4,3,1
7481,11520,9888,36,3,2,1,1,1,0
7482,11527,8530,44,4,2,2,3,1,2
7483,11527,8551,56,11,3,8,3,0,3
7484,11529,8533,47,5,4,1,1,1,0
7485,11529,6269,53,7,6,1,3,2,1
7486,11532,9885,63,8,4,4,2,1,1
7487,11532,10167,37,3,1,2,1,0,1
7488,11536,8686,53,9,4,5,2,0,2
7489,11536,8529,47,2,1,1,2,0,2
7490,11540,8686,65,3,2,1,3,2,1
7491,11540,8636,35,3,1,2,4,1,3
7492,11541,8543,51,5,3,2,2,2,0
7493,11541,10233,49,2,0,2,2,1,1
7494,11544,9885,71,13,3,10,2,1,1
7495,11544,8551,29,3,1,2,2,0,2
7496,11547,8533,47,3,2,1,3,2,1
7497,11547,9875,53,5,0,5,0,0,0
7498,11551,8636,70,13,5,8,2,1,1
7499,11551,6269,30,5,3,2,1,0,1
7500,11553,8686,74,5,3,2,2,1,1
7501,11553,8551,26,3,1,2,1,0,1
7502,11555,8636,56,8,3,5,1,0,1
7503,11555,9857,44,3,1,2,1,0,1
7504,11557,8530,36,5,4,1,1,0,1
7505,11557,9885,64,17,9,8,1,0,1
7506,11563,9888,52,3,3,0,2,2,0
7507,11563,8551,48,7,3,4,4,2,2
7508,11566,9875,49,3,2,1,3,2,1
7509,11566,8636,51,2,0,2,0,0,0
7510,11572,8686,68,4,4,0,1,0,1
7511,11572,8524,32,0,0,0,0,0,0
7512,11575,8564,63,8,4,4,3,3,0
7513,11575,8540,37,7,4,3,2,1,1
7514,11576,10167,57,12,3,9,2,0,2
7515,11576,9875,43,1,0,1,1,0,1
7516,11577,8529,46,4,3,1,1,0,1
7517,11577,9875,54,3,2,1,1,0,1
7518,11584,9885,72,6,3,3,2,2,0
7519,11584,8535,28,3,0,3,2,0,2
7520,11587,9875,65,10,3,7,2,1,1
7521,11587,8600,35,1,1,0,0,0,0
7522,11590,9857,49,7,6,1,2,1,1
7523,11590,8524,51,10,7,3,1,1,0
7524,11596,8686,52,6,3,3,2,1,1
7525,11596,8564,48,9,6,3,2,1,1
7526,11598,8540,42,4,2,2,2,1,1
7527,11598,8600,58,10,5,5,1,0,1
7528,11599,8540,55,2,1,1,2,1,1
7529,11599,8524,45,1,0,1,0,0,0
7530,11601,8529,54,7,3,4,1,1,0
7531,11601,6269,46,4,2,2,3,0,3
7532,11604,10233,52,2,1,1,4,4,0
7533,11604,8543,48,2,0,2,0,0,0
7534,11605,9875,45,3,2,1,1,1,0
7535,11605,8564,55,6,2,4,1,0,1
7536,11607,9885,60,7,2,5,2,1,1
7537,11607,8551,40,4,2,2,7,1,6
7538,11608,8600,42,5,3,2,3,2,1
7539,11608,8535,58,5,3,2,1,0,1
7540,11609,10233,49,8,6,2,2,2,0
7541,11609,8636,51,7,3,4,0,0,0
7542,11610,10167,51,7,3,4,1,0,1
7543,11610,8543,49,2,1,1,2,0,2
7544,11612,8686,65,8,2,6,1,0,1
7545,11612,6269,35,8,1,7,0,0,0
7546,11617,8564,63,7,1,6,1,1,0
7547,11617,8535,37,3,1,2,1,0,1
7548,11620,9885,65,9,5,4,1,0,1
7549,11620,8540,35,2,1,1,0,0,0
7550,11621,9875,58,2,1,1,1,0,1
7551,11621,8543,42,3,0,3,0,0,0
7552,11628,9885,72,11,8,3,2,1,1
7553,11628,8543,28,5,4,1,0,0,0
7554,11636,8530,51,8,3,5,1,1,0
7555,11636,8529,49,6,2,4,0,0,0
7556,11637,8533,44,3,2,1,1,1,0
7557,11637,8524,56,5,4,1,3,0,3
7558,11638,8686,65,7,2,5,2,1,1
7559,11638,8535,35,5,4,1,0,0,0
7560,11639,8564,66,11,4,7,1,1,0
7561,11639,10233,34,2,1,1,2,0,2
7562,11640,8600,51,8,3,5,1,0,1
7563,11640,8636,49,3,2,1,0,0,0
7564,11641,9885,72,11,5,6,1,0,1
7565,11641,9880,28,4,3,1,0,0,0
7566,11642,6269,46,6,4,2,1,0,1
7567,11642,8543,54,5,1,4,0,0,0
7568,11660,9885,65,9,2,7,1,1,0
7569,11660,6269,35,3,0,3,2,1,1
7570,11661,8600,62,9,6,3,2,1,1
7571,11661,8543,38,4,2,2,1,0,1
7572,11665,8564,54,9,6,3,2,0,2
7573,11665,8524,46,4,2,2,1,0,1
7574,11675,8686,62,13,5,8,1,0,1
7575,11675,8530,38,4,4,0,0,0,0
7576,11678,8535,33,2,2,0,2,1,1
7577,11678,9888,67,4,1,3,0,0,0
7578,11680,9885,55,8,5,3,3,2,1
7579,11680,8529,45,0,0,0,1,0,1
7580,11684,8551,47,4,2,2,1,0,1
7581,11684,10167,53,4,1,3,1,0,1
7582,11702,6269,43,7,2,5,1,1,0
7583,11702,8636,57,5,4,1,0,0,0
7584,11706,8636,43,3,1,2,4,1,3
7585,11706,9857,57,4,2,2,2,2,0
7586,11709,10233,47,5,5,0,3,0,3
7587,11709,8533,53,9,2,7,0,0,0
7588,11711,9880,39,4,1,3,1,1,0
7589,11711,8564,61,4,0,4,1,1,0
7590,11716,8543,58,6,2,4,1,1,0
7591,11716,8535,42,6,0,6,0,0,0
7592,11717,8636,40,4,2,2,3,1,2
7593,11717,9875,60,1,0,1,1,0,1
7594,11718,9885,55,8,6,2,1,0,1
7595,11718,8564,45,2,1,1,0,0,0
7596,11725,8524,52,9,4,5,2,1,1
7597,11725,8600,48,2,1,1,2,2,0
7598,11727,8530,51,5,2,3,2,2,0
7599,11727,8636,49,2,0,2,0,0,0
7600,11728,8535,53,6,3,3,1,0,1
7601,11728,9880,47,3,1,2,0,0,0
7602,11732,8564,68,11,5,6,1,0,1
7603,11732,8540,32,0,0,0,0,0,0
7604,11736,8529,41,4,2,2,2,1,1
7605,11736,9875,59,3,1,2,0,0,0
7606,11737,8535,48,9,5,4,2,1,1
7607,11737,8530,52,5,1,4,0,0,0
7608,11739,10233,43,6,4,2,1,1,0
7609,11739,9885,57,6,5,1,0,0,0
7610,11742,8540,40,8,2,6,1,1,0
7611,11742,8686,60,2,0,2,0,0,0
7612,11745,8524,44,2,2,0,1,0,1
7613,11745,8636,56,4,2,2,0,0,0
7614,11751,10167,38,5,3,2,3,2,1
7615,11751,8564,62,6,1,5,2,0,2
7616,12515,9876,46,4,3,1,2,0,2
7617,12515,8524,54,6,2,4,1,0,1
7618,12518,10233,47,4,3,1,2,0,2
7619,12518,9875,53,4,0,4,0,0,0
7620,12521,8535,43,4,2,2,4,1,3
7621,12521,8686,57,5,1,4,0,0,0
7622,12522,7943,41,8,3,5,1,0,1
7623,12522,8529,59,7,2,5,0,0,0
7624,12523,9804,42,4,0,4,1,1,0
7625,12523,8636,58,2,0,2,2,0,2
7626,12526,7943,56,5,2,3,1,1,0
7627,12526,8533,44,5,3,2,0,0,0
7628,12528,8543,47,4,4,0,4,2,2
7629,12528,8529,53,4,1,3,3,1,2
7630,12530,9875,41,8,5,3,1,1,0
7631,12530,8686,59,7,4,3,0,0,0
7632,12531,8636,70,2,1,1,3,2,1
7633,12531,10167,30,4,1,3,2,0,2
7634,12532,8535,67,9,6,3,1,1,0
7635,12532,9882,33,5,1,4,2,0,2
7636,12533,8524,36,6,1,5,5,3,2
7637,12533,9804,64,13,1,12,1,0,1
7638,12534,10233,49,3,2,1,2,1,1
7639,12534,8600,51,1,0,1,0,0,0
7640,12535,10233,54,7,4,3,2,0,2
7641,12535,8529,46,6,3,3,0,0,0
7642,12538,9875,41,10,7,3,3,2,1
7643,12538,8535,59,6,1,5,2,0,2
7644,12540,9885,68,4,3,1,3,1,2
7645,12540,10167,32,2,2,0,0,0,0
7646,12542,8686,59,7,4,3,1,0,1
7647,12542,9804,41,5,2,3,0,0,0
7648,12544,7943,55,11,5,6,1,0,1
7649,12544,8524,45,3,1,2,0,0,0
7650,12545,8524,45,4,3,1,3,3,0
7651,12545,8686,55,3,3,0,1,0,1
7652,12547,10233,58,8,5,3,1,0,1
7653,12547,8540,42,5,3,2,1,0,1
7654,12549,9885,56,5,3,2,3,0,3
7655,12549,8543,44,7,1,6,0,0,0
7656,12550,8636,56,2,2,0,1,0,1
7657,12550,8564,44,2,0,2,0,0,0
7658,12552,10167,51,5,2,3,1,1,0
7659,12552,8534,49,4,2,2,3,1,2
7660,12553,9804,54,7,5,2,1,0,1
7661,12553,7943,46,5,0,5,1,0,1
7662,12554,8600,53,4,1,3,1,0,1
7663,12554,8533,47,5,4,1,1,0,1
7664,12555,8535,48,4,3,1,1,1,0
7665,12555,8529,52,9,3,6,1,1,0
7666,12559,9885,62,7,5,2,4,2,2
7667,12559,9804,38,8,2,6,0,0,0
7668,12560,8564,62,10,5,5,4,0,4
7669,12560,8600,38,1,0,1,1,0,1
7670,12561,10167,51,7,2,5,3,2,1
7671,12561,8540,49,3,1,2,2,2,0
7672,12562,8686,52,4,3,1,1,1,0
7673,12562,8636,48,2,1,1,5,2,3
7674,12563,9882,42,6,5,1,2,2,0
7675,12563,9875,58,2,0,2,0,0,0
7676,12564,9876,46,3,1,2,2,1,1
7677,12564,7943,54,7,6,1,4,0,4
7678,12566,8533,43,4,3,1,3,1,2
7679,12566,8529,57,5,1,4,1,0,1
7680,12567,8535,49,6,4,2,2,0,2
7681,12567,9885,51,8,2,6,0,0,0
7682,12569,9876,39,8,3,5,1,1,0
7683,12569,9882,61,6,3,3,0,0,0
7684,12570,8600,35,5,2,3,3,2,1
7685,12570,8636,65,9,3,6,3,1,2
7686,12571,9875,55,15,11,4,3,2,1
7687,12571,8534,45,4,2,2,2,0,2
7688,12573,8686,77,5,4,1,1,0,1
7689,12573,7943,23,3,1,2,0,0,0
7690,12576,8636,68,12,5,7,2,2,0
7691,12576,8533,32,7,4,3,1,1,0
7692,12577,8534,54,11,5,6,3,3,0
7693,12577,9804,46,5,3,2,1,0,1
7694,12578,8686,67,8,5,3,3,2,1
7695,12578,10233,33,3,3,0,1,0,1
7696,12579,9885,66,11,5,6,2,0,2
7697,12579,9882,34,4,2,2,0,0,0
7698,12580,8543,53,9,4,5,1,1,0
7699,12580,8524,47,2,0,2,1,0,1
7700,12581,9875,51,7,4,3,2,1,1
7701,12581,8564,49,3,0,3,1,0,1
7702,12582,7943,54,8,5,3,1,1,0
7703,12582,8540,46,6,2,4,0,0,0
7704,12583,10167,44,1,1,0,1,0,1
7705,12583,8529,56,6,1,5,0,0,0
7706,12584,9876,41,5,4,1,1,1,0
7707,12584,8600,59,9,4,5,1,0,1
7708,12585,8540,48,7,4,3,2,1,1
7709,12585,8524,52,6,1,5,1,0,1
7710,12586,9885,63,7,1,6,3,2,1
7711,12586,8529,37,3,3,0,0,0,0
7712,12587,8535,60,6,3,3,1,0,1
7713,12587,8534,40,5,2,3,0,0,0
7714,12588,9876,54,4,2,2,2,1,1
7715,12588,8533,46,4,2,2,1,0,1
7716,12590,9875,60,7,1,6,2,0,2
7717,12590,10167,40,0,0,0,0,0,0
7718,12592,8600,33,3,1,2,2,1,1
7719,12592,9882,67,9,3,6,1,1,0
7720,12593,7943,53,10,7,3,1,1,0
7721,12593,9880,47,2,1,1,0,0,0
7722,12594,9804,42,6,2,4,1,1,0
7723,12594,10233,58,6,3,3,1,0,1
7724,12595,9875,60,7,4,3,2,1,1
7725,12595,9880,40,4,2,2,0,0,0
7726,12596,8533,55,11,6,5,6,4,2
7727,12596,9804,45,6,4,2,1,1,0
7728,12598,10233,61,10,4,6,1,1,0
7729,12598,8524,39,5,2,3,1,0,1
7730,12599,8636,49,4,1,3,4,4,0
7731,12599,9885,51,8,6,2,0,0,0
7732,12600,8543,56,7,3,4,2,1,1
7733,12600,9882,44,2,1,1,1,1,0
7734,12601,8564,64,6,1,5,1,1,0
7735,12601,7943,36,3,2,1,3,2,1
7736,12604,8686,61,7,2,5,1,1,0
7737,12604,8600,39,1,1,0,1,0,1
7738,12605,8533,48,4,2,2,2,1,1
7739,12605,8524,52,10,5,5,4,0,4
7740,12606,9880,60,7,3,4,2,2,0
7741,12606,8529,40,5,0,5,0,0,0
7742,12609,8636,60,9,7,2,2,1,1
7743,12609,10233,40,7,1,6,2,1,1
7744,12610,9885,51,4,4,0,2,1,1
7745,12610,9875,49,3,1,2,0,0,0
7746,12614,9804,65,9,2,7,3,1,2
7747,12614,8564,35,2,2,0,1,1,0
7748,12615,9804,48,5,1,4,3,1,2
7749,12615,9880,52,6,1,5,1,0,1
7750,12616,8533,39,10,5,5,4,3,1
7751,12616,8535,61,8,2,6,2,0,2
7752,12618,7943,40,7,6,1,1,1,0
7753,12618,10233,60,5,0,5,2,2,0
7754,12621,8564,69,11,6,5,1,1,0
7755,12621,8524,31,7,3,4,2,1,1
7756,12622,8686,59,4,1,3,2,1,1
7757,12622,8540,41,2,1,1,1,0,1
7758,12623,9882,53,5,2,3,1,0,1
7759,12623,10167,47,5,3,2,0,0,0
7760,12625,8529,57,9,5,4,2,2,0
7761,12625,8524,43,2,1,1,0,0,0
7762,12626,8686,60,2,1,1,2,2,0
7763,12626,8534,40,9,4,5,0,0,0
7764,12627,8535,65,12,5,7,2,1,1
7765,12627,10233,35,2,1,1,1,0,1
7766,12630,9885,55,7,3,4,2,0,2
7767,12630,8600,45,2,0,2,2,0,2
7768,12634,9882,44,2,1,1,2,0,2
7769,12634,9804,56,1,0,1,0,0,0
7770,12635,9876,47,8,4,4,2,2,0
7771,12635,8524,53,7,2,5,2,0,2
7772,12637,9885,63,16,9,7,1,0,1
7773,12637,8533,37,4,2,2,1,0,1
7774,12640,8540,54,9,3,6,3,1,2
7775,12640,9882,46,6,3,3,3,2,1
7776,12642,8529,40,3,1,2,2,1,1
7777,12642,7943,60,6,1,5,2,1,1
7778,12643,8636,70,7,3,4,3,1,2
7779,12643,9804,30,3,0,3,0,0,0
7780,12644,8534,66,6,3,3,1,1,0
7781,12644,8600,34,1,0,1,1,0,1
7782,12647,10233,47,7,4,3,1,1,0
7783,12647,8535,53,6,2,4,0,0,0
7784,12648,8540,66,6,5,1,1,0,1
7785,12648,9876,34,7,3,4,0,0,0
7786,12649,8636,70,8,4,4,2,1,1
7787,12649,7943,30,7,4,3,1,0,1
7788,12651,9880,41,5,4,1,2,1,1
7789,12651,8543,59,6,4,2,1,0,1
7790,12652,9875,53,7,2,5,1,1,0
7791,12652,8533,47,3,0,3,2,0,2
7792,12654,9882,60,3,2,1,1,1,0
7793,12654,9804,40,5,2,3,1,1,0
7794,12655,8524,37,5,4,1,2,2,0
7795,12655,8535,63,10,5,5,2,1,1
7796,12656,8534,60,4,3,1,1,0,1
7797,12656,9880,40,3,0,3,0,0,0
7798,12657,10167,48,4,3,1,4,2,2
7799,12657,8533,52,4,0,4,1,0,1
7800,12659,9885,53,10,7,3,1,1,0
7801,12659,8564,47,6,1,5,1,1,0
7802,12661,8529,44,7,3,4,3,1,2
7803,12661,8686,56,4,1,3,1,0,1
7804,12662,7943,49,5,3,2,1,0,1
7805,12662,9882,51,6,2,4,1,0,1
7806,12663,9804,42,3,1,2,1,0,1
7807,12663,9876,58,11,2,9,0,0,0
7808,12665,9804,47,10,2,8,2,0,2
7809,12665,8529,53,3,2,1,0,0,0
7810,12668,9876,35,7,4,3,4,3,1
7811,12668,10233,65,2,1,1,0,0,0
7812,12672,9875,64,4,3,1,2,1,1
7813,12672,8540,36,2,0,2,0,0,0
7814,12673,10167,32,1,1,0,2,1,1
7815,12673,8686,68,9,5,4,0,0,0
7816,12674,9882,70,5,3,2,1,0,1
7817,12674,8533,30,4,0,4,0,0,0
7818,12675,9885,62,7,4,3,4,3,1
7819,12675,8524,38,2,1,1,1,1,0
7820,12676,8564,58,7,5,2,2,1,1
7821,12676,9880,42,7,5,2,0,0,0
7822,12678,10233,61,5,4,1,2,2,0
7823,12678,9882,39,2,1,1,1,0,1
7824,12679,8636,62,9,6,3,3,3,0
7825,12679,8529,38,5,1,4,0,0,0
7826,12680,8540,43,7,3,4,2,1,1
7827,12680,8543,57,9,2,7,0,0,0
7828,12681,8686,77,11,4,7,2,0,2
7829,12681,9876,23,3,2,1,0,0,0
7830,12682,7943,44,4,2,2,2,0,2
7831,12682,9875,56,2,1,1,1,0,1
7832,12683,8535,62,9,6,3,1,1,0
7833,12683,9804,38,6,1,5,0,0,0
7834,12684,8600,59,4,3,1,1,1,0
7835,12684,10167,41,11,6,5,1,0,1
7836,12685,8540,46,7,4,3,2,2,0
7837,12685,8534,54,8,3,5,2,1,1
7838,12686,8535,41,6,3,3,1,0,1
7839,12686,8636,59,9,3,6,0,0,0
7840,12687,8529,71,8,3,5,2,1,1
7841,12687,9876,29,2,0,2,0,0,0
7842,12688,9885,40,3,1,2,1,0,1
7843,12688,8686,60,9,3,6,0,0,0
7844,12689,7943,39,5,2,3,2,0,2
7845,12689,8543,61,6,3,3,0,0,0
7846,12690,8564,63,5,3,2,4,4,0
7847,12690,8533,37,7,3,4,3,2,1
7848,12691,9875,57,6,3,3,2,2,0
7849,12691,9804,43,4,2,2,0,0,0
7850,12693,9882,55,9,2,7,4,2,2
7851,12693,8524,45,7,1,6,1,0,1
7852,12694,8600,45,3,2,1,1,1,0
7853,12694,9880,55,6,4,2,1,0,1
7854,12695,8524,52,3,2,1,1,1,0
7855,12695,10167,48,8,3,5,0,0,0
7856,12696,9882,53,7,4,3,1,1,0
7857,12696,8529,47,5,1,4,2,1,1
7858,12697,8543,44,10,5,5,3,1,2
7859,12697,8535,56,3,2,1,1,1,0
7860,12698,10233,49,5,3,2,4,1,3
7861,12698,8534,51,2,0,2,1,0,1
7862,12699,8564,61,10,4,6,3,2,1
7863,12699,9876,39,5,3,2,1,1,0
7864,12700,8636,63,6,4,2,1,1,0
7865,12700,9875,37,6,5,1,1,0,1
7866,12702,8686,60,5,3,2,1,0,1
7867,12702,8533,40,4,2,2,0,0,0
7868,12706,8533,38,6,3,3,2,1,1
7869,12706,10233,62,7,4,3,1,0,1
7870,12707,8529,38,5,4,1,1,1,0
7871,12707,8534,62,2,1,1,2,1,1
7872,12708,9885,49,4,1,3,3,2,1
7873,12708,8540,51,7,2,5,0,0,0
7874,12709,8543,53,6,4,2,1,0,1
7875,12709,9804,47,5,1,4,1,0,1
7876,12710,8535,56,8,4,4,2,2,0
7877,12710,8564,44,4,4,0,0,0,0
7878,12711,9876,31,5,4,1,2,1,1
7879,12711,9875,69,8,2,6,1,0,1
7880,12712,10167,44,4,1,3,1,1,0
7881,12712,7943,56,10,3,7,4,2,2
7882,12713,8686,61,10,6,4,1,0,1
7883,12713,9882,39,4,2,2,0,0,0
7884,12715,9875,69,11,5,6,2,2,0
7885,12715,8524,31,4,4,0,0,0,0
7886,12718,9885,55,6,3,3,4,1,3
7887,12718,10233,45,4,3,1,0,0,0
7888,12719,9876,43,2,1,1,2,1,1
7889,12719,8543,57,11,5,6,2,0,2
7890,12721,8533,30,8,4,4,1,0,1
7891,12721,8540,70,5,1,4,0,0,0
7892,12722,8686,51,4,4,0,2,1,1
7893,12722,9880,49,1,0,1,2,1,1
7894,12724,9804,59,5,2,3,1,0,1
7895,12724,10167,41,6,1,5,0,0,0
7896,12725,9880,63,8,4,4,2,1,1
7897,12725,9876,37,6,3,3,1,1,0
7898,12726,7943,48,1,1,0,1,1,0
7899,12726,8533,52,4,1,3,5,1,4
7900,12728,8529,40,8,4,4,1,0,1
7901,12728,8543,60,8,3,5,0,0,0
7902,12729,8564,47,5,2,3,1,0,1
7903,12729,8540,53,4,3,1,0,0,0
7904,12730,8686,47,3,1,2,3,1,2
7905,12730,9875,53,7,3,4,0,0,0
7906,12734,8600,42,9,5,4,1,0,1
7907,12734,10233,58,8,5,3,0,0,0
7908,12735,8535,63,10,5,5,2,1,1
7909,12735,8524,37,9,3,6,3,0,3
7910,12737,10167,60,3,2,1,1,0,1
7911,12737,8533,40,1,0,1,0,0,0
7912,12738,8543,59,7,6,1,2,1,1
7913,12738,10233,41,3,2,1,0,0,0
7914,12742,7943,48,5,2,3,2,1,1
7915,12742,9882,52,3,0,3,2,0,2
7916,12743,9804,49,7,2,5,2,2,0
7917,12743,9876,51,4,2,2,2,1,1
7918,12744,9875,55,4,3,1,1,0,1
7919,12744,8600,45,4,1,3,0,0,0
7920,12746,8533,48,6,2,4,2,0,2
7921,12746,9880,52,5,2,3,0,0,0
7922,12747,8534,52,9,4,5,1,1,0
7923,12747,8543,48,3,1,2,3,1,2
7924,12748,9875,37,4,4,0,2,1,1
7925,12748,8535,63,2,2,0,1,0,1
7926,12749,9876,38,7,0,7,2,1,1
7927,12749,8636,62,0,0,0,0,0,0
7928,12750,10167,34,3,1,2,3,2,1
7929,12750,9885,66,8,7,1,4,0,4
7930,12753,8564,58,13,8,5,1,0,1
7931,12753,9882,42,4,2,2,0,0,0
7932,12757,8540,39,5,3,2,3,1,2
7933,12757,10233,61,2,0,2,2,1,1
7934,12760,8636,55,7,2,5,1,1,0
7935,12760,8564,45,6,2,4,1,0,1
7936,12761,8529,48,5,3,2,3,2,1
7937,12761,9875,52,4,3,1,0,0,0
7938,12763,9804,56,11,8,3,2,2,0
7939,12763,7943,44,2,0,2,1,1,0
7940,12766,10233,54,5,3,2,3,2,1
7941,12766,9880,46,7,4,3,0,0,0
7942,12767,8543,55,12,6,6,2,1,1
7943,12767,8533,45,2,1,1,1,0,1
7944,12769,9804,45,4,3,1,3,2,1
7945,12769,9885,55,5,2,3,3,2,1
7946,12771,10167,43,4,2,2,1,1,0
7947,12771,8540,57,11,5,6,1,0,1
7948,12772,8686,54,7,4,3,2,2,0
7949,12772,8636,46,4,2,2,1,0,1
7950,12774,9876,33,9,5,4,1,1,0
7951,12774,7943,67,8,2,6,1,1,0
7952,12775,8524,45,7,3,4,2,1,1
7953,12775,9880,55,3,2,1,3,0,3
7954,12776,8529,56,6,5,1,2,1,1
7955,12776,8533,44,5,1,4,4,3,1
7956,12777,9885,51,6,5,1,4,1,3
7957,12777,8535,49,2,1,1,0,0,0
7958,12779,9876,39,6,1,5,3,1,2
7959,12779,9882,61,11,6,5,2,0,2
7960,12782,10167,31,2,1,1,3,3,0
7961,12782,8543,69,5,2,3,2,1,1
7962,12784,9804,51,5,2,3,3,1,2
7963,12784,8540,49,4,0,4,1,0,1
7964,12786,8636,71,11,5,6,5,3,2
7965,12786,8533,29,5,0,5,0,0,0
7966,12787,8534,39,12,9,3,1,1,0
7967,12787,9804,61,7,1,6,0,0,0
7968,12788,10233,56,7,4,3,1,1,0
7969,12788,8686,44,7,4,3,0,0,0
7970,12790,8543,51,7,4,3,3,2,1
7971,12790,8524,49,9,6,3,2,1,1
7972,12791,9875,77,7,1,6,5,2,3
7973,12791,8564,23,1,1,0,0,0,0
7974,12793,10167,46,8,3,5,2,2,0
7975,12793,8529,54,4,3,1,2,1,1
7976,12794,8600,52,6,2,4,1,1,0
7977,12794,9876,48,7,2,5,3,0,3
7978,12795,8540,65,11,3,8,1,0,1
7979,12795,8524,35,6,1,5,0,0,0
7980,12796,8529,47,9,2,7,1,1,0
7981,12796,9885,53,4,3,1,0,0,0
7982,12797,8535,49,4,1,3,1,0,1
7983,12797,8534,51,4,0,4,0,0,0
7984,12798,9876,45,5,4,1,1,0,1
7985,12798,8533,55,7,3,4,1,0,1
7986,12799,8543,31,9,5,4,2,1,1
7987,12799,8636,69,7,2,5,0,0,0
7988,12802,9882,53,9,4,5,1,0,1
7989,12802,8600,47,3,0,3,2,0,2
7990,12803,9880,54,9,2,7,1,1,0
7991,12803,7943,46,5,3,2,2,0,2
7992,12804,10233,54,6,6,0,2,1,1
7993,12804,9804,46,4,3,1,1,0,1
7994,12805,9875,62,4,1,3,5,3,2
7995,12805,9880,38,2,1,1,2,1,1
7996,12806,9804,54,16,8,8,1,1,0
7997,12806,8533,46,3,1,2,1,1,0
7998,12809,8636,65,11,6,5,2,1,1
7999,12809,9885,35,4,3,1,1,0,1
8000,12810,8543,54,3,2,1,1,0,1
8001,12810,9882,46,1,1,0,0,0,0
8002,12811,7943,41,4,1,3,1,1,0
8003,12811,8564,59,3,2,1,3,1,2
8004,12813,8535,66,9,4,5,3,1,2
8005,12813,10167,34,7,2,5,1,0,1
8006,12815,8533,43,8,2,6,4,3,1
8007,12815,8524,57,4,4,0,2,0,2
8008,12816,8529,57,4,1,3,1,0,1
8009,12816,9880,43,5,1,4,1,0,1
8010,12817,8540,47,3,2,1,2,0,2
8011,12817,8535,53,1,0,1,0,0,0
8012,12820,9875,43,11,4,7,2,1,1
8013,12820,9885,57,4,2,2,3,2,1
8014,12821,8543,62,9,4,5,2,0,2
8015,12821,8686,38,1,0,1,1,0,1
8016,12822,8534,53,11,7,4,3,0,3
8017,12822,9882,47,7,2,5,1,0,1
8018,12823,8600,58,9,3,6,2,1,1
8019,12823,7943,42,5,3,2,1,0,1
8020,12827,8636,60,9,6,3,1,0,1
8021,12827,8534,40,5,0,5,1,0,1
8022,12828,7943,37,6,3,3,1,1,0
8023,12828,10233,63,8,5,3,2,0,2
8024,12829,9876,38,6,3,3,1,0,1
8025,12829,9885,62,3,2,1,0,0,0
8026,12830,8564,55,3,3,0,2,1,1
8027,12830,8524,45,9,7,2,0,0,0
8028,12831,8686,58,2,1,1,2,2,0
8029,12831,8540,42,3,2,1,1,0,1
8030,12832,9882,60,8,3,5,3,1,2
8031,12832,10167,40,1,1,0,0,0,0
8032,12833,8600,47,4,3,1,3,1,2
8033,12833,8529,53,4,3,1,0,0,0
8034,12835,8534,45,5,2,3,2,1,1
8035,12835,8564,55,5,2,3,1,0,1
8036,12837,10233,46,5,4,1,4,3,1
8037,12837,9876,54,6,4,2,1,0,1
8038,12838,8636,45,6,2,4,1,1,0
8039,12838,8524,55,5,4,1,0,0,0
8040,12842,10167,35,4,2,2,5,1,4
8041,12842,8686,65,5,1,4,1,0,1
8042,12843,8533,40,3,1,2,1,1,0
8043,12843,9882,60,7,4,3,1,0,1
8044,12846,8533,43,7,5,2,3,1,2
8045,12846,8534,57,3,1,2,1,0,1
8046,12852,9804,43,7,5,2,1,0,1
8047,12852,8535,57,14,10,4,1,0,1
8048,12853,10167,61,11,5,6,2,1,1
8049,12853,8600,39,3,0,3,0,0,0
8050,12855,8535,46,7,4,3,2,1,1
8051,12855,8636,54,8,2,6,4,2,2
8052,12856,8529,45,8,7,1,3,1,2
8053,12856,9876,55,10,3,7,2,0,2
8054,12858,8543,53,7,2,5,2,0,2
8055,12858,7943,47,3,1,2,0,0,0
8056,12861,10233,48,6,5,1,2,1,1
8057,12861,10167,52,3,3,0,2,1,1
8058,12863,9880,47,4,2,2,3,2,1
8059,12863,8600,53,3,0,3,1,0,1
8060,12865,8529,58,3,2,1,2,2,0
8061,12865,9882,42,5,2,3,2,0,2
8062,12866,8543,42,6,3,3,3,1,2
8063,12866,8535,58,7,2,5,2,0,2
8064,12867,8534,53,5,3,2,3,3,0
8065,12867,10233,47,3,1,2,0,0,0
8066,12868,8564,49,4,2,2,1,0,1
8067,12868,9876,51,10,4,6,0,0,0
8068,12870,8540,54,3,1,2,1,1,0
8069,12870,9880,46,2,0,2,1,0,1
8070,12874,8636,68,8,1,7,1,0,1
8071,12874,9880,32,2,1,1,1,0,1
8072,12875,8533,37,5,3,2,2,1,1
8073,12875,10233,63,4,1,3,2,1,1
8074,12876,8529,45,9,6,3,1,0,1
8075,12876,8534,55,8,2,6,0,0,0
8076,12879,8564,48,7,2,5,1,0,1
8077,12879,8535,52,4,1,3,1,0,1
8078,12880,9875,70,14,11,3,1,0,1
8079,12880,9876,30,5,2,3,3,0,3
8080,12881,7943,47,5,2,3,3,1,2
8081,12881,10167,53,7,2,5,1,1,0
8082,12883,8524,59,8,3,5,2,2,0
8083,12883,8600,41,3,1,2,1,0,1
8084,12884,9875,76,7,4,3,2,2,0
8085,12884,8524,24,4,2,2,0,0,0
8086,12887,9885,57,5,3,2,6,3,3
8087,12887,10233,43,1,0,1,0,0,0
8088,12888,9876,42,4,2,2,3,1,2
8089,12888,8543,58,4,2,2,0,0,0
8090,12889,8636,63,8,4,4,6,3,3
8091,12889,9882,37,6,3,3,3,1,2
8092,12890,8533,46,7,3,4,1,0,1
8093,12890,8540,54,7,3,4,0,0,0
8094,12891,8686,73,7,3,4,3,3,0
8095,12891,9880,27,1,1,0,3,1,2
8096,12893,9804,51,7,2,5,4,2,2
8097,12893,10167,49,4,2,2,2,1,1
8098,12894,8534,56,9,8,1,2,2,0
8099,12894,8533,44,2,1,1,1,1,0
8100,12895,8535,59,9,6,3,3,2,1
8101,12895,8564,41,4,2,2,3,1,2
8102,12896,9891,46,5,3,2,2,1,1
8103,12896,9804,54,14,7,7,0,0,0
8104,12898,8636,68,10,4,6,1,1,0
8105,12898,8524,32,2,1,1,1,0,1
8106,12899,9885,66,15,6,9,2,0,2
8107,12899,8600,34,3,0,3,0,0,0
8108,12901,10233,55,4,4,0,5,2,3
8109,12901,8540,45,11,3,8,0,0,0
8110,12903,9875,57,9,3,6,2,1,1
8111,12903,7943,43,6,4,2,1,0,1
8112,12904,8524,48,4,2,2,3,2,1
8113,12904,8543,52,5,3,2,0,0,0
8114,12906,208931,49,5,2,3,3,3,0
8115,12906,9891,51,2,2,0,1,1,0
8116,12908,8533,46,4,3,1,1,0,1
8117,12908,8564,54,7,3,4,0,0,0
8118,12909,9875,67,11,5,6,2,1,1
8119,12909,8540,33,3,2,1,1,0,1
8120,12910,8686,63,9,4,5,2,1,1
8121,12910,8600,37,4,2,2,4,0,4
8122,12911,8534,51,10,7,3,1,1,0
8123,12911,9882,49,5,3,2,0,0,0
8124,12912,9885,63,7,2,5,1,1,0
8125,12912,7943,37,2,1,1,1,0,1
8126,12913,10233,54,2,2,0,1,0,1
8127,12913,9804,46,8,2,6,0,0,0
8128,12914,9857,45,2,2,0,3,1,2
8129,12914,8524,55,4,3,1,0,0,0
8130,12916,8533,49,4,1,3,4,1,3
8131,12916,9882,51,4,2,2,0,0,0
8132,12918,9875,57,12,4,8,2,1,1
8133,12918,10233,43,3,1,2,1,0,1
8134,12919,8686,60,11,4,7,2,2,0
8135,12919,8636,40,5,3,2,2,1,1
8136,12921,8564,39,2,2,0,3,2,1
8137,12921,8543,61,3,1,2,1,0,1
8138,12922,8534,52,7,5,2,1,1,0
8139,12922,8540,48,6,2,4,1,0,1
8140,12923,8600,49,6,4,2,1,0,1
8141,12923,7943,51,3,2,1,0,0,0
8142,12925,9891,48,9,5,4,1,1,0
8143,12925,10233,52,3,3,0,1,0,1
8144,12926,9876,57,8,5,3,1,0,1
8145,12926,9857,43,3,0,3,1,0,1
8146,12927,8564,41,5,3,2,3,2,1
8147,12927,8524,59,8,1,7,2,2,0
8148,12928,9875,59,11,5,6,3,1,2
8149,12928,8600,41,4,1,3,2,0,2
8150,12929,8533,46,7,2,5,4,1,3
8151,12929,8540,54,4,0,4,1,0,1
8152,12930,8686,45,4,3,1,4,1,3
8153,12930,8543,55,2,0,2,0,0,0
8154,12931,9882,42,3,2,1,2,1,1
8155,12931,8535,58,9,2,7,1,1,0
8156,12932,208931,41,3,3,0,4,2,2
8157,12932,7943,59,3,1,2,0,0,0
8158,12933,9804,48,9,2,7,2,0,2
8159,12933,8636,52,2,1,1,0,0,0
8160,12934,9804,38,6,4,2,5,2,3
8161,12934,8524,62,8,6,2,2,0,2
8162,12935,8686,52,10,4,6,1,1,0
8163,12935,9857,48,3,2,1,0,0,0
8164,12938,7943,53,5,3,2,2,0,2
8165,12938,10233,47,3,0,3,0,0,0
8166,12939,9875,72,7,2,5,1,1,0
8167,12939,9876,28,2,0,2,0,0,0
8168,12940,8636,64,12,6,6,2,0,2
8169,12940,9891,36,5,4,1,0,0,0
8170,12941,9885,55,6,3,3,4,1,3
8171,12941,8564,45,3,1,2,1,1,0
8172,12942,8543,63,8,8,0,1,1,0
8173,12942,8540,37,10,5,5,0,0,0
8174,12943,8600,39,4,2,2,2,1,1
8175,12943,9882,61,4,1,3,1,0,1
8176,12944,8533,48,4,4,0,2,2,0
8177,12944,8600,52,6,3,3,0,0,0
8178,12945,8534,37,2,1,1,1,0,1
8179,12945,8543,63,12,5,7,0,0,0
8180,12946,9876,47,12,7,5,1,1,0
8181,12946,9891,53,4,1,3,3,0,3
8182,12947,208931,48,5,2,3,1,0,1
8183,12947,10233,52,6,1,5,0,0,0
8184,12948,9882,43,5,3,2,2,1,1
8185,12948,8564,57,8,4,4,4,3,1
8186,12951,8686,59,10,4,6,1,1,0
8187,12951,8524,41,2,0,2,2,0,2
8188,12953,9804,61,7,5,2,3,1,2
8189,12953,9857,39,2,2,0,0,0,0
8190,12955,9857,32,2,1,1,3,0,3
8191,12955,9875,68,7,3,4,0,0,0
8192,12956,208931,39,6,4,2,4,2,2
8193,12956,8564,61,8,3,5,1,0,1
8194,12957,8535,57,5,3,2,2,2,0
8195,12957,8600,43,2,0,2,2,1,1
8196,12959,8534,43,5,4,1,2,1,1
8197,12959,9876,57,13,7,6,0,0,0
8198,12960,8636,63,6,5,1,1,1,0
8199,12960,10233,37,4,1,3,1,0,1
8200,12962,9882,56,4,2,2,2,0,2
8201,12962,7943,44,7,6,1,0,0,0
8202,12963,9804,40,4,2,2,4,1,3
8203,12963,8686,60,3,0,3,0,0,0
8204,12965,208931,34,6,2,4,2,0,2
8205,12965,8534,66,3,3,0,0,0,0
8206,12966,10233,67,13,8,5,1,0,1
8207,12966,9857,33,4,0,4,0,0,0
8208,12967,9885,39,7,3,4,2,1,1
8209,12967,8535,61,1,1,0,1,0,1
8210,12968,8543,57,3,3,0,3,1,2
8211,12968,9882,43,4,2,2,1,0,1
8212,12969,9876,44,4,3,1,2,2,0
8213,12969,8564,56,8,3,5,2,1,1
8214,12972,7943,58,6,3,3,1,0,1
8215,12972,9804,42,3,1,2,0,0,0
8216,12973,8636,45,4,2,2,2,1,1
8217,12973,8600,55,12,8,4,0,0,0
8218,12974,8524,47,10,5,5,3,3,0
8219,12974,9875,53,5,3,2,1,0,1
8220,12975,8534,47,9,4,5,2,1,1
8221,12975,9857,53,5,0,5,2,1,1
8222,12976,9885,71,4,4,0,1,1,0
8223,12976,208931,29,5,2,3,3,1,2
8224,12977,8535,66,8,4,4,2,0,2
8225,12977,8533,34,6,0,6,0,0,0
8226,12978,9891,30,7,4,3,1,1,0
8227,12978,8564,70,14,9,5,3,1,2
8228,12980,8543,35,5,3,2,1,1,0
8229,12980,8636,65,4,3,1,1,0,1
8230,12982,8540,40,5,2,3,2,0,2
8231,12982,9882,60,7,4,3,0,0,0
8232,12983,8600,49,7,4,3,5,3,2
8233,12983,9804,51,3,2,1,4,1,3
8234,12984,8533,56,5,2,3,1,0,1
8235,12984,8686,44,4,2,2,0,0,0
8236,12986,9882,40,4,2,2,3,1,2
8237,12986,10233,60,13,3,10,1,1,0
8238,12988,208931,36,1,0,1,4,1,3
8239,12988,8543,64,4,0,4,2,1,1
8240,12989,9857,46,3,1,2,2,1,1
8241,12989,8564,54,13,6,7,0,0,0
8242,12990,9875,60,8,4,4,6,4,2
8243,12990,9804,40,3,2,1,1,0,1
8244,12992,7943,60,11,2,9,2,1,1
8245,12992,9891,40,1,0,1,1,0,1
8246,12993,8600,48,7,3,4,2,2,0
8247,12993,8524,52,11,3,8,0,0,0
8248,12994,8524,54,5,2,3,1,1,0
8249,12994,10233,46,1,1,0,2,1,1
8250,12995,9857,56,5,1,4,2,1,1
8251,12995,8533,44,4,1,3,1,0,1
8252,12996,208931,40,7,5,2,3,1,2
8253,12996,8600,60,4,1,3,0,0,0
8254,12999,9876,59,12,5,7,2,1,1
8255,12999,8540,41,5,2,3,2,1,1
8256,13000,7943,42,9,6,3,2,1,1
8257,13000,8636,58,14,1,13,0,0,0
8258,13001,8686,47,5,3,2,2,0,2
8259,13001,8564,53,8,6,2,0,0,0
8260,13002,9885,51,5,2,3,2,0,2
8261,13002,9882,49,3,1,2,0,0,0
8262,13004,8524,61,8,4,4,5,2,3
8263,13004,9891,39,5,2,3,0,0,0
8264,13005,7943,54,5,1,4,1,1,0
8265,13005,9857,46,6,3,3,3,2,1
8266,13006,208931,30,4,3,1,2,1,1
8267,13006,8636,70,4,3,1,1,0,1
8268,13008,10233,54,7,2,5,2,0,2
8269,13008,9876,46,3,0,3,0,0,0
8270,13009,8534,49,9,2,7,3,1,2
8271,13009,8564,51,2,1,1,0,0,0
8272,13013,8600,60,10,4,6,4,1,3
8273,13013,8540,40,3,2,1,0,0,0
8274,13014,8534,63,7,1,6,1,0,1
8275,13014,8533,37,4,2,2,0,0,0
8276,13015,8535,69,3,1,2,4,1,3
8277,13015,8564,31,1,0,1,0,0,0
8278,13016,9804,52,10,5,5,2,1,1
8279,13016,9891,48,7,3,4,1,0,1
8280,13017,8686,69,6,1,5,3,1,2
8281,13017,9876,31,4,3,1,1,0,1
8282,13019,8600,38,3,1,2,3,1,2
8283,13019,9885,62,6,2,4,1,0,1
8284,13022,9882,61,7,4,3,2,0,2
8285,13022,208931,39,7,3,4,0,0,0
8286,13023,9875,66,7,3,4,1,0,1
8287,13023,7943,34,5,4,1,1,0,1
8288,13024,9891,48,5,3,2,1,1,0
8289,13024,8524,52,6,2,4,2,0,2
8290,13026,8636,70,9,4,5,2,0,2
8291,13026,208931,30,7,6,1,1,0,1
8292,13027,8533,38,4,3,1,2,2,0
8293,13027,8543,62,6,6,0,2,0,2
8294,13028,10233,53,4,3,1,1,1,0
8295,13028,9876,47,10,2,8,3,0,3
8296,13029,8534,62,8,5,3,2,0,2
8297,13029,8564,38,5,3,2,0,0,0
8298,13032,9804,47,5,2,3,1,1,0
8299,13032,8535,53,4,1,3,2,2,0
8300,13036,9891,32,5,1,4,1,1,0
8301,13036,8686,68,8,6,2,0,0,0
8302,13038,8636,51,6,4,2,2,1,1
8303,13038,8564,49,5,0,5,2,0,2
8304,13042,9857,43,2,1,1,1,0,1
8305,13042,9882,57,5,1,4,0,0,0
8306,13043,7943,54,3,2,1,3,0,3
8307,13043,8524,46,3,1,2,0,0,0
8308,13044,8524,52,9,5,4,1,0,1
8309,13044,9876,48,2,0,2,0,0,0
8310,13046,208931,31,2,2,0,2,1,1
8311,13046,8535,69,4,3,1,0,0,0
8312,13047,8636,62,10,6,4,1,0,1
8313,13047,8533,38,5,1,4,1,0,1
8314,13049,8564,60,11,8,3,3,2,1
8315,13049,8540,40,6,1,5,0,0,0
8316,13050,9875,59,4,2,2,2,2,0
8317,13050,8543,41,2,0,2,3,0,3
8318,13051,7943,46,10,2,8,1,0,1
8319,13051,8686,54,8,4,4,0,0,0
8320,13052,9804,53,3,2,1,2,0,2
8321,13052,9882,47,3,2,1,0,0,0
8322,13054,9875,74,8,4,4,1,1,0
8323,13054,208931,26,0,0,0,0,0,0
8324,13055,9804,52,9,5,4,1,0,1
8325,13055,8533,48,4,1,3,1,0,1
8326,13056,8534,51,4,4,0,3,2,1
8327,13056,8524,49,6,6,0,1,0,1
8328,13057,9857,48,9,4,5,1,1,0
8329,13057,8535,52,3,3,0,3,0,3
8330,13058,8636,70,7,4,3,3,2,1
8331,13058,9876,30,3,1,2,1,0,1
8332,13060,8543,49,2,1,1,1,1,0
8333,13060,10233,51,4,1,3,3,1,2
8334,13061,7943,64,9,3,6,3,1,2
8335,13061,8540,36,2,2,0,0,0,0
8336,13062,8686,58,4,3,1,3,1,2
8337,13062,9882,42,6,1,5,3,0,3
8338,13063,8564,63,14,7,7,3,1,2
8339,13063,8600,37,6,3,3,1,1,0
8340,13064,8524,46,7,3,4,2,1,1
8341,13064,9882,54,3,1,2,2,1,1
8342,13065,9857,47,5,3,2,1,1,0
8343,13065,8600,53,3,1,2,0,0,0
8344,13066,8534,70,15,9,6,1,1,0
8345,13066,9891,30,0,0,0,1,0,1
8346,13067,8564,58,6,2,4,1,0,1
8347,13067,10233,42,2,1,1,1,0,1
8348,13069,8535,62,8,4,4,5,2,3
8349,13069,8636,38,1,0,1,1,0,1
8350,13072,7943,57,6,3,3,3,1,2
8351,13072,8533,43,5,3,2,0,0,0
8352,13073,8540,52,9,2,7,2,0,2
8353,13073,9804,48,9,0,9,2,0,2
8354,13074,9804,59,7,4,3,1,1,0
8355,13074,208931,41,1,1,0,1,0,1
8356,13075,8533,51,5,1,4,2,0,2
8357,13075,9876,49,8,4,4,1,0,1
8358,13078,9885,60,4,2,2,2,0,2
8359,13078,9857,40,2,2,0,0,0,0
8360,13079,9891,34,4,1,3,3,2,1
8361,13079,8543,66,7,1,6,0,0,0
8362,13080,8564,35,3,1,2,3,1,2
8363,13080,9875,65,7,2,5,0,0,0
8364,13082,9882,56,6,4,2,2,1,1
8365,13082,8636,44,0,0,0,1,1,0
8366,13084,8524,57,4,2,2,2,0,2
8367,13084,208931,43,4,1,3,0,0,0
8368,13085,9857,53,7,3,4,2,1,1
8369,13085,8540,47,5,2,3,0,0,0
8370,13087,8533,48,10,3,7,1,1,0
8371,13087,10233,52,8,4,4,1,1,0
8372,13089,9885,49,4,4,0,1,1,0
8373,13089,8636,51,4,1,3,2,1,1
8374,13091,8686,52,5,2,3,1,1,0
8375,13091,8534,48,5,3,2,4,3,1
8376,13092,8543,59,4,1,3,1,0,1
8377,13092,7943,41,4,1,3,0,0,0
8378,13093,9804,45,6,3,3,4,1,3
8379,13093,8564,55,8,5,3,0,0,0
8380,13096,10233,46,6,5,1,6,3,3
8381,13096,8534,54,3,0,3,2,2,0
8382,13097,8535,49,3,1,2,2,1,1
8383,13097,8686,51,3,0,3,2,0,2
8384,13098,9885,60,3,2,1,1,0,1
8385,13098,8524,40,7,3,4,1,0,1
8386,13099,9804,37,5,3,2,1,1,0
8387,13099,8543,63,4,1,3,3,0,3
8388,13102,9882,53,7,6,1,2,1,1
8389,13102,9876,47,6,3,3,0,0,0
8390,13103,9891,43,3,1,2,3,2,1
8391,13103,8600,57,3,2,1,1,0,1
8392,13104,8524,49,5,4,1,2,2,0
8393,13104,8543,51,0,0,0,1,0,1
8394,13105,9857,45,2,1,1,2,2,0
8395,13105,8636,55,3,3,0,3,1,2
8396,13109,9875,66,8,2,6,2,0,2
8397,13109,8540,34,5,3,2,1,0,1
8398,13111,9882,40,7,5,2,1,1,0
8399,13111,8534,60,10,5,5,1,0,1
8400,13114,8534,42,5,4,1,3,2,1
8401,13114,9875,58,7,3,4,1,0,1
8402,13115,8535,49,4,3,1,2,1,1
8403,13115,10233,51,8,2,6,0,0,0
8404,13116,8686,57,7,5,2,1,1,0
8405,13116,9891,43,7,1,6,1,0,1
8406,13118,8564,49,9,6,3,3,0,3
8407,13118,8636,51,7,4,3,0,0,0
8408,13122,9857,44,5,4,1,1,1,0
8409,13122,9882,56,5,2,3,0,0,0
8410,13123,7943,61,7,3,4,5,2,3
8411,13123,8524,39,3,2,1,1,1,0
8412,13126,9882,65,11,3,8,4,2,2
8413,13126,8533,35,5,4,1,0,0,0
8414,13127,8535,69,14,6,8,3,1,2
8415,13127,9891,31,7,3,4,1,1,0
8416,13130,9885,58,6,4,2,2,1,1
8417,13130,9804,42,7,2,5,2,0,2
8418,13133,7943,62,9,4,5,6,3,3
8419,13133,8600,38,2,2,0,0,0,0
8420,13136,9857,61,6,2,4,3,2,1
8421,13136,9876,39,1,0,1,1,0,1
8422,13137,8564,52,6,2,4,2,1,1
8423,13137,8524,48,5,2,3,1,1,0
8424,13139,8540,49,6,3,3,1,1,0
8425,13139,8533,51,2,2,0,2,2,0
8426,13140,8543,42,5,2,3,1,1,0
8427,13140,8686,58,3,1,2,1,1,0
8428,13142,7943,58,5,3,2,2,2,0
8429,13142,208931,42,1,0,1,0,0,0
8430,13145,8686,65,4,3,1,2,1,1
8431,13145,9857,35,4,1,3,0,0,0
8432,13146,8533,65,6,3,3,3,2,1
8433,13146,208931,35,5,1,4,1,0,1
8434,13147,8535,60,13,4,9,2,2,0
8435,13147,8534,40,4,0,4,2,0,2
8436,13151,8564,43,5,3,2,1,1,0
8437,13151,9885,57,3,3,0,2,0,2
8438,13152,8543,68,8,5,3,2,2,0
8439,13152,8540,32,5,0,5,3,0,3
8440,13153,9882,52,5,3,2,1,1,0
8441,13153,8600,48,7,1,6,0,0,0
8442,13155,8543,47,6,2,4,1,0,1
8443,13155,8534,53,2,2,0,0,0,0
8444,13156,9876,57,8,3,5,3,1,2
8445,13156,9891,43,3,3,0,0,0,0
8446,13157,208931,49,6,3,3,2,1,1
8447,13157,10233,51,7,3,4,1,1,0
8448,13158,8564,57,7,6,1,5,1,4
8449,13158,9882,43,4,3,1,0,0,0
8450,13159,9875,64,5,4,1,1,1,0
8451,13159,8636,36,7,2,5,1,0,1
8452,13160,9885,63,3,2,1,3,1,2
8453,13160,8540,37,6,3,3,0,0,0
8454,13162,8535,52,5,4,1,2,2,0
8455,13162,7943,48,2,0,2,1,1,0
8456,13163,9804,47,2,2,0,1,1,0
8457,13163,9857,53,3,1,2,1,1,0
8458,13164,8524,49,3,1,2,1,0,1
8459,13164,8540,51,9,0,9,1,0,1
8460,13166,8564,76,11,4,7,1,0,1
8461,13166,208931,24,2,0,2,0,0,0
8462,13167,8535,62,5,3,2,5,5,0
8463,13167,8600,38,3,1,2,2,0,2
8464,13168,8533,63,8,4,4,5,3,2
8465,13168,9891,37,1,1,0,1,1,0
8466,13169,8534,59,8,6,2,3,2,1
8467,13169,9876,41,10,3,7,0,0,0
8468,13170,8636,63,5,3,2,2,1,1
8469,13170,10233,37,7,3,4,1,0,1
8470,13171,9885,56,11,6,5,1,1,0
8471,13171,8543,44,3,3,0,0,0,0
8472,13172,7943,64,7,1,6,1,1,0
8473,13172,9882,36,2,1,1,0,0,0
8474,13173,9804,49,5,1,4,3,1,2
8475,13173,8686,51,7,6,1,2,0,2
8476,13174,8524,44,10,3,7,2,1,1
8477,13174,8533,56,5,1,4,2,1,1
8478,13176,9857,40,7,3,4,1,0,1
8479,13176,10233,60,4,3,1,0,0,0
8480,13177,8535,55,11,4,7,1,1,0
8481,13177,9885,45,1,0,1,1,0,1
8482,13178,9882,44,6,2,4,3,2,1
8483,13178,8543,56,6,3,3,2,1,1
8484,13180,8686,48,3,3,0,1,1,0
8485,13180,9875,52,4,2,2,0,0,0
8486,13181,8540,46,1,1,0,2,2,0
8487,13181,9891,54,6,1,5,1,0,1
8488,13183,8636,60,13,6,7,1,1,0
8489,13183,8600,40,6,2,4,4,2,2
8490,13184,9875,59,10,5,5,3,1,2
8491,13184,8524,41,1,0,1,0,0,0
8492,13186,9885,71,7,5,2,3,1,2
8493,13186,208931,29,3,1,2,1,0,1
8494,13187,8535,55,9,5,4,2,2,0
8495,13187,8533,45,6,2,4,3,2,1
8496,13188,9891,27,4,1,3,3,3,0
8497,13188,8564,73,12,8,4,3,0,3
8498,13189,7943,55,2,1,1,4,2,2
8499,13189,9876,45,3,2,1,0,0,0
8500,13191,10233,41,6,4,2,1,0,1
8501,13191,8686,59,7,4,3,1,0,1
8502,13192,8540,39,6,3,3,4,3,1
8503,13192,9882,61,5,5,0,3,1,2
8504,13194,8686,61,13,6,7,3,0,3
8505,13194,8533,39,8,4,4,0,0,0
8506,13195,8636,47,6,5,1,2,1,1
8507,13195,8534,53,4,2,2,0,0,0
8508,13196,10233,44,7,6,1,3,2,1
8509,13196,9882,56,5,2,3,1,0,1
8510,13197,9876,41,6,2,4,1,1,0
8511,13197,9885,59,9,1,8,0,0,0
8512,13198,208931,53,10,1,9,1,1,0
8513,13198,8543,47,7,5,2,2,0,2
8514,13199,8564,57,6,3,3,1,1,0
8515,13199,9857,43,3,1,2,0,0,0
8516,13200,9875,60,7,6,1,1,1,0
8517,13200,9804,40,5,3,2,0,0,0
8518,13201,8535,60,11,6,5,3,1,2
8519,13201,8540,40,2,2,0,2,0,2
8520,13203,8524,64,5,5,0,3,2,1
8521,13203,8600,36,1,1,0,1,1,0
8522,13204,10233,54,4,1,3,1,0,1
8523,13204,8524,46,4,3,1,1,0,1
8524,13205,9857,52,8,4,4,1,1,0
8525,13205,8533,48,4,2,2,0,0,0
8526,13207,8535,56,6,5,1,5,4,1
8527,13207,8543,44,6,0,6,1,1,0
8528,13208,9891,26,5,2,3,2,1,1
8529,13208,9875,74,16,12,4,2,0,2
8530,13209,9876,63,4,2,2,3,1,2
8531,13209,8540,37,0,0,0,2,0,2
8532,13210,8636,53,5,4,1,1,1,0
8533,13210,7943,47,2,0,2,3,0,3
8534,13211,8564,35,8,3,5,1,1,0
8535,13211,8686,65,8,2,6,1,1,0
8536,13212,9882,31,3,2,1,1,0,1
8537,13212,9885,69,8,3,5,0,0,0
8538,13215,9891,58,7,2,5,5,3,2
8539,13215,9857,42,7,6,1,0,0,0
8540,13217,8533,45,5,4,1,1,1,0
8541,13217,8636,55,4,2,2,4,1,3
8542,13219,8564,55,7,5,2,1,1,0
8543,13219,8540,45,3,1,2,0,0,0
8544,13220,9875,64,6,4,2,4,3,1
8545,13220,8543,36,3,0,3,3,3,0
8546,13221,7943,34,9,5,4,1,0,1
8547,13221,8686,66,10,5,5,1,0,1
8548,13223,8600,42,2,2,0,3,3,0
8549,13223,8534,58,5,1,4,4,3,1
8550,13225,9804,56,2,1,1,2,2,0
8551,13225,8533,44,5,1,4,2,1,1
8552,13226,8524,53,6,3,3,2,1,1
8553,13226,8534,47,4,1,3,4,0,4
8554,13228,8636,62,15,12,3,1,1,0
8555,13228,9876,38,5,2,3,0,0,0
8556,13229,9885,70,16,5,11,1,1,0
8557,13229,9891,30,3,1,2,1,0,1
8558,13230,8543,57,4,3,1,1,1,0
8559,13230,10233,43,4,3,1,1,1,0
8560,13232,9882,37,5,1,4,1,0,1
8561,13232,8686,63,17,4,13,2,0,2
8562,13235,8600,53,4,1,3,2,0,2
8563,13235,9857,47,5,2,3,0,0,0
8564,13240,9875,54,4,1,3,2,1,1
8565,13240,9885,46,5,1,4,3,1,2
8566,13241,8686,69,6,4,2,3,2,1
8567,13241,208931,31,8,1,7,2,1,1
8568,13242,7943,55,8,1,7,1,0,1
8569,13242,8533,45,5,4,1,0,0,0
8570,13243,9804,52,6,2,4,3,2,1
8571,13243,8540,48,2,0,2,1,0,1
8572,13246,8534,54,6,2,4,2,1,1
8573,13246,7943,46,2,0,2,2,0,2
8574,13248,9885,66,6,3,3,3,2,1
8575,13248,9857,34,0,0,0,3,2,1
8576,13250,8564,40,8,4,4,5,2,3
8577,13250,9875,60,6,3,3,0,0,0
8578,13251,8540,39,4,1,3,2,0,2
8579,13251,8686,61,7,3,4,0,0,0
8580,13252,9882,33,6,5,1,1,1,0
8581,13252,8636,67,10,4,6,2,0,2
8582,13256,9882,61,5,3,2,2,0,2
8583,13256,9891,39,7,6,1,0,0,0
8584,13257,10233,45,5,4,1,2,0,2
8585,13257,8533,55,9,3,6,1,0,1
8586,13260,8535,53,5,4,1,1,1,0
8587,13260,9875,47,6,2,4,2,0,2
8588,13261,8686,57,5,5,0,6,6,0
8589,13261,8534,43,7,3,4,1,1,0
8590,13262,7943,42,7,1,6,1,0,1
8591,13262,8543,58,5,2,3,0,0,0
8592,13263,8564,53,3,1,2,1,1,0
8593,13263,9804,47,3,0,3,2,1,1
8594,13264,208931,41,4,4,0,2,2,0
8595,13264,9857,59,4,2,2,2,1,1
8596,13265,9875,62,5,3,2,1,1,0
8597,13265,8533,38,2,0,2,1,0,1
8598,13266,8534,48,5,3,2,1,1,0
8599,13266,10233,52,7,3,4,1,0,1
8600,13267,8686,28,2,1,1,2,1,1
8601,13267,8535,72,7,2,5,1,0,1
8602,13268,9885,69,8,6,2,2,2,0
8603,13268,8524,31,1,1,0,1,0,1
8604,13269,8543,54,3,3,0,4,1,3
8605,13269,9804,46,3,2,1,2,1,1
8606,13270,7943,45,2,2,0,3,1,2
8607,13270,8564,55,7,0,7,2,2,0
8608,13272,9882,46,4,3,1,6,3,3
8609,13272,9876,54,5,1,4,1,1,0
8610,13273,8600,52,12,5,7,4,2,2
8611,13273,9891,48,5,3,2,1,1,0
8612,13612,8593,56,10,4,6,6,4,2
8613,13612,10235,44,3,1,2,0,0,0
8614,13694,10235,55,6,3,3,2,1,1
8615,13694,8593,45,8,3,5,0,0,0
8616,14119,8640,45,10,5,5,2,0,2
8617,14119,10235,55,8,5,3,0,0,0
8618,14206,8593,58,4,3,1,3,1,2
8619,14206,10235,42,7,3,4,0,0,0
8620,14251,8640,54,8,3,5,4,2,2
8621,14251,10235,46,9,3,6,2,1,1
8622,14287,10235,42,9,6,3,1,0,1
8623,14287,8593,58,5,2,3,0,0,0
8624,14334,8640,55,9,7,2,5,2,3
8625,14334,10235,45,8,4,4,2,0,2
8626,14368,8593,63,5,4,1,1,0,1
8627,14368,8640,37,1,0,1,0,0,0
8628,14467,8593,54,6,2,4,1,0,1
8629,14467,8640,46,8,2,6,1,0,1
8630,15416,10228,51,8,3,5,2,1,1
8631,15416,8526,49,6,2,4,0,0,0
8632,15417,7788,65,11,7,4,2,1,1
8633,15417,6413,35,4,3,1,0,0,0
8634,15420,10235,44,3,2,1,3,1,2
8635,15420,9908,56,6,2,4,2,0,2
8636,15421,8593,57,6,3,3,1,1,0
8637,15421,10229,43,7,4,3,1,0,1
8638,15422,10218,44,2,1,1,2,1,1
8639,15422,8464,56,4,3,1,0,0,0
8640,15423,8674,63,11,7,4,1,1,0
8641,15423,8611,37,2,0,2,3,1,2
8642,15424,8277,51,8,5,3,2,1,1
8643,15424,8525,49,5,4,1,0,0,0
8644,15425,6413,55,3,3,0,1,0,1
8645,15425,9908,45,3,1,2,0,0,0
8646,15427,8526,38,7,6,1,2,0,2
8647,15427,9791,62,5,3,2,1,0,1
8648,15430,7788,57,11,6,5,3,1,2
8649,15430,10217,43,8,1,7,3,1,2
8650,15431,8277,48,8,7,1,4,2,2
8651,15431,8593,52,7,4,3,0,0,0
8652,15433,10235,61,7,3,4,2,2,0
8653,15433,10229,39,11,3,8,1,0,1
8654,15434,8525,57,2,2,0,2,1,1
8655,15434,9791,43,5,2,3,4,1,3
8656,15435,6413,58,9,3,6,2,1,1
8657,15435,8674,42,2,1,1,2,2,0
8658,15436,9803,35,2,2,0,2,1,1
8659,15436,8593,65,9,0,9,2,0,2
8660,15437,8277,68,4,3,1,3,0,3
8661,15437,10218,32,12,4,8,0,0,0
8662,15438,8640,64,12,9,3,2,1,1
8663,15438,8526,36,8,1,7,0,0,0
8664,15439,10235,61,9,2,7,1,1,0
8665,15439,10217,39,2,1,1,0,0,0
8666,15441,9908,52,3,2,1,2,1,1
8667,15441,8611,48,9,0,9,6,3,3
8668,15442,10229,56,14,6,8,3,1,2
8669,15442,8464,44,3,0,3,0,0,0
8670,15443,10217,60,7,3,4,1,1,0
8671,15443,9803,40,1,0,1,3,1,2
8672,15444,10228,38,5,3,2,3,3,0
8673,15444,8611,62,2,2,0,3,0,3
8674,15445,8526,41,8,1,7,4,3,1
8675,15445,8464,59,2,1,1,3,1,2
8676,15447,6413,61,10,6,4,3,2,1
8677,15447,9791,39,5,0,5,0,0,0
8678,15451,10229,48,8,2,6,1,1,0
8679,15451,8277,52,3,2,1,2,1,1
8680,15453,9803,63,11,4,7,1,1,0
8681,15453,6413,37,4,2,2,2,1,1
8682,15456,8526,42,10,8,2,2,1,1
8683,15456,8674,58,2,2,0,2,0,2
8684,15457,10218,43,6,3,3,3,1,2
8685,15457,9791,57,9,1,8,2,0,2
8686,15462,10228,68,10,6,4,1,1,0
8687,15462,9803,32,1,0,1,0,0,0
8688,15464,8525,42,7,6,1,1,1,0
8689,15464,8611,58,11,6,5,3,1,2
8690,15465,8277,57,3,3,0,1,1,0
8691,15465,8464,43,8,3,5,2,0,2
8692,15467,8674,61,7,4,3,1,1,0
8693,15467,10217,39,2,0,2,2,1,1
8694,15468,9791,54,5,2,3,3,2,1
8695,15468,9908,46,4,1,3,2,0,2
8696,15470,10229,60,6,3,3,2,0,2
8697,15470,10217,40,6,2,4,0,0,0
8698,15471,8611,52,12,7,5,1,1,0
8699,15471,10218,48,3,1,2,2,0,2
8700,15473,8277,55,7,4,3,2,2,0
8701,15473,8640,45,7,2,5,2,2,0
8702,15475,8525,43,6,1,5,3,2,1
8703,15475,7788,57,4,0,4,1,0,1
8704,15476,10235,55,7,5,2,2,1,1
8705,15476,9791,45,3,1,2,0,0,0
8706,15478,9803,46,8,2,6,4,3,1
8707,15478,8674,54,5,1,4,2,2,0
8708,15479,10218,44,7,3,4,1,0,1
8709,15479,10228,56,13,5,8,1,0,1
8710,15480,8611,48,9,5,4,3,2,1
8711,15480,8526,52,8,0,8,2,1,1
8712,15481,8464,44,2,1,1,3,0,3
8713,15481,7788,56,3,2,1,0,0,0
8714,15483,10217,31,10,4,6,2,1,1
8715,15483,8525,69,1,0,1,1,0,1
8716,15484,8593,64,6,6,0,3,2,1
8717,15484,9908,36,4,3,1,2,1,1
8718,15486,10235,51,5,3,2,1,0,1
8719,15486,8674,49,9,2,7,0,0,0
8720,15487,8277,54,4,2,2,2,0,2
8721,15487,9791,46,6,1,5,0,0,0
8722,15491,6413,38,8,3,5,3,2,1
8723,15491,8640,62,5,1,4,0,0,0
8724,15492,9908,59,7,4,3,3,1,2
8725,15492,10229,41,4,0,4,2,1,1
8726,15493,7788,60,5,2,3,2,1,1
8727,15493,10218,40,3,0,3,0,0,0
8728,15494,10228,62,12,6,6,3,2,1
8729,15494,10217,38,5,1,4,2,0,2
8730,15496,8593,68,11,5,6,4,3,1
8731,15496,8526,32,5,3,2,2,1,1
8732,15497,8611,41,2,2,0,3,3,0
8733,15497,9791,59,5,4,1,1,0,1
8734,15498,8277,43,4,2,2,1,1,0
8735,15498,7788,57,4,2,2,2,1,1
8736,15499,10228,44,4,2,2,1,0,1
8737,15499,6413,56,8,3,5,1,0,1
8738,15500,10229,33,3,2,1,3,2,1
8739,15500,9803,67,7,1,6,1,0,1
8740,15501,10218,51,4,3,1,4,1,3
8741,15501,8526,49,2,1,1,0,0,0
8742,15502,8593,58,6,2,4,1,0,1
8743,15502,10217,42,6,1,5,0,0,0
8744,15503,10235,61,4,2,2,1,0,1
8745,15503,8640,39,6,2,4,0,0,0
8746,15504,8674,48,6,4,2,2,1,1
8747,15504,9908,52,9,4,5,1,0,1
8748,15505,8464,47,6,5,1,1,1,0
8749,15505,8525,53,7,2,5,1,1,0
8750,15506,8464,47,7,3,4,2,1,1
8751,15506,8674,53,9,3,6,3,1,2
8752,15507,8526,45,2,1,1,4,0,4
8753,15507,9791,55,3,1,2,0,0,0
8754,15508,8277,58,7,3,4,3,1,2
8755,15508,8593,42,5,1,4,1,1,0
8756,15509,10218,49,6,5,1,5,1,4
8757,15509,9803,51,5,2,3,2,0,2
8758,15510,10228,55,7,3,4,2,0,2
8759,15510,8525,45,6,4,2,2,0,2
8760,15512,6413,46,7,5,2,1,1,0
8761,15512,9908,54,10,4,6,0,0,0
8762,15513,8611,45,6,1,5,1,1,0
8763,15513,8640,55,7,3,4,2,0,2
8764,15514,10217,42,4,1,3,1,1,0
8765,15514,7788,58,3,0,3,0,0,0
8766,15515,8277,73,7,3,4,2,2,0
8767,15515,9803,27,4,2,2,1,0,1
8768,15516,8526,58,8,6,2,2,2,0
8769,15516,6413,42,3,1,2,1,1,0
8770,15518,8611,53,6,3,3,2,0,2
8771,15518,10217,47,1,0,1,0,0,0
8772,15519,10229,57,4,1,3,6,4,2
8773,15519,10218,43,4,1,3,0,0,0
8774,15520,8674,46,7,5,2,2,1,1
8775,15520,8640,54,8,3,5,1,0,1
8776,15524,8674,46,3,1,2,1,1,0
8777,15524,8525,54,4,2,2,1,0,1
8778,15525,8593,64,8,2,6,2,0,2
8779,15525,9791,36,1,1,0,0,0,0
8780,15527,8464,46,5,3,2,2,2,0
8781,15527,8611,54,12,3,9,1,0,1
8782,15529,8640,55,5,3,2,4,3,1
8783,15529,10218,45,2,1,1,1,0,1
8784,15530,8277,69,4,3,1,1,1,0
8785,15530,6413,31,4,0,4,1,0,1
8786,15531,9803,48,8,4,4,3,2,1
8787,15531,9908,52,7,3,4,1,1,0
8788,15532,10235,60,8,4,4,2,1,1
8789,15532,10228,40,8,1,7,0,0,0
8790,15534,8277,68,10,5,5,3,1,2
8791,15534,10218,32,7,2,5,2,1,1
8792,15535,8674,45,6,4,2,1,0,1
8793,15535,6413,55,8,6,2,3,0,3
8794,15538,8593,57,2,2,0,5,2,3
8795,15538,9803,43,3,2,1,1,0,1
8796,15539,10228,41,7,4,3,1,1,0
8797,15539,7788,59,3,0,3,0,0,0
8798,15540,10235,65,9,2,7,3,2,1
8799,15540,10217,35,1,1,0,0,0,0
8800,15541,8611,42,7,4,3,1,0,1
8801,15541,9908,58,5,1,4,1,0,1
8802,15543,10217,54,5,1,4,4,0,4
8803,15543,9803,46,6,1,5,0,0,0
8804,15544,8611,46,4,2,2,3,2,1
8805,15544,10228,54,1,1,0,0,0,0
8806,15546,9791,48,7,5,2,3,1,2
8807,15546,6413,52,2,2,0,0,0,0
8808,15547,10235,36,6,4,2,1,1,0
8809,15547,8593,64,3,2,1,1,1,0
8810,15548,8464,58,11,5,6,4,2,2
8811,15548,8526,42,3,2,1,2,1,1
8812,15551,7788,41,5,5,0,5,4,1
8813,15551,9908,59,7,3,4,2,1,1
8814,15552,9791,64,6,4,2,2,0,2
8815,15552,10229,36,6,1,5,0,0,0
8816,15553,8525,65,13,7,6,3,2,1
8817,15553,8526,35,2,1,1,1,0,1
8818,15554,9803,55,4,2,2,2,1,1
8819,15554,8611,45,3,2,1,1,0,1
8820,15557,6413,45,5,5,0,1,1,0
8821,15557,10235,55,11,4,7,0,0,0
8822,15558,10217,51,4,1,3,2,1,1
8823,15558,10218,49,7,4,3,0,0,0
8824,15560,6413,38,5,0,5,3,2,1
8825,15560,10217,62,3,0,3,0,0,0
8826,15561,10229,46,6,4,2,3,1,2
8827,15561,8674,54,4,1,3,2,2,0
8828,15562,10228,59,7,4,3,1,1,0
8829,15562,8464,41,5,1,4,2,2,0
8830,15563,8640,54,10,7,3,2,2,0
8831,15563,9791,46,3,3,0,0,0,0
8832,15564,7788,55,4,3,1,2,1,1
8833,15564,8611,45,6,2,4,1,0,1
8834,15566,8525,46,1,1,0,1,1,0
8835,15566,9908,54,6,1,5,1,1,0
8836,15567,8593,62,13,5,8,3,0,3
8837,15567,10218,38,4,1,3,0,0,0
8838,15568,8277,64,6,2,4,2,2,0
8839,15568,8526,36,8,5,3,2,1,1
8840,15569,10218,39,6,2,4,1,1,0
8841,15569,8464,61,3,3,0,0,0,0
8842,15571,6413,32,6,3,3,1,1,0
8843,15571,7788,68,7,1,6,0,0,0
8844,15572,8640,63,9,5,4,1,1,0
8845,15572,10217,37,3,1,2,1,0,1
8846,15574,9803,39,6,4,2,2,2,0
8847,15574,9791,61,4,3,1,1,1,0
8848,15576,9908,53,11,5,6,6,2,4
8849,15576,10235,47,4,0,4,2,1,1
8850,15578,8611,58,6,2,4,4,2,2
8851,15578,10217,42,1,1,0,1,0,1
8852,15580,10229,63,11,3,8,1,1,0
8853,15580,10218,37,3,0,3,3,1,2
8854,15581,8640,55,8,3,5,2,1,1
8855,15581,8674,45,2,1,1,1,0,1
8856,15582,9908,53,5,4,1,1,0,1
8857,15582,10228,47,4,1,3,0,0,0
8858,15583,8464,60,7,2,5,4,3,1
8859,15583,9791,40,2,1,1,0,0,0
8860,15584,8525,45,8,4,4,1,1,0
8861,15584,8593,55,8,7,1,0,0,0
8862,15585,8277,62,8,3,5,5,2,3
8863,15585,9803,38,3,1,2,1,0,1
8864,15586,10235,52,7,3,4,1,1,0
8865,15586,7788,48,3,0,3,4,1,3
8866,15587,9803,54,11,2,9,3,0,3
8867,15587,8526,46,7,0,7,1,0,1
8868,15588,10229,49,9,2,7,4,1,3
8869,15588,8525,51,2,2,0,1,0,1
8870,15589,10228,41,3,2,1,3,2,1
8871,15589,8640,59,4,0,4,0,0,0
8872,15590,6413,56,7,4,3,1,1,0
8873,15590,8611,44,7,2,5,1,0,1
8874,15591,10218,40,3,2,1,1,1,0
8875,15591,8674,60,7,2,5,3,1,2
8876,15592,10217,51,3,2,1,2,1,1
8877,15592,9908,49,6,1,5,0,0,0
8878,15593,9791,51,9,6,3,1,1,0
8879,15593,7788,49,5,1,4,1,1,0
8880,15594,10235,49,4,3,1,5,2,3
8881,15594,8277,51,2,1,1,0,0,0
8882,15596,10218,51,3,1,2,3,1,2
8883,15596,9908,49,7,4,3,0,0,0
8884,15597,10228,55,11,3,8,1,0,1
8885,15597,9791,45,4,1,3,0,0,0
8886,15598,10235,68,15,8,7,1,0,1
8887,15598,8526,32,3,3,0,3,0,3
8888,15600,7788,63,7,3,4,4,1,3
8889,15600,9803,37,3,0,3,2,0,2
8890,15602,8674,46,6,5,1,2,0,2
8891,15602,8277,54,7,3,4,0,0,0
8892,15603,10217,54,3,1,2,1,0,1
8893,15603,8464,46,5,2,3,1,0,1
8894,15604,8593,42,6,4,2,4,4,0
8895,15604,8640,58,4,2,2,2,1,1
8896,15605,9908,56,10,4,6,2,0,2
8897,15605,9791,44,1,0,1,0,0,0
8898,15608,10235,65,10,4,6,3,2,1
8899,15608,10218,35,1,0,1,0,0,0
8900,15609,8611,48,5,1,4,2,1,1
8901,15609,8525,52,6,3,3,2,1,1
8902,15612,10217,58,13,4,9,2,1,1
8903,15612,8674,42,4,2,2,3,0,3
8904,15614,8674,62,6,5,1,4,2,2
8905,15614,10218,38,5,3,2,3,1,2
8906,15615,9803,46,4,2,2,2,1,1
8907,15615,8526,54,4,3,1,0,0,0
8908,15616,10228,45,11,6,5,3,1,2
8909,15616,8640,55,8,4,4,0,0,0
8910,15619,8611,56,9,6,3,3,2,1
8911,15619,6413,44,11,5,6,2,1,1
8912,15620,8525,46,2,2,0,5,1,4
8913,15620,10229,54,9,5,4,0,0,0
8914,15623,6413,63,4,3,1,2,1,1
8915,15623,9803,37,4,2,2,0,0,0
8916,15624,9791,44,3,1,2,2,1,1
8917,15624,10218,56,4,2,2,2,1,1
8918,15626,8277,61,9,3,6,3,2,1
8919,15626,10217,39,3,2,1,0,0,0
8920,15627,8525,51,6,4,2,3,1,2
8921,15627,8640,49,4,1,3,0,0,0
8922,15628,10229,48,10,5,5,2,1,1
8923,15628,10228,52,4,1,3,0,0,0
8924,15629,9908,47,6,2,4,4,2,2
8925,15629,8464,53,4,3,1,1,0,1
8926,15630,8674,59,9,2,7,3,0,3
8927,15630,8526,41,8,3,5,0,0,0
8928,15631,10235,59,6,3,3,2,1,1
8929,15631,8611,41,5,3,2,0,0,0
8930,15632,8611,45,3,1,2,2,2,0
8931,15632,8526,55,7,3,4,3,0,3
8932,15633,9791,37,4,1,3,2,1,1
8933,15633,8277,63,5,0,5,1,0,1
8934,15635,10229,60,18,10,8,1,1,0
8935,15635,6413,40,3,1,2,3,0,3
8936,15636,9803,40,3,2,1,2,1,1
8937,15636,8640,60,3,1,2,1,1,0
8938,15637,8593,63,8,2,6,3,1,2
8939,15637,9908,37,3,1,2,0,0,0
8940,15638,8525,57,8,2,6,1,1,0
8941,15638,10217,43,2,0,2,2,1,1
8942,15639,8464,52,8,3,5,2,1,1
8943,15639,7788,48,5,1,4,0,0,0
8944,15641,8674,60,4,3,1,2,2,0
8945,15641,9803,40,4,3,1,1,0,1
8946,15642,8277,58,8,3,5,2,1,1
8947,15642,8640,42,11,4,7,0,0,0
8948,15643,10218,34,2,1,1,2,1,1
8949,15643,8611,66,6,1,5,0,0,0
8950,15644,10229,54,2,1,1,5,1,4
8951,15644,10217,46,5,2,3,3,2,1
8952,15646,8593,52,7,4,3,3,2,1
8953,15646,10228,48,3,2,1,1,0,1
8954,15647,8526,35,9,4,5,3,2,1
8955,15647,9908,65,12,7,5,1,1,0
8956,15648,7788,60,8,3,5,1,1,0
8957,15648,8525,40,4,2,2,0,0,0
8958,15650,10228,55,5,4,1,2,0,2
8959,15650,8674,45,1,1,0,1,0,1
8960,15651,8526,43,3,1,2,3,3,0
8961,15651,10229,57,9,2,7,1,1,0
8962,15652,10235,53,4,2,2,4,3,1
8963,15652,8525,47,3,1,2,1,0,1
8964,15653,8593,66,11,8,3,2,0,2
8965,15653,8611,34,5,2,3,0,0,0
8966,15654,8640,52,10,6,4,1,0,1
8967,15654,7788,48,7,4,3,0,0,0
8968,15655,10218,43,5,1,4,2,2,0
8969,15655,6413,57,3,0,3,3,2,1
8970,15656,9791,55,12,3,9,3,1,2
8971,15656,10217,45,3,0,3,1,1,0
8972,15657,8277,56,7,4,3,4,1,3
8973,15657,9908,44,4,0,4,1,1,0
8974,15659,7788,76,15,6,9,1,1,0
8975,15659,10218,24,2,1,1,3,1,2
8976,15662,8640,55,8,4,4,1,1,0
8977,15662,6413,45,6,5,1,4,1,3
8978,15663,8593,57,11,3,8,1,0,1
8979,15663,8526,43,3,0,3,1,0,1
8980,15664,8525,57,4,0,4,3,2,1
8981,15664,9803,43,1,0,1,2,0,2
8982,15665,8674,49,6,2,4,2,2,0
8983,15665,9791,51,4,0,4,0,0,0
8984,15666,10217,46,8,4,4,1,0,1
8985,15666,10228,54,2,1,1,0,0,0
8986,15667,8277,61,12,2,10,5,1,4
8987,15667,8611,39,4,0,4,1,1,0
8988,15669,8674,44,4,2,2,2,1,1
8989,15669,9908,56,3,2,1,0,0,0
8990,15670,10228,63,6,4,2,1,1,0
8991,15670,6413,37,4,0,4,3,1,2
8992,15671,10218,61,7,3,4,2,1,1
8993,15671,8526,39,4,1,3,3,1,2
8994,15674,9803,47,5,3,2,3,3,0
8995,15674,10229,53,4,2,2,3,1,2
8996,15675,8277,48,5,2,3,2,1,1
8997,15675,7788,52,2,1,1,0,0,0
8998,15676,8640,46,10,8,2,1,1,0
8999,15676,10235,54,4,1,3,1,0,1
9000,15677,8526,45,6,4,2,2,1,1
9001,15677,10229,55,7,5,2,0,0,0
9002,15679,8593,65,7,1,6,5,4,1
9003,15679,8611,35,2,0,2,1,0,1
9004,15680,7788,32,2,2,0,3,0,3
9005,15680,8640,68,10,7,3,0,0,0
9006,15682,8674,49,12,6,6,2,1,1
9007,15682,10228,51,5,3,2,2,2,0
9008,15685,8277,60,8,6,2,1,0,1
9009,15685,9908,40,8,5,3,0,0,0
9010,15687,8611,45,6,2,4,2,1,1
9011,15687,7788,55,0,0,0,1,0,1
9012,15689,8640,53,8,4,4,1,0,1
9013,15689,9791,47,6,4,2,0,0,0
9014,15691,9803,44,8,3,5,1,1,0
9015,15691,10235,56,6,2,4,0,0,0
9016,15692,8593,59,7,2,5,2,1,1
9017,15692,10218,41,2,0,2,1,1,0
9018,15697,8593,51,7,3,4,4,3,1
9019,15697,8674,49,2,1,1,2,1,1
9020,15698,10229,45,10,3,7,1,0,1
9021,15698,9791,55,3,2,1,0,0,0
9022,15700,8525,57,3,1,2,8,4,4
9023,15700,8526,43,6,2,4,1,0,1
9024,15701,10235,59,6,2,4,3,0,3
9025,15701,6413,41,2,1,1,0,0,0
9026,15705,8464,57,8,2,6,2,0,2
9027,15705,10217,43,4,2,2,0,0,0
9028,15707,8525,59,7,4,3,2,0,2
9029,15707,6413,41,7,3,4,0,0,0
9030,15708,10218,38,6,4,2,3,1,2
9031,15708,9908,62,7,2,5,1,1,0
9032,15709,10235,60,6,5,1,2,0,2
9033,15709,8526,40,8,6,2,0,0,0
9034,15710,8593,43,3,2,1,1,1,0
9035,15710,8640,57,13,6,7,4,2,2
9036,15711,8277,55,10,4,6,1,1,0
9037,15711,8674,45,2,0,2,0,0,0
9038,15713,7788,59,10,6,4,1,1,0
9039,15713,10229,41,6,2,4,0,0,0
9040,15714,8674,51,6,3,3,1,1,0
9041,15714,8525,49,3,0,3,1,0,1
9042,15715,8593,53,5,1,4,7,4,3
9043,15715,9791,47,6,3,3,1,1,0
9044,15716,9908,61,5,2,3,6,2,4
9045,15716,9803,39,5,2,3,1,1,0
9046,15717,8640,62,15,7,8,3,2,1
9047,15717,10218,38,7,2,5,0,0,0
9048,15718,8464,51,7,4,3,2,1,1
9049,15718,8611,49,7,4,3,1,0,1
9050,15719,10235,58,4,2,2,1,0,1
9051,15719,10228,42,2,1,1,0,0,0
9052,15721,8277,61,15,7,8,2,0,2
9053,15721,6413,39,6,3,3,0,0,0
9054,21518,8661,48,4,3,1,3,1,2
9055,21518,10267,52,5,3,2,0,0,0
9056,21520,8633,61,12,5,7,2,1,1
9057,21520,9783,39,2,1,1,3,0,3
9058,21521,8634,74,6,2,4,3,3,0
9059,21521,8388,26,2,1,1,3,1,2
9060,21532,9906,51,6,3,3,3,3,0
9061,21532,8371,49,10,6,4,0,0,0
9062,21539,10267,65,10,5,5,1,0,1
9063,21539,9869,35,3,0,3,0,0,0
9064,21544,9864,53,8,4,4,2,2,0
9065,21544,10205,47,6,3,3,3,1,2
9066,21545,10281,51,2,1,1,1,1,0
9067,21545,8633,49,11,2,9,2,1,1
9068,21550,8634,67,7,5,2,3,1,2
9069,21550,8305,33,7,4,3,0,0,0
9070,21553,8315,47,6,3,3,1,1,0
9071,21553,9783,53,8,7,1,0,0,0
9072,21555,8479,40,3,1,2,3,2,1
9073,21555,8633,60,8,3,5,0,0,0
9074,21559,10205,45,3,2,1,2,0,2
9075,21559,8479,55,4,1,3,1,0,1
9076,21561,8696,43,3,2,1,4,2,2
9077,21561,9906,57,3,0,3,1,0,1
9078,21564,8634,65,13,7,6,2,2,0
9079,21564,8302,35,3,2,1,4,2,2
9080,21566,8633,56,6,4,2,2,1,1
9081,21566,8305,44,3,1,2,0,0,0
9082,21570,8479,43,4,1,3,1,0,1
9083,21570,8661,57,2,2,0,1,0,1
9084,21571,10205,56,7,2,5,1,0,1
9085,21571,8305,44,2,1,1,1,0,1
9086,21572,8634,59,5,4,1,2,0,2
9087,21572,10267,41,2,2,0,0,0,0
9088,21575,8603,53,7,6,1,2,1,1
9089,21575,8558,47,7,3,4,0,0,0
9090,21576,8633,56,12,5,7,4,2,2
9091,21576,8302,44,6,1,5,0,0,0
9092,21578,8634,73,10,6,4,1,0,1
9093,21578,8633,27,3,2,1,0,0,0
9094,21580,9906,48,10,5,5,1,0,1
9095,21580,8603,52,5,3,2,0,0,0
9096,21582,9783,56,5,2,3,1,1,0
9097,21582,10281,44,3,0,3,2,1,1
9098,21585,8302,61,10,5,5,1,0,1
9099,21585,10205,39,2,0,2,0,0,0
9100,21586,8558,30,2,1,1,3,1,2
9101,21586,10267,70,11,5,6,1,0,1
9102,21588,8315,45,4,1,3,3,1,2
9103,21588,8603,55,3,0,3,0,0,0
9104,21592,8661,41,8,3,5,4,1,3
9105,21592,8302,59,3,0,3,3,0,3
9106,21594,8633,44,8,4,4,1,0,1
9107,21594,10267,56,11,5,6,0,0,0
9108,21595,8558,45,8,5,3,1,0,1
9109,21595,9906,55,5,1,4,0,0,0
9110,21598,8305,49,7,2,5,1,1,0
9111,21598,9783,51,5,3,2,1,0,1
9112,21602,8371,41,1,1,0,1,1,0
9113,21602,8302,59,4,1,3,0,0,0
9114,21604,8633,52,10,3,7,1,0,1
9115,21604,10205,48,7,1,6,0,0,0
9116,21605,10267,55,5,2,3,1,0,1
9117,21605,9906,45,5,1,4,0,0,0
9118,21611,8558,57,10,4,6,2,2,0
9119,21611,9865,43,2,0,2,0,0,0
9120,21614,8634,67,8,4,4,3,1,2
9121,21614,8371,33,3,1,2,0,0,0
9122,21617,8302,42,2,1,1,2,1,1
9123,21617,9783,58,6,0,6,2,0,2
9124,21619,9865,49,6,2,4,1,1,0
9125,21619,9906,51,6,0,6,3,0,3
9126,21624,8302,66,8,1,7,1,1,0
9127,21624,8388,34,6,5,1,1,0,1
9128,21625,8634,64,9,6,3,2,2,0
9129,21625,9783,36,1,0,1,1,0,1
9130,21626,8633,54,6,4,2,8,4,4
9131,21626,8371,46,2,1,1,1,1,0
9132,21628,9783,46,4,3,1,1,1,0
9133,21628,10205,54,11,5,6,2,1,1
9134,21629,8633,59,13,9,4,1,1,0
9135,21629,8388,41,3,1,2,0,0,0
9136,21630,8634,70,13,4,9,1,0,1
9137,21630,8696,30,1,0,1,1,0,1
9138,21631,8302,65,10,4,6,3,1,2
9139,21631,9869,35,7,2,5,1,1,0
9140,21636,9865,49,6,3,3,4,2,2
9141,21636,10267,51,2,1,1,2,0,2
9142,21638,8634,73,8,4,4,1,1,0
9143,21638,8388,27,1,0,1,1,0,1
9144,21639,8633,55,9,4,5,2,2,0
9145,21639,9783,45,5,1,4,1,0,1
9146,21640,8371,48,4,1,3,2,1,1
9147,21640,10205,52,9,3,6,2,0,2
9148,21646,9906,56,7,4,3,1,0,1
9149,21646,9864,44,6,1,5,0,0,0
9150,21648,8634,67,2,1,1,2,2,0
9151,21648,8696,33,3,1,2,1,0,1
9152,21649,8388,49,6,3,3,2,1,1
9153,21649,8633,51,7,3,4,1,0,1
9154,21656,8315,57,5,3,2,2,2,0
9155,21656,9864,43,2,1,1,2,1,1
9156,21657,10267,52,2,1,1,2,2,0
9157,21657,9865,48,4,3,1,1,1,0
9158,21660,8633,58,8,6,2,2,2,0
9159,21660,8696,42,6,4,2,1,1,0
9160,21661,8634,75,5,3,2,1,1,0
9161,21661,9869,25,2,2,0,2,2,0
9162,21662,8302,57,7,3,4,2,1,1
9163,21662,8603,43,6,1,5,2,0,2
9164,21668,8634,69,13,3,10,2,0,2
9165,21668,8603,31,4,0,4,1,0,1
9166,21670,8633,59,6,3,3,2,1,1
9167,21670,9869,41,3,1,2,4,0,4
9168,21671,10267,60,11,5,6,1,0,1
9169,21671,9864,40,6,5,1,0,0,0
9170,21673,8305,49,3,3,0,2,2,0
9171,21673,9906,51,7,2,5,1,1,0
9172,21674,8558,40,6,1,5,3,1,2
9173,21674,8302,60,8,3,5,0,0,0
9174,21678,8634,61,6,2,4,1,0,1
9175,21678,8558,39,1,1,0,0,0,0
9176,21680,9783,54,7,5,2,3,0,3
9177,21680,10267,46,3,3,0,0,0,0
9178,21684,8633,62,8,3,5,1,0,1
9179,21684,8603,38,0,0,0,1,0,1
9180,21687,9906,42,8,3,5,7,4,3
9181,21687,8302,58,5,2,3,3,0,3
9182,21690,8302,61,6,3,3,3,1,2
9183,21690,8315,39,3,1,2,2,0,2
9184,21693,8603,48,9,5,4,1,0,1
9185,21693,10205,52,4,2,2,0,0,0
9186,21701,8558,52,7,2,5,3,3,0
9187,21701,10205,48,2,1,1,0,0,0
9188,21702,9906,42,5,3,2,1,1,0
9189,21702,8633,58,8,5,3,2,1,1
9190,21704,8302,51,9,3,6,1,1,0
9191,21704,9865,49,4,0,4,1,0,1
9192,21705,9864,37,3,1,2,2,1,1
9193,21705,8305,63,3,2,1,0,0,0
9194,21711,9906,58,12,9,3,3,1,2
9195,21711,10205,42,2,1,1,0,0,0
9196,21713,8302,67,8,4,4,1,0,1
9197,21713,9864,33,1,0,1,0,0,0
9198,21716,8315,48,4,2,2,1,1,0
9199,21716,8633,52,9,4,5,1,0,1
9200,21719,10281,41,4,1,3,3,1,2
9201,21719,8302,59,3,2,1,0,0,0
9202,21724,8634,66,11,7,4,3,0,3
9203,21724,9864,34,3,1,2,1,0,1
9204,21725,8661,40,1,1,0,1,1,0
9205,21725,9906,60,1,1,0,0,0,0
9206,21726,8315,45,7,5,2,2,2,0
9207,21726,10205,55,5,1,4,0,0,0
9208,21727,9865,49,5,2,3,1,1,0
9209,21727,8633,51,7,3,4,1,1,0
9210,21728,8371,47,2,2,0,2,1,1
9211,21728,9906,53,7,2,5,1,0,1
9212,21734,9864,45,7,4,3,3,2,1
9213,21734,8633,55,5,0,5,1,0,1
9214,21738,8634,68,6,4,2,5,3,2
9215,21738,9869,32,2,2,0,2,0,2
9216,21741,10267,60,4,3,1,1,1,0
9217,21741,8371,40,1,0,1,2,0,2
9218,21743,8305,51,6,5,1,2,2,0
9219,21743,8558,49,3,1,2,1,0,1
9220,21754,9864,42,2,1,1,2,1,1
9221,21754,10205,58,12,4,8,0,0,0
9222,21755,8633,55,9,2,7,1,1,0
9223,21755,10281,45,10,4,6,0,0,0
9224,21756,8479,25,3,2,1,2,1,1
9225,21756,8634,75,6,3,3,0,0,0
9226,21757,8302,58,4,4,0,4,2,2
9227,21757,8305,42,1,1,0,4,0,4
9228,21758,9869,51,6,3,3,3,1,2
9229,21758,8603,49,6,1,5,0,0,0
9230,21763,10267,51,10,5,5,3,2,1
9231,21763,8302,49,3,3,0,0,0,0
9232,21764,8634,69,10,7,3,1,1,0
9233,21764,8305,31,1,0,1,2,0,2
9234,21765,8633,57,10,4,6,4,1,3
9235,21765,8479,43,3,2,1,0,0,0
9236,21769,10267,54,2,2,0,3,2,1
9237,21769,8603,46,2,1,1,0,0,0
9238,21775,8633,56,9,3,6,3,0,3
9239,21775,8305,44,2,0,2,0,0,0
9240,21776,8634,62,8,5,3,1,1,0
9241,21776,8302,38,2,0,2,0,0,0
9242,21780,10205,40,4,3,1,1,1,0
9243,21780,8305,60,5,1,4,2,0,2
9244,21781,8302,53,4,2,2,3,2,1
9245,21781,8633,47,2,1,1,1,1,0
9246,21782,8634,63,8,4,4,1,1,0
9247,21782,10267,37,3,2,1,0,0,0
9248,21783,9783,58,9,3,6,1,1,0
9249,21783,9864,42,6,4,2,0,0,0
9250,21788,10267,55,9,4,5,2,1,1
9251,21788,8558,45,5,0,5,1,1,0
9252,21789,8603,53,2,1,1,4,1,3
9253,21789,9906,47,2,0,2,0,0,0
9254,21793,10281,60,7,5,2,4,1,3
9255,21793,9783,40,8,3,5,2,0,2
9256,21794,8634,60,8,7,1,2,2,0
9257,21794,8633,40,2,1,1,1,1,0
9258,21795,10205,48,8,3,5,1,1,0
9259,21795,8302,52,3,2,1,0,0,0
9260,21799,8661,39,6,3,3,2,1,1
9261,21799,8302,61,6,2,4,1,0,1
9262,21805,8558,47,4,1,3,4,1,3
9263,21805,9906,53,9,3,6,0,0,0
9264,21806,8634,60,5,3,2,1,1,0
9265,21806,10205,40,1,1,0,0,0,0
9266,21807,10267,55,6,5,1,3,1,2
9267,21807,8633,45,7,3,4,0,0,0
9268,21808,9869,52,12,6,6,2,1,1
9269,21808,9864,48,2,0,2,1,0,1
9270,21809,9906,47,10,8,2,6,3,3
9271,21809,10267,53,2,2,0,0,0,0
9272,21812,8634,60,10,6,4,2,1,1
9273,21812,8661,40,8,2,6,1,0,1
9274,21816,8633,54,4,2,2,1,1,0
9275,21816,10205,46,5,1,4,1,1,0
9276,21824,8371,38,5,1,4,1,1,0
9277,21824,8634,62,4,1,3,0,0,0
9278,21825,8633,58,6,4,2,3,2,1
9279,21825,8661,42,5,2,3,1,0,1
9280,21831,8479,51,1,1,0,3,0,3
9281,21831,9869,49,8,2,6,0,0,0
9282,21835,8371,48,8,4,4,2,2,0
9283,21835,8633,52,5,2,3,1,0,1
9284,21842,8634,65,9,4,5,2,0,2
9285,21842,8603,35,3,2,1,0,0,0
9286,21847,9864,51,6,2,4,6,3,3
9287,21847,10267,49,3,1,2,2,0,2
9288,21853,8558,35,4,2,2,4,3,1
9289,21853,8634,65,15,5,10,0,0,0
9290,21859,8558,44,3,1,2,2,1,1
9291,21859,8633,56,8,0,8,1,0,1
9292,21870,8633,48,13,5,8,2,1,1
9293,21870,9906,52,5,1,4,0,0,0
9294,21873,8558,44,3,2,1,3,2,1
9295,21873,10205,56,5,1,4,0,0,0
9296,21883,8315,46,5,3,2,2,2,0
9297,21883,8633,54,3,1,2,1,0,1
9298,21886,10267,70,7,2,5,1,0,1
9299,21886,8479,30,2,0,2,0,0,0
9300,21889,9864,45,2,2,0,6,2,4
9301,21889,8634,55,4,1,3,0,0,0
9302,21893,9783,42,5,3,2,1,0,1
9303,21893,8603,58,8,3,5,1,0,1
9304,21895,8633,54,5,3,2,4,3,1
9305,21895,9865,46,7,1,6,0,0,0
9306,21898,9783,39,2,2,0,2,2,0
9307,21898,8633,61,9,4,5,1,1,0
9308,21902,8394,41,7,4,3,2,0,2
9309,21902,9867,59,5,2,3,1,0,1
9310,21903,10267,53,4,3,1,1,1,0
9311,21903,8302,47,1,0,1,0,0,0
9312,21905,9869,25,6,2,4,1,1,0
9313,21905,8634,75,8,2,6,1,0,1
9314,21909,8302,57,4,4,0,1,1,0
9315,21909,10205,43,3,2,1,3,1,2
9316,21912,8305,64,3,1,2,2,0,2
9317,21912,9783,36,1,0,1,0,0,0
9318,21913,9906,48,7,3,4,2,1,1
9319,21913,8633,52,6,5,1,0,0,0
9320,21915,8634,68,7,6,1,1,0,1
9321,21915,8661,32,5,2,3,1,0,1
9322,21917,10267,53,6,2,4,2,1,1
9323,21917,8394,47,5,2,3,1,0,1
9324,21922,9783,52,10,5,5,1,1,0
9325,21922,9906,48,7,1,6,0,0,0
9326,21924,8634,62,6,2,4,3,1,2
9327,21924,8315,38,1,0,1,0,0,0
9328,21926,10267,49,2,2,0,2,0,2
9329,21926,8371,51,2,1,1,1,0,1
9330,21932,9906,48,6,4,2,1,0,1
9331,21932,8558,52,3,1,2,1,0,1
9332,21933,9783,49,3,1,2,3,1,2
9333,21933,8696,51,3,0,3,0,0,0
9334,21934,8634,58,4,3,1,2,1,1
9335,21934,8633,42,8,4,4,4,1,3
9336,21936,8661,41,1,1,0,5,2,3
9337,21936,10267,59,6,1,5,3,0,3
9338,21938,10281,37,3,2,1,3,2,1
9339,21938,8302,63,5,1,4,2,1,1
9340,21940,10205,54,7,6,1,2,1,1
9341,21940,8305,46,1,0,1,1,0,1
9342,21942,8696,44,2,1,1,5,3,2
9343,21942,8558,56,0,0,0,1,1,0
9344,21943,8634,65,9,8,1,1,0,1
9345,21943,9783,35,2,1,1,0,0,0
9346,21944,8633,66,18,13,5,2,2,0
9347,21944,9865,34,1,0,1,2,2,0
9348,21945,10267,59,3,2,1,2,1,1
9349,21945,8315,41,3,0,3,0,0,0
9350,21949,9869,52,7,4,3,2,1,1
9351,21949,8302,48,2,2,0,1,0,1
9352,21951,10205,52,7,4,3,6,4,2
9353,21951,9906,48,2,2,0,0,0,0
9354,21953,8634,70,3,3,0,4,1,3
9355,21953,8558,30,2,1,1,1,0,1
9356,21959,8302,65,7,5,2,5,1,4
9357,21959,8305,35,2,0,2,1,0,1
9358,21960,9906,53,2,1,1,4,2,2
9359,21960,9867,47,12,4,8,1,1,0
9360,21962,9868,34,6,4,2,1,1,0
9361,21962,8634,66,3,3,0,2,0,2
9362,21964,10267,57,7,3,4,4,1,3
9363,21964,9783,43,4,2,2,0,0,0
9364,21965,8633,57,5,1,4,2,1,1
9365,21965,8394,43,2,1,1,1,0,1
9366,21970,8302,58,2,1,1,2,1,1
9367,21970,9906,42,2,0,2,1,1,0
9368,21972,8634,63,7,1,6,2,1,1
9369,21972,10205,37,3,0,3,0,0,0
9370,21975,8394,51,7,2,5,1,1,0
9371,21975,9783,49,6,0,6,1,0,1
9372,21976,8633,51,9,3,6,3,0,3
9373,21976,8371,49,2,1,1,0,0,0
9374,21977,8661,51,6,3,3,3,1,2
9375,21977,8315,49,4,0,4,2,0,2
9376,21980,8302,64,9,4,5,3,1,2
9377,21980,8696,36,3,2,1,0,0,0
9378,21981,9867,36,5,4,1,4,1,3
9379,21981,8634,64,4,3,1,0,0,0
9380,21982,10205,52,3,1,2,1,0,1
9381,21982,9865,48,2,0,2,0,0,0
9382,21983,10267,55,4,4,0,2,1,1
9383,21983,9868,45,3,1,2,2,0,2
9384,21986,8661,37,3,2,1,4,2,2
9385,21986,8633,63,5,0,5,1,0,1
9386,21989,9869,49,7,4,3,4,2,2
9387,21989,9906,51,3,1,2,0,0,0
9388,21991,8634,68,11,4,7,1,0,1
9389,21991,8302,32,0,0,0,1,0,1
9390,21993,10267,57,9,2,7,1,1,0
9391,21993,10205,43,1,0,1,0,0,0
9392,21998,9906,45,3,2,1,1,0,1
9393,21998,8305,55,7,4,3,0,0,0
9394,22000,8634,70,7,2,5,3,3,0
9395,22000,10281,30,6,3,3,2,1,1
9396,22005,8558,59,4,2,2,1,0,1
9397,22005,8661,41,4,2,2,0,0,0
9398,22006,8315,54,7,3,4,4,2,2
9399,22006,9783,46,3,0,3,3,1,2
9400,22007,9864,41,3,2,1,1,1,0
9401,22007,8633,59,6,4,2,1,0,1
9402,22009,8633,49,7,2,5,1,1,0
9403,22009,8558,51,5,3,2,0,0,0
9404,22010,9868,59,9,2,7,1,1,0
9405,22010,8315,41,7,2,5,2,1,1
9406,22013,8302,58,3,1,2,1,1,0
9407,22013,8394,42,5,3,2,0,0,0
9408,22014,10267,47,4,2,2,2,1,1
9409,22014,10281,53,6,2,4,2,1,1
9410,22016,8305,39,6,1,5,1,1,0
9411,22016,8634,61,8,2,6,0,0,0
9412,22018,8633,59,8,7,1,4,1,3
9413,22018,9783,41,3,1,2,0,0,0
9414,22023,8302,48,3,1,2,3,2,1
9415,22023,10267,52,12,3,9,0,0,0
9416,22025,8634,71,6,1,5,4,4,0
9417,22025,9869,29,2,1,1,0,0,0
9418,22027,9864,42,1,1,0,2,1,1
9419,22027,9906,58,6,2,4,1,0,1
9420,22029,8633,61,9,6,3,4,2,2
9421,22029,8558,39,4,1,3,3,2,1
9422,22030,9868,42,4,3,1,1,1,0
9423,22030,8315,58,9,4,5,1,0,1
9424,22033,8302,52,4,2,2,2,0,2
9425,22033,8394,48,4,2,2,0,0,0
9426,22034,10281,52,7,2,5,3,1,2
9427,22034,10267,48,12,7,5,1,0,1
9428,22036,8634,51,5,5,0,1,1,0
9429,22036,8305,49,5,2,3,0,0,0
9430,22037,8696,53,4,2,2,1,1,0
9431,22037,9906,47,2,1,1,2,0,2
9432,22039,9868,38,2,2,0,3,1,2
9433,22039,8633,62,9,4,5,0,0,0
9434,22040,8315,48,1,1,0,3,1,2
9435,22040,10205,52,6,2,4,1,0,1
9436,22041,8661,51,5,3,2,1,0,1
9437,22041,9867,49,2,0,2,1,0,1
9438,22042,8302,55,3,2,1,2,1,1
9439,22042,8371,45,3,3,0,1,0,1
9440,22044,10267,61,10,10,0,2,1,1
9441,22044,9869,39,5,2,3,1,0,1
9442,22046,9906,38,5,3,2,2,1,1
9443,22046,8634,62,6,5,1,2,0,2
9444,22050,8633,56,3,2,1,1,1,0
9445,22050,10205,44,3,1,2,0,0,0
9446,22051,8315,55,7,2,5,4,2,2
9447,22051,9867,45,3,0,3,0,0,0
9448,22052,8302,52,3,3,0,1,1,0
9449,22052,8661,48,3,1,2,2,1,1
9450,22055,10267,43,8,5,3,1,1,0
9451,22055,8305,57,5,2,3,1,0,1
9452,22056,9865,47,5,3,2,1,1,0
9453,22056,9906,53,9,4,5,1,0,1
9454,22057,8634,65,6,3,3,1,1,0
9455,22057,8696,35,1,0,1,2,0,2
9456,22059,10205,45,6,4,2,5,2,3
9457,22059,9783,55,3,1,2,1,1,0
9458,22060,9867,43,7,2,5,3,2,1
9459,22060,8633,57,5,2,3,1,0,1
9460,22061,8302,54,7,3,4,3,1,2
9461,22061,8315,46,5,1,4,2,1,1
9462,22065,10267,44,1,1,0,2,2,0
9463,22065,9906,56,9,0,9,1,0,1
9464,22067,9864,28,1,1,0,3,2,1
9465,22067,8634,72,5,2,3,1,0,1
9466,22069,8558,57,8,6,2,2,0,2
9467,22069,10205,43,8,3,5,1,0,1
9468,22071,8633,56,13,8,5,6,1,5
9469,22071,8302,44,0,0,0,0,0,0
9470,22072,8315,46,7,3,4,1,1,0
9471,22072,10281,54,7,2,5,0,0,0
9472,22075,8394,47,7,4,3,4,2,2
9473,22075,9906,53,1,0,1,0,0,0
9474,22076,10267,60,6,3,3,2,1,1
9475,22076,8696,40,6,1,5,0,0,0
9476,22077,8634,73,9,5,4,3,2,1
9477,22077,9865,27,2,1,1,0,0,0
9478,22078,10205,51,8,5,3,2,1,1
9479,22078,9868,49,4,2,2,0,0,0
9480,22080,9783,36,3,2,1,2,2,0
9481,22080,8302,64,7,1,6,2,2,0
9482,22081,10281,53,6,3,3,2,0,2
9483,22081,8633,47,11,5,6,0,0,0
9484,22083,8661,44,3,2,1,5,1,4
9485,22083,8305,56,6,4,2,1,1,0
9486,22084,8371,51,6,2,4,1,0,1
9487,22084,9906,49,9,5,4,0,0,0
9488,22092,9869,38,4,1,3,2,1,1
9489,22092,8633,62,9,4,5,1,0,1
9490,22096,8634,60,3,2,1,2,1,1
9491,22096,8394,40,1,0,1,0,0,0
9492,22097,10267,54,9,5,4,4,0,4
9493,22097,9865,46,5,1,4,0,0,0
9494,22099,9868,46,2,1,1,1,1,0
9495,22099,8302,54,2,0,2,0,0,0
9496,22102,8633,51,9,7,2,1,1,0
9497,22102,8305,49,5,0,5,5,1,4
9498,22103,8315,49,5,3,2,1,0,1
9499,22103,9906,51,7,2,5,1,0,1
9500,22109,10205,42,3,1,2,5,3,2
9501,22109,8302,58,6,1,5,2,1,1
9502,22112,9783,48,3,1,2,3,1,2
9503,22112,8305,52,4,1,3,0,0,0
9504,22113,8633,60,10,7,3,1,1,0
9505,22113,9906,40,3,2,1,0,0,0
9506,22114,8696,48,3,1,2,1,0,1
9507,22114,8315,52,1,1,0,1,0,1
9508,22115,8661,33,3,3,0,2,1,1
9509,22115,8634,67,4,2,2,1,0,1
9510,22117,10267,52,3,3,0,4,2,2
9511,22117,8394,48,7,3,4,2,1,1
9512,22118,9783,52,5,2,3,1,1,0
9513,22118,8558,48,3,2,1,2,0,2
9514,22119,8633,52,10,6,4,3,1,2
9515,22119,9868,48,3,2,1,0,0,0
9516,22122,8302,45,2,2,0,1,1,0
9517,22122,8371,55,4,1,3,4,0,4
9518,22124,10267,67,14,6,8,1,1,0
9519,22124,9869,33,3,0,3,1,0,1
9520,22128,9867,48,5,2,3,1,1,0
9521,22128,8302,52,2,1,1,0,0,0
9522,22132,9906,53,8,4,4,2,2,0
9523,22132,9783,47,2,0,2,1,0,1
9524,22133,8696,40,2,1,1,2,2,0
9525,22133,8633,60,6,1,5,2,2,0
9526,22134,8634,63,9,5,4,1,1,0
9527,22134,8315,37,4,1,3,0,0,0
9528,22142,8558,47,5,3,2,2,2,0
9529,22142,9906,53,3,2,1,0,0,0
9530,22144,8634,56,4,2,2,2,2,0
9531,22144,8633,44,10,1,9,1,0,1
9532,22146,8661,40,8,4,4,1,1,0
9533,22146,10267,60,3,1,2,2,0,2
9534,22148,10281,38,7,4,3,1,1,0
9535,22148,8302,62,2,0,2,0,0,0
9536,22150,8305,44,4,3,1,2,1,1
9537,22150,10205,56,4,2,2,1,0,1
9538,22151,9906,51,6,3,3,1,1,0
9539,22151,9868,49,2,1,1,2,0,2
9540,22153,9783,27,2,1,1,2,1,1
9541,22153,8634,73,10,6,4,1,0,1
9542,22154,8633,60,18,9,9,1,1,0
9543,22154,9865,40,5,2,3,0,0,0
9544,22155,10267,64,6,2,4,1,1,0
9545,22155,8315,36,3,1,2,1,0,1
9546,22158,10281,49,1,1,0,1,1,0
9547,22158,9864,51,0,0,0,0,0,0
9548,22161,10205,46,4,3,1,2,1,1
9549,22161,9906,54,5,2,3,1,0,1
9550,22163,8558,36,3,3,0,3,2,1
9551,22163,8634,64,3,1,2,0,0,0
9552,22165,8633,52,10,6,4,2,0,2
9553,22165,10267,48,2,1,1,0,0,0
9554,22167,8661,46,7,4,3,2,1,1
9555,22167,8371,54,4,2,2,0,0,0
9556,22169,8305,57,6,1,5,2,2,0
9557,22169,8302,43,5,0,5,1,0,1
9558,22170,9906,48,5,4,1,3,2,1
9559,22170,9867,52,3,2,1,1,0,1
9560,22172,8634,67,7,2,5,2,1,1
9561,22172,9868,33,3,1,2,0,0,0
9562,22174,10267,61,7,2,5,1,0,1
9563,22174,9783,39,2,1,1,0,0,0
9564,22175,8633,64,10,3,7,1,1,0
9565,22175,8394,36,2,0,2,1,0,1
9566,22180,8302,51,3,2,1,3,0,3
9567,22180,9906,49,2,2,0,0,0,0
9568,22182,8634,64,5,4,1,1,0,1
9569,22182,10205,36,3,1,2,0,0,0
9570,22184,10267,61,6,4,2,3,2,1
9571,22184,8558,39,2,1,1,2,2,0
9572,22185,9783,48,5,1,4,4,3,1
9573,22185,8394,52,1,1,0,1,0,1
9574,22186,8633,58,10,4,6,2,1,1
9575,22186,8371,42,5,2,3,1,0,1
9576,22187,8315,56,4,2,2,1,0,1
9577,22187,8661,44,6,3,3,1,0,1
9578,22191,8634,78,5,3,2,2,2,0
9579,22191,9867,22,2,1,1,4,2,2
9580,22193,10267,62,6,4,2,2,2,0
9581,22193,9868,38,2,2,0,1,1,0
9582,22196,8633,64,5,4,1,2,1,1
9583,22196,8661,36,3,3,0,2,1,1
9584,22199,9906,58,2,1,1,1,0,1
9585,22199,9869,42,0,0,0,0,0,0
9586,22201,8634,64,4,1,3,3,1,2
9587,22201,8302,36,3,2,1,0,0,0
9588,22203,10205,46,5,3,2,3,2,1
9589,22203,10267,54,5,2,3,2,2,0
9590,22206,8661,55,3,2,1,1,1,0
9591,22206,9783,45,4,2,2,3,1,2
9592,22207,8315,33,3,2,1,1,1,0
9593,22207,8633,67,15,8,7,2,1,1
9594,22209,8696,57,9,8,1,1,0,1
9595,22209,9869,43,5,1,4,0,0,0
9596,22210,10281,23,5,2,3,2,2,0
9597,22210,8634,77,6,6,0,2,1,1
9598,22211,9865,55,4,1,3,6,1,5
9599,22211,8302,45,3,2,1,0,0,0
9600,22213,8394,52,3,2,1,1,0,1
9601,22213,10205,48,7,4,3,0,0,0
9602,22216,8315,52,6,5,1,1,0,1
9603,22216,9783,48,4,1,3,1,0,1
9604,22217,9864,33,2,1,1,1,1,0
9605,22217,8633,67,9,3,6,0,0,0
9606,22220,8633,51,9,4,5,2,1,1
9607,22220,10205,49,6,1,5,3,2,1
9608,22227,8634,72,7,2,5,1,1,0
9609,22227,8696,28,1,0,1,4,2,2
9610,22230,8633,51,10,4,6,2,1,1
9611,22230,9867,49,8,3,5,2,1,1
9612,22235,10267,55,8,2,6,1,0,1
9613,22235,9906,45,4,0,4,0,0,0
9614,22240,9867,60,7,2,5,3,1,2
9615,22240,9783,40,4,1,3,3,1,2
9616,22241,8302,52,14,5,9,2,0,2
9617,22241,8633,48,4,2,2,0,0,0
9618,22246,8696,51,5,2,3,2,0,2
9619,22246,10267,49,3,2,1,1,0,1
9620,22247,8634,72,10,4,6,1,1,0
9621,22247,9865,28,0,0,0,3,0,3
9622,22249,8558,57,5,4,1,4,2,2
9623,22249,9867,43,3,0,3,0,0,0
9624,22251,10281,44,11,3,8,2,0,2
9625,22251,8633,56,5,0,5,0,0,0
9626,22256,10267,40,4,1,3,3,2,1
9627,22256,8634,60,6,2,4,0,0,0
9628,22260,8558,41,2,1,1,2,1,1
9629,22260,8302,59,13,7,6,0,0,0
9630,22262,8633,63,9,5,4,4,2,2
9631,22262,9869,37,4,3,1,3,0,3
9632,22266,8634,77,9,6,3,2,1,1
9633,22266,8394,23,5,1,4,1,0,1
9634,22267,10267,56,5,3,2,1,0,1
9635,22267,9865,44,1,0,1,0,0,0
9636,22272,8633,47,14,8,6,2,2,0
9637,22272,8305,53,8,3,5,2,1,1
9638,22275,8634,70,11,6,5,2,0,2
9639,22275,8371,30,0,0,0,0,0,0
9640,22281,10267,57,9,6,3,1,0,1
9641,22281,9864,43,6,2,4,0,0,0
9642,22287,8633,58,11,2,9,2,1,1
9643,22287,8661,42,3,1,2,1,0,1
9644,22289,8302,59,9,5,4,3,3,0
9645,22289,10267,41,7,3,4,0,0,0
9646,22291,10205,56,10,5,5,3,1,2
9647,22291,8315,44,6,1,5,0,0,0
9648,22295,8560,47,7,4,3,1,0,1
9649,22295,8696,53,5,1,4,0,0,0
9650,22296,8558,47,6,4,2,1,0,1
9651,22296,9864,53,4,2,2,0,0,0
9652,22309,8305,67,7,5,2,3,1,2
9653,22309,8394,33,5,2,3,2,0,2
9654,22311,8634,76,9,3,6,1,0,1
9655,22311,9865,24,3,1,2,1,0,1
9656,22312,8315,46,9,6,3,2,1,1
9657,22312,8633,54,4,2,2,4,4,0
9658,22319,8394,45,5,3,2,3,1,2
9659,22319,10205,55,5,2,3,1,0,1
9660,22320,10267,51,3,2,1,2,0,2
9661,22320,9865,49,2,1,1,1,0,1
9662,22322,8371,55,4,2,2,1,1,0
9663,22322,8315,45,3,2,1,1,0,1
9664,22331,10267,49,7,2,5,4,1,3
9665,22331,8633,51,10,6,4,3,1,2
9666,22332,8371,31,2,1,1,2,2,0
9667,22332,8634,69,6,1,5,0,0,0
9668,22339,8302,60,2,1,1,1,1,0
9669,22339,9865,40,3,3,0,0,0,0
9670,22341,10267,52,7,6,1,1,0,1
9671,22341,8371,48,3,0,3,2,0,2
9672,22345,9906,49,3,3,0,7,1,6
9673,22345,9783,51,1,1,0,1,0,1
9674,22347,8661,60,10,4,6,2,0,2
9675,22347,8696,40,4,1,3,0,0,0
9676,22349,8305,57,7,3,4,1,0,1
9677,22349,9865,43,7,6,1,0,0,0
9678,22351,8394,47,3,2,1,2,0,2
9679,22351,8371,53,9,8,1,0,0,0
9680,22352,8560,45,4,3,1,3,2,1
9681,22352,10267,55,6,3,3,0,0,0
9682,22356,9906,48,4,3,1,2,2,0
9683,22356,9864,52,6,3,3,1,0,1
9684,22357,10278,55,3,1,2,2,2,0
9685,22357,8696,45,2,2,0,0,0,0
9686,22360,8302,59,6,6,0,1,1,0
9687,22360,8371,41,3,1,2,3,0,3
9688,22362,10267,51,7,4,3,1,1,0
9689,22362,8558,49,4,1,3,3,1,2
9690,22363,8634,75,12,8,4,2,2,0
9691,22363,8581,25,2,1,1,0,0,0
9692,22368,9865,56,2,1,1,2,0,2
9693,22368,8661,44,5,0,5,0,0,0
9694,22369,10205,45,4,2,2,3,2,1
9695,22369,8633,55,5,1,4,0,0,0
9696,22373,8581,39,6,6,0,2,1,1
9697,22373,10267,61,6,3,3,1,1,0
9698,22375,8315,46,5,3,2,1,1,0
9699,22375,9864,54,4,3,1,0,0,0
9700,22378,9865,37,3,2,1,2,1,1
9701,22378,8633,63,13,6,7,1,0,1
9702,22383,10267,60,9,5,4,2,2,0
9703,22383,9783,40,3,0,3,0,0,0
9704,22390,8634,70,7,2,5,2,2,0
9705,22390,10278,30,4,1,3,1,0,1
9706,22393,8302,57,14,4,10,1,1,0
9707,22393,9783,43,4,2,2,1,0,1
9708,22395,8558,54,9,6,3,2,2,0
9709,22395,10205,46,7,2,5,0,0,0
9710,22397,8371,41,1,1,0,2,0,2
9711,22397,8633,59,7,3,4,0,0,0
9712,22398,9869,42,4,1,3,8,4,4
9713,22398,9906,58,1,0,1,2,0,2
9714,22405,10205,54,10,5,5,3,1,2
9715,22405,8560,46,2,2,0,1,0,1
9716,22407,8633,64,10,4,6,2,1,1
9717,22407,8661,36,2,0,2,0,0,0
9718,22408,9869,38,2,1,1,1,1,0
9719,22408,8661,62,3,0,3,1,1,0
9720,22410,8634,67,9,6,3,3,1,2
9721,22410,10278,33,2,1,1,1,0,1
9722,22413,8302,52,3,1,2,2,1,1
9723,22413,9783,48,1,0,1,1,1,0
9724,22417,8633,66,9,5,4,1,1,0
9725,22417,8371,34,6,4,2,0,0,0
9726,22424,8581,42,6,4,2,3,1,2
9727,22424,10205,58,10,4,6,2,1,1
9728,22429,9869,26,3,2,1,3,0,3
9729,22429,8634,74,9,3,6,0,0,0
9730,22436,8558,63,7,3,4,1,1,0
9731,22436,8633,37,8,4,4,1,1,0
9732,22437,8560,47,11,4,7,2,0,2
9733,22437,8371,53,4,1,3,0,0,0
9734,22440,9906,47,7,6,1,1,0,1
9735,22440,8394,53,4,2,2,0,0,0
9736,22445,8581,29,2,2,0,3,1,2
9737,22445,8633,71,12,5,7,0,0,0
9738,22448,8661,28,5,3,2,4,1,3
9739,22448,8634,72,2,2,0,1,0,1
9740,22453,8696,54,7,4,3,1,1,0
9741,22453,10205,46,9,6,3,1,0,1
9742,22454,9864,62,5,3,2,3,1,2
9743,22454,9865,38,3,0,3,0,0,0
9744,22455,8633,66,13,3,10,2,1,1
9745,22455,9783,34,2,2,0,0,0,0
9746,22461,9906,55,1,1,0,2,1,1
9747,22461,8305,45,2,1,1,3,2,1
9748,22463,8696,44,3,2,1,2,1,1
9749,22463,9865,56,7,4,3,1,0,1
9750,22464,8633,59,7,1,6,1,0,1
9751,22464,9864,41,1,1,0,1,0,1
9752,22468,10267,56,4,2,2,1,1,0
9753,22468,8661,44,1,0,1,0,0,0
9754,22469,8634,78,13,6,7,2,2,0
9755,22469,8394,22,1,0,1,2,1,1
9756,22470,8315,47,5,2,3,3,1,2
9757,22470,8302,53,3,0,3,0,0,0
9758,22472,10205,48,3,1,2,3,2,1
9759,22472,9906,52,5,0,5,0,0,0
9760,22474,8696,35,2,1,1,2,2,0
9761,22474,8633,65,5,4,1,1,0,1
9762,22478,9869,49,5,3,2,1,1,0
9763,22478,10205,51,2,1,1,0,0,0
9764,22480,8302,33,3,1,2,4,1,3
9765,22480,8634,67,6,1,5,0,0,0
9766,22482,9906,51,10,3,7,2,2,0
9767,22482,9865,49,6,3,3,2,1,1
9768,22488,8661,58,3,3,0,2,1,1
9769,22488,8394,42,1,0,1,1,1,0
9770,22493,8633,46,9,8,1,1,1,0
9771,22493,9906,54,8,5,3,0,0,0
9772,22495,8696,51,4,1,3,4,1,3
9773,22495,8560,49,4,2,2,1,0,1
9774,22498,8315,51,10,1,9,2,0,2
9775,22498,9869,49,3,3,0,1,0,1
9776,22499,8634,69,10,3,7,3,0,3
9777,22499,9906,31,5,3,2,0,0,0
9778,22500,10278,55,9,6,3,2,2,0
9779,22500,10267,45,2,1,1,0,0,0
9780,22502,9864,49,5,4,1,4,2,2
9781,22502,8302,51,7,5,2,0,0,0
9782,22503,8305,55,4,2,2,2,1,1
9783,22503,9783,45,14,1,13,0,0,0
9784,22506,8633,52,8,3,5,2,2,0
9785,22506,8560,48,2,0,2,4,3,1
9786,22509,8305,43,5,2,3,4,2,2
9787,22509,10267,57,3,2,1,0,0,0
9788,22510,10205,31,2,1,1,1,0,1
9789,22510,8634,69,7,3,4,1,0,1
9790,22519,8305,56,6,4,2,1,1,0
9791,22519,8394,44,6,1,5,0,0,0
9792,22522,8315,51,6,4,2,6,5,1
9793,22522,8633,49,4,2,2,0,0,0
9794,22529,8394,46,9,4,5,2,1,1
9795,22529,10205,54,6,4,2,1,0,1
9796,22530,9865,36,2,1,1,1,1,0
9797,22530,10267,64,6,3,3,1,0,1
9798,22531,8633,31,6,5,1,3,2,1
9799,22531,8634,69,5,3,2,1,0,1
9800,22541,8633,42,5,5,0,2,1,1
9801,22541,10267,58,13,6,7,1,0,1
9802,22550,8394,43,2,2,0,3,1,2
9803,22550,8633,57,9,1,8,2,1,1
9804,22555,9783,41,2,2,0,1,0,1
9805,22555,9906,59,4,2,2,1,0,1
9806,22558,8661,48,5,3,2,3,1,2
9807,22558,10205,52,2,0,2,0,0,0
9808,22562,8560,45,4,3,1,8,2,6
9809,22562,10267,55,1,0,1,0,0,0
9810,22576,8696,48,5,3,2,2,1,1
9811,22576,9906,52,3,2,1,1,1,0
9812,22584,9783,25,5,2,3,1,1,0
9813,22584,8634,75,2,0,2,1,0,1
9814,22590,8560,59,7,6,1,3,1,2
9815,22590,8305,41,2,2,0,1,0,1
9816,22593,9783,45,7,2,5,3,2,1
9817,22593,10267,55,6,3,3,2,1,1
9818,22598,8661,55,6,4,2,2,2,0
9819,22598,8315,45,5,2,3,2,0,2
9820,22599,8634,73,7,4,3,1,1,0
9821,22599,9869,27,1,1,0,1,0,1
9822,22600,9906,38,2,0,2,2,1,1
9823,22600,10267,62,5,0,5,0,0,0
9824,22606,8633,63,13,8,5,2,1,1
9825,22606,8558,37,4,0,4,1,0,1
9826,22608,8634,70,12,4,8,2,2,0
9827,22608,8315,30,2,1,1,3,1,2
9828,22610,9906,51,4,2,2,2,0,2
9829,22610,8394,49,11,2,9,1,0,1
9830,22611,8302,63,7,5,2,1,0,1
9831,22611,10278,37,4,1,3,0,0,0
9832,22615,8633,69,12,5,7,3,0,3
9833,22615,8581,31,2,1,1,0,0,0
9834,22618,8634,75,9,4,5,1,1,0
9835,22618,8661,25,4,1,3,1,1,0
9836,22619,10267,54,5,1,4,4,0,4
9837,22619,8315,46,2,0,2,2,0,2
9838,22621,8302,47,9,8,1,4,3,1
9839,22621,9906,53,6,4,2,0,0,0
9840,22625,8633,60,8,6,2,1,0,1
9841,22625,9783,40,1,0,1,0,0,0
9842,22628,10267,45,2,2,0,4,2,2
9843,22628,8634,55,10,5,5,2,1,1
9844,22629,8394,41,4,2,2,3,3,0
9845,22629,8315,59,7,1,6,0,0,0
9846,22630,9869,39,5,3,2,2,1,1
9847,22630,8302,61,3,3,0,3,1,2
9848,22637,8558,41,6,2,4,3,0,3
9849,22637,8661,59,4,1,3,2,0,2
9850,22639,8634,69,10,4,6,2,1,1
9851,22639,8394,31,3,3,0,2,0,2
9852,22640,8315,48,4,2,2,3,2,1
9853,22640,8302,52,5,3,2,0,0,0
9854,22646,8560,49,4,1,3,3,1,2
9855,22646,9783,51,3,0,3,1,0,1
9856,22650,8315,44,6,3,3,2,1,1
9857,22650,8305,56,3,0,3,1,0,1
9858,22657,8661,65,7,4,3,8,3,5
9859,22657,8581,35,3,1,2,2,0,2
9860,22658,9906,42,7,2,5,2,2,0
9861,22658,8560,58,6,5,1,0,0,0
9862,22665,8558,43,7,5,2,2,2,0
9863,22665,7878,57,6,1,5,4,1,3
9864,22672,9906,46,6,1,5,1,1,0
9865,22672,8315,54,2,1,1,0,0,0
9866,22681,8633,62,7,7,0,1,1,0
9867,22681,8560,38,2,0,2,0,0,0
9868,22684,8302,51,11,3,8,2,1,1
9869,22684,7878,49,4,2,2,2,0,2
9870,22685,10267,55,4,2,2,1,1,0
9871,22685,8305,45,5,5,0,5,3,2
9872,22691,10205,42,4,1,3,1,1,0
9873,22691,8558,58,7,4,3,0,0,0
9874,22698,8558,58,10,2,8,4,2,2
9875,22698,8560,42,1,1,0,0,0,0
9876,22701,8603,63,10,5,5,2,0,2
9877,22701,10205,37,5,1,4,0,0,0
9878,22702,8315,57,3,2,1,1,0,1
9879,22702,8302,43,4,1,3,0,0,0
9880,22710,9869,51,5,3,2,2,2,0
9881,22710,8581,49,1,0,1,0,0,0
9882,22711,8560,38,6,4,2,3,2,1
9883,22711,8603,62,7,5,2,0,0,0
9884,22714,10205,51,7,3,4,7,4,3
9885,22714,9864,49,6,6,0,0,0,0
9886,22715,8302,43,7,5,2,2,0,2
9887,22715,8394,57,3,0,3,1,0,1
9888,22716,10267,46,3,1,2,2,1,1
9889,22716,8370,54,3,1,2,0,0,0
9890,22718,9906,46,9,3,6,4,3,1
9891,22718,8370,54,5,1,4,2,2,0
9892,22719,8696,36,1,1,0,5,2,3
9893,22719,10205,64,2,0,2,1,1,0
9894,22720,8302,55,5,1,4,2,1,1
9895,22720,8305,45,0,0,0,2,1,1
9896,22721,10267,42,5,4,1,3,2,1
9897,22721,8558,58,1,1,0,1,1,0
9898,22722,8581,30,4,2,2,6,2,4
9899,22722,8634,70,7,3,4,0,0,0
9900,22723,8371,58,6,3,3,4,2,2
9901,22723,8603,42,8,0,8,3,0,3
9902,22724,8661,39,5,2,3,2,2,0
9903,22724,8315,61,1,1,0,0,0,0
9904,22727,7878,47,4,2,2,1,1,0
9905,22727,8394,53,8,2,6,2,0,2
9906,22730,9869,33,7,4,3,2,2,0
9907,22730,8370,67,8,3,5,1,0,1
9908,22735,8603,46,5,1,4,2,1,1
9909,22735,10267,54,4,2,2,0,0,0
9910,22740,8581,44,8,4,4,1,1,0
9911,22740,7878,56,6,2,4,2,1,1
9912,22741,9906,67,13,6,7,2,0,2
9913,22741,8603,33,2,1,1,0,0,0
9914,22742,8633,55,8,5,3,1,1,0
9915,22742,8302,45,6,4,2,1,0,1
9916,22745,8634,59,3,3,0,5,2,3
9917,22745,8370,41,6,2,4,0,0,0
9918,22751,8370,40,5,2,3,1,0,1
9919,22751,8302,60,6,2,4,0,0,0
9920,22754,9906,43,3,1,2,1,1,0
9921,22754,9864,57,2,2,0,0,0,0
9922,22759,8696,47,5,4,1,1,0,1
9923,22759,8371,53,3,1,2,2,0,2
9924,22767,8581,47,8,4,4,1,0,1
9925,22767,8315,53,7,5,2,0,0,0
9926,22769,9906,58,11,4,7,3,1,2
9927,22769,8371,42,4,1,3,0,0,0
9928,22772,8302,43,8,4,4,1,1,0
9929,22772,9864,57,1,1,0,3,1,2
9930,22773,7878,42,4,3,1,2,1,1
9931,22773,8603,58,4,2,2,2,1,1
9932,22776,8394,38,4,3,1,1,0,1
9933,22776,8633,62,18,8,10,0,0,0
9934,22779,8560,47,9,4,5,3,2,1
9935,22779,9906,53,5,0,5,1,0,1
9936,22782,8633,54,12,5,7,1,1,0
9937,22782,8315,46,4,4,0,0,0,0
9938,22790,9864,45,5,4,1,1,1,0
9939,22790,8302,55,2,1,1,1,0,1
9940,22799,9906,51,3,1,2,1,1,0
9941,22799,10267,49,4,3,1,0,0,0
9942,22800,9864,45,4,4,0,1,1,0
9943,22800,7878,55,9,4,5,1,0,1
9944,22801,8633,61,5,1,4,1,1,0
9945,22801,8305,39,0,0,0,0,0,0
9946,22802,8371,52,7,2,5,3,2,1
9947,22802,9869,48,5,2,3,1,0,1
9948,22808,9864,55,8,4,4,1,0,1
9949,22808,8661,45,2,1,1,1,0,1
9950,22813,8394,41,5,1,4,3,2,1
9951,22813,8558,59,4,1,3,1,1,0
9952,22821,8394,55,11,8,3,3,0,3
9953,22821,8603,45,7,2,5,0,0,0
9954,22823,8305,49,11,3,8,2,1,1
9955,22823,8558,51,2,0,2,3,1,2
9956,22831,8581,32,1,0,1,5,2,3
9957,22831,8558,68,2,0,2,1,1,0
9958,22840,7878,56,7,2,5,1,1,0
9959,22840,10267,44,0,0,0,1,0,1
9960,22862,10267,45,4,1,3,2,1,1
9961,22862,8315,55,3,1,2,1,0,1
9962,22872,9906,45,8,2,6,3,0,3
9963,22872,8315,55,1,0,1,0,0,0
9964,22873,10205,37,2,2,0,2,2,0
9965,22873,8633,63,9,6,3,1,0,1
9966,22874,8302,64,7,4,3,4,2,2
9967,22874,8696,36,4,2,2,0,0,0
9968,22876,9864,55,4,2,2,1,1,0
9969,22876,8370,45,7,1,6,2,1,1
9970,22877,8634,71,7,5,2,3,3,0
9971,22877,7878,29,1,1,0,1,0,1
9972,22881,10205,46,8,5,3,2,2,0
9973,22881,8302,54,2,2,0,0,0,0
9974,22884,8315,55,8,4,4,1,1,0
9975,22884,8558,45,4,4,0,1,0,1
9976,22891,8633,62,7,3,4,2,1,1
9977,22891,8560,38,3,1,2,0,0,0
9978,22892,9906,51,3,1,2,2,1,1
9979,22892,8394,49,1,0,1,0,0,0
9980,22895,8305,37,3,1,2,4,2,2
9981,22895,10267,63,7,2,5,0,0,0
9982,22897,8634,59,6,5,1,1,0,1
9983,22897,8661,41,3,0,3,0,0,0
9984,22907,8394,51,4,3,1,2,1,1
9985,22907,9869,49,5,4,1,1,0,1
9986,22914,8370,45,7,2,5,1,1,0
9987,22914,8371,55,3,1,2,0,0,0
9988,22923,8633,52,9,5,4,1,1,0
9989,22923,9906,48,4,1,3,0,0,0
9990,22926,10267,57,4,4,0,2,1,1
9991,22926,8370,43,4,2,2,2,0,2
9992,22930,8633,72,5,2,3,1,1,0
9993,22930,9869,28,1,1,0,2,1,1
9994,22937,8634,71,10,7,3,1,0,1
9995,22937,8581,29,2,1,1,1,0,1
9996,22938,10267,54,5,1,4,1,1,0
9997,22938,8603,46,3,1,2,1,0,1
9998,22940,8633,34,5,3,2,1,1,0
9999,22940,8634,66,4,0,4,1,0,1
10000,22947,8302,68,8,3,5,1,1,0
10001,22947,8581,32,2,1,1,1,0,1
10002,22949,8394,35,9,3,6,2,1,1
10003,22949,8315,65,4,4,0,0,0,0
10004,22951,8371,49,1,1,0,1,1,0
10005,22951,10205,51,7,3,4,0,0,0
10006,22953,9869,40,3,2,1,1,0,1
10007,22953,8558,60,9,3,6,1,0,1
10008,22956,8603,48,2,2,0,3,1,2
10009,22956,9906,52,9,2,7,0,0,0
10010,22957,8633,53,3,3,0,2,1,1
10011,22957,8302,47,3,2,1,2,0,2
10012,22963,8634,66,5,4,1,1,0,1
10013,22963,8558,34,5,1,4,0,0,0
10014,22971,10267,62,6,3,3,1,1,0
10015,22971,8560,38,5,3,2,0,0,0
10016,22973,8634,61,6,4,2,3,2,1
10017,22973,8603,39,3,1,2,1,1,0
10018,22975,8633,64,9,4,5,1,1,0
10019,22975,8661,36,4,1,3,2,0,2
10020,22979,9906,67,3,2,1,3,3,0
10021,22979,8696,33,1,1,0,2,2,0
10022,22980,7878,37,3,1,2,4,2,2
10023,22980,10205,63,3,1,2,1,1,0
10024,22982,9869,36,11,3,8,1,0,1
10025,22982,10267,64,6,1,5,0,0,0
10026,22984,8633,71,10,5,5,2,0,2
10027,22984,8581,29,6,2,4,0,0,0
10028,22986,8315,62,10,2,8,1,0,1
10029,22986,8603,38,2,1,1,0,0,0
10030,22987,8302,56,5,3,2,4,2,2
10031,22987,8560,44,1,1,0,1,0,1
10032,22989,8696,32,2,1,1,1,0,1
10033,22989,8633,68,7,1,6,0,0,0
10034,22991,8394,55,8,2,6,3,1,2
10035,22991,8603,45,3,3,0,2,0,2
10036,23000,8302,42,6,3,3,2,0,2
10037,23000,10267,58,9,3,6,0,0,0
10038,23003,8603,55,6,1,5,1,0,1
10039,23003,8305,45,7,5,2,0,0,0
10040,23005,8560,52,5,2,3,2,0,2
10041,23005,8661,48,5,2,3,0,0,0
10042,23010,10267,62,14,9,5,2,1,1
10043,23010,7878,38,3,2,1,2,1,1
10044,23012,8661,43,4,4,0,2,1,1
10045,23012,8371,57,4,3,1,1,0,1
10046,23014,8634,74,6,1,5,1,1,0
10047,23014,9869,26,3,2,1,3,0,3
10048,23016,8633,54,5,4,1,4,2,2
10049,23016,8558,46,5,3,2,0,0,0
10050,23018,9906,59,8,2,6,2,2,0
10051,23018,7878,41,5,1,4,1,1,0
10052,23022,8696,24,3,2,1,2,1,1
10053,23022,8634,76,6,3,3,2,0,2
10054,23033,9864,45,6,2,4,1,0,1
10055,23033,8633,55,4,2,2,0,0,0
10056,23434,8634,53,10,4,6,2,0,2
10057,23434,8633,47,5,1,4,0,0,0
10058,23634,8634,65,9,5,4,5,2,3
10059,23634,8633,35,6,4,2,0,0,0
10060,23798,8302,46,6,2,4,1,0,1
10061,23798,10267,54,3,1,2,0,0,0
10062,23799,8581,49,4,1,3,2,1,1
10063,23799,10205,51,4,0,4,1,1,0
10064,23800,9906,43,6,4,2,4,2,2
10065,23800,8370,57,5,1,4,0,0,0
10066,23802,9910,59,8,5,3,1,0,1
10067,23802,8305,41,2,2,0,1,0,1
10068,23803,8560,59,10,5,5,2,0,2
10069,23803,8372,41,6,4,2,1,0,1
10070,23804,9783,46,5,2,3,3,1,2
10071,23804,7878,54,1,0,1,0,0,0
10072,23805,8634,69,4,1,3,3,1,2
10073,23805,10268,31,0,0,0,0,0,0
10074,23806,8633,67,9,7,2,1,0,1
10075,23806,7869,33,2,0,2,0,0,0
10076,23807,9865,59,7,5,2,2,2,0
10077,23807,8558,41,4,1,3,1,0,1
10078,23810,8305,44,5,1,4,1,1,0
10079,23810,9783,56,4,0,4,3,0,3
10080,23811,10268,41,4,3,1,5,2,3
10081,23811,8558,59,11,6,5,1,0,1
10082,23812,10267,41,2,1,1,4,2,2
10083,23812,10205,59,8,5,3,3,0,3
10084,23813,8315,43,5,3,2,3,1,2
10085,23813,8302,57,1,1,0,0,0,0
10086,23816,8633,69,8,3,5,2,2,0
10087,23816,7878,31,6,1,5,1,0,1
10088,23818,9906,42,1,1,0,5,2,3
10089,23818,8560,58,5,4,1,1,0,1
10090,23820,10268,47,6,3,3,1,1,0
10091,23820,8305,53,7,4,3,3,2,1
10092,23821,8558,58,5,2,3,2,1,1
10093,23821,10205,42,3,1,2,3,0,3
10094,23822,10267,46,3,2,1,3,1,2
10095,23822,8315,54,1,0,1,2,0,2
10096,23823,8581,39,7,4,3,3,1,2
10097,23823,8302,61,6,3,3,4,3,1
10098,23824,8634,70,4,3,1,3,2,1
10099,23824,9865,30,3,2,1,2,0,2
10100,23825,7878,34,4,1,3,1,1,0
10101,23825,9910,66,9,4,5,1,0,1
10102,23826,8633,52,7,3,4,5,3,2
10103,23826,8370,48,8,3,5,1,1,0
10104,23828,9864,47,2,0,2,1,1,0
10105,23828,9906,53,2,0,2,1,0,1
10106,23829,9783,54,9,3,6,1,1,0
10107,23829,8560,46,8,4,4,2,1,1
10108,23830,7869,48,5,3,2,1,1,0
10109,23830,10268,52,5,3,2,2,2,0
10110,23831,8305,46,7,1,6,2,1,1
10111,23831,10205,54,3,2,1,1,0,1
10112,23832,8315,54,3,2,1,1,1,0
10113,23832,8558,46,3,2,1,0,0,0
10114,23833,10267,67,10,3,7,1,0,1
10115,23833,8581,33,6,2,4,0,0,0
10116,23834,8634,71,8,5,3,1,0,1
10117,23834,8302,29,2,1,1,0,0,0
10118,23835,7878,55,16,7,9,2,2,0
10119,23835,9865,45,1,0,1,2,1,1
10120,23836,9910,56,6,3,3,2,1,1
10121,23836,8370,44,3,1,2,0,0,0
10122,23837,8372,35,5,2,3,1,1,0
10123,23837,8633,65,5,3,2,1,0,1
10124,23838,9783,49,3,1,2,1,1,0
10125,23838,9906,51,3,0,3,1,0,1
10126,23839,8560,51,8,4,4,2,1,1
10127,23839,10268,49,5,3,2,1,0,1
10128,23840,10205,49,5,1,4,5,2,3
10129,23840,7869,51,8,3,5,0,0,0
10130,23842,8558,58,5,4,1,1,1,0
10131,23842,8581,42,7,5,2,1,1,0
10132,23843,10267,30,6,2,4,2,0,2
10133,23843,8634,70,7,1,6,0,0,0
10134,23844,8302,71,5,3,2,7,1,6
10135,23844,7878,29,3,1,2,1,1,0
10136,23845,8370,48,5,3,2,2,1,1
10137,23845,9865,52,5,3,2,0,0,0
10138,23847,8633,60,11,6,5,1,1,0
10139,23847,9864,40,7,2,5,0,0,0
10140,23849,9906,54,2,1,1,1,1,0
10141,23849,10268,46,5,2,3,0,0,0
10142,23850,10205,60,13,6,7,4,3,1
10143,23850,8560,40,6,2,4,2,1,1
10144,23851,7869,37,3,2,1,3,2,1
10145,23851,8315,63,8,1,7,0,0,0
10146,23853,8558,23,2,2,0,1,0,1
10147,23853,8634,77,5,3,2,2,0,2
10148,23854,7878,37,5,3,2,3,1,2
10149,23854,10267,63,4,3,1,2,2,0
10150,23856,9865,56,4,3,1,2,2,0
10151,23856,8372,44,5,0,5,2,1,1
10152,23857,8633,53,12,7,5,2,2,0
10153,23857,9910,47,3,0,3,2,1,1
10154,23858,10268,47,6,3,3,2,2,0
10155,23858,9783,53,7,2,5,1,1,0
10156,23859,9906,53,3,2,1,3,2,1
10157,23859,10205,47,3,1,2,2,0,2
10158,23862,8634,76,11,3,8,3,2,1
10159,23862,8305,24,4,2,2,0,0,0
10160,23863,8558,43,4,3,1,1,1,0
10161,23863,7878,57,5,4,1,0,0,0
10162,23865,8372,38,3,3,0,2,0,2
10163,23865,8302,62,12,4,8,1,0,1
10164,23866,9865,37,6,3,3,1,0,1
10165,23866,8633,63,5,0,5,0,0,0
10166,23868,9864,52,11,7,4,1,1,0
10167,23868,10268,48,4,3,1,2,1,1
10168,23869,10205,52,10,8,2,3,2,1
10169,23869,9783,48,4,0,4,0,0,0
10170,23870,8315,55,2,1,1,1,0,1
10171,23870,9906,45,0,0,0,0,0,0
10172,23873,7878,47,6,5,1,1,0,1
10173,23873,8305,53,4,2,2,1,0,1
10174,23875,8372,55,4,3,1,1,1,0
10175,23875,10267,45,5,1,4,0,0,0
10176,23876,8302,39,5,3,2,3,1,2
10177,23876,8633,61,6,2,4,3,1,2
10178,23878,10205,52,9,5,4,6,2,4
10179,23878,10268,48,7,5,2,1,0,1
10180,23881,8634,68,8,3,5,1,1,0
10181,23881,8560,32,3,1,2,0,0,0
10182,23882,7869,45,1,1,0,4,2,2
10183,23882,7878,55,2,0,2,0,0,0
10184,23884,8372,47,5,3,2,2,0,2
10185,23884,8558,53,6,1,5,0,0,0
10186,23885,10267,39,3,2,1,1,0,1
10187,23885,8633,61,11,4,7,1,0,1
10188,23886,9910,48,4,2,2,1,1,0
10189,23886,8302,52,2,2,0,0,0,0
10190,23887,9864,68,7,3,4,7,1,6
10191,23887,9865,32,2,1,1,1,0,1
10192,23888,9864,47,6,3,3,2,1,1
10193,23888,10205,53,4,2,2,4,1,3
10194,23889,8315,60,6,3,3,2,1,1
10195,23889,10268,40,6,2,4,0,0,0
10196,23890,9783,52,8,2,6,2,1,1
10197,23890,8581,48,3,1,2,1,0,1
10198,23892,7878,58,6,3,3,1,1,0
10199,23892,8560,42,5,4,1,1,1,0
10200,23893,8370,64,8,2,6,1,1,0
10201,23893,7869,36,3,2,1,6,4,2
10202,23894,8372,49,7,3,4,3,1,2
10203,23894,8305,51,3,2,1,3,2,1
10204,23895,8558,45,5,3,2,2,1,1
10205,23895,8633,55,6,3,3,1,0,1
10206,23897,9865,49,9,2,7,1,1,0
10207,23897,8302,51,6,1,5,0,0,0
10208,23898,8315,54,7,4,3,1,0,1
10209,23898,10205,46,6,2,4,0,0,0
10210,23899,10268,54,6,4,2,3,1,2
10211,23899,8581,46,2,0,2,0,0,0
10212,23900,8634,64,5,2,3,2,1,1
10213,23900,9783,36,3,1,2,0,0,0
10214,23901,9906,59,7,4,3,2,1,1
10215,23901,7878,41,2,2,0,0,0,0
10216,23902,8560,49,3,2,1,4,2,2
10217,23902,8370,51,5,2,3,2,1,1
10218,23903,7869,57,7,3,4,1,1,0
10219,23903,8372,43,3,2,1,1,0,1
10220,23904,8633,59,14,10,4,1,0,1
10221,23904,8305,41,1,0,1,2,0,2
10222,23905,8558,52,5,2,3,3,0,3
10223,23905,9910,48,3,1,2,1,0,1
10224,23906,10267,72,7,3,4,6,4,2
10225,23906,9865,28,0,0,0,0,0,0
10226,23908,9864,41,10,6,4,1,1,0
10227,23908,10267,59,3,0,3,0,0,0
10228,23909,8302,52,5,3,2,1,0,1
10229,23909,8558,48,2,0,2,0,0,0
10230,23911,9910,59,6,4,2,3,2,1
10231,23911,7869,41,1,0,1,1,1,0
10232,23912,8633,55,6,3,3,1,1,0
10233,23912,8560,45,3,2,1,1,0,1
10234,23913,9906,46,5,2,3,3,2,1
10235,23913,8372,54,4,3,1,1,0,1
10236,23914,9783,47,5,2,3,2,2,0
10237,23914,8370,53,3,2,1,0,0,0
10238,23916,8634,76,11,5,6,2,1,1
10239,23916,10205,24,1,0,1,2,1,1
10240,23917,8581,42,4,2,2,3,2,1
10241,23917,8315,58,3,1,2,0,0,0
10242,23918,8302,56,7,4,3,1,1,0
10243,23918,10267,44,7,2,5,2,1,1
10244,23920,9910,57,5,4,1,1,1,0
10245,23920,8305,43,8,3,5,2,1,1
10246,23921,7869,40,6,4,2,1,1,0
10247,23921,8633,60,4,0,4,1,1,0
10248,23922,8372,43,5,3,2,5,2,3
10249,23922,8560,57,4,2,2,1,0,1
10250,23923,8370,67,2,1,1,1,1,0
10251,23923,9906,33,5,2,3,1,1,0
10252,23925,10268,22,3,3,0,2,2,0
10253,23925,8634,78,2,0,2,1,0,1
10254,23926,10205,52,5,1,4,2,1,1
10255,23926,8581,48,2,2,0,0,0,0
10256,23927,8315,53,7,3,4,4,4,0
10257,23927,9864,47,3,3,0,0,0,0
10258,23928,9864,56,6,2,4,1,0,1
10259,23928,10267,44,3,1,2,3,0,3
10260,23929,8302,61,8,4,4,1,0,1
10261,23929,8558,39,0,0,0,0,0,0
10262,23932,8560,43,1,1,0,1,1,0
10263,23932,8633,57,12,5,7,3,1,2
10264,23934,8370,57,6,4,2,1,1,0
10265,23934,9783,43,8,5,3,2,1,1
10266,23935,7878,59,7,3,4,2,1,1
10267,23935,10268,41,2,2,0,1,1,0
10268,23936,8634,67,6,5,1,1,1,0
10269,23936,10205,33,4,2,2,1,0,1
10270,23937,8315,48,7,2,5,1,1,0
10271,23937,8581,52,6,3,3,1,0,1
10272,23938,10267,54,4,1,3,1,1,0
10273,23938,8558,46,6,1,5,1,0,1
10274,23940,7869,54,8,2,6,1,1,0
10275,23940,9865,46,0,0,0,2,1,1
10276,23942,9906,46,8,3,5,3,1,2
10277,23942,8633,54,2,1,1,0,0,0
10278,23943,9783,61,7,5,2,3,1,2
10279,23943,8372,39,4,0,4,0,0,0
10280,23944,10268,43,8,5,3,1,1,0
10281,23944,8370,57,6,1,5,2,1,1
10282,23945,10205,46,5,2,3,8,2,6
10283,23945,7878,54,5,0,5,0,0,0
10284,23946,8634,73,10,4,6,2,2,0
10285,23946,8315,27,8,2,6,1,0,1
10286,23948,9864,58,10,3,7,1,1,0
10287,23948,8558,42,1,0,1,1,1,0
10288,23949,10267,55,4,3,1,5,3,2
10289,23949,8305,45,3,1,2,1,0,1
10290,23951,8560,59,2,1,1,1,1,0
10291,23951,9865,41,2,0,2,0,0,0
10292,23952,9906,34,5,2,3,1,0,1
10293,23952,9910,66,5,4,1,1,0,1
10294,23954,8372,55,7,3,4,2,0,2
10295,23954,10268,45,1,1,0,2,0,2
10296,23956,7878,51,5,2,3,1,1,0
10297,23956,8315,49,4,0,4,1,0,1
10298,23958,8305,49,6,4,2,6,1,5
10299,23958,8558,51,9,1,8,0,0,0
10300,23961,9865,46,3,0,3,3,0,3
10301,23961,9906,54,3,0,3,0,0,0
10302,23963,8633,57,6,4,2,4,1,3
10303,23963,10268,43,4,1,3,0,0,0
10304,23964,8372,42,5,1,4,2,1,1
10305,23964,10205,58,10,6,4,1,0,1
10306,23965,8315,52,12,6,6,1,1,0
10307,23965,8370,48,3,1,2,3,0,3
10308,23968,9864,53,6,5,1,1,0,1
10309,23968,8305,47,6,3,3,0,0,0
10310,23971,8302,65,5,3,2,1,0,1
10311,23971,9906,35,4,0,4,0,0,0
10312,23972,9865,36,6,4,2,2,1,1
10313,23972,9783,64,10,7,3,0,0,0
10314,23974,8633,60,8,4,4,2,1,1
10315,23974,10205,40,5,4,1,0,0,0
10316,23976,8370,64,5,3,2,2,0,2
10317,23976,8581,36,2,0,2,0,0,0
10318,23977,8634,70,7,4,3,1,0,1
10319,23977,7878,30,4,3,1,0,0,0
10320,23978,8305,44,9,6,3,2,2,0
10321,23978,7869,56,6,3,3,3,2,1
10322,23980,9906,46,4,2,2,3,1,2
10323,23980,10267,54,1,0,1,1,1,0
10324,23981,9783,52,4,2,2,1,0,1
10325,23981,8302,48,4,0,4,0,0,0
10326,23982,10268,58,8,3,5,2,1,1
10327,23982,9865,42,5,2,3,1,0,1
10328,23984,8633,65,6,2,4,3,2,1
10329,23984,8315,35,3,1,2,2,0,2
10330,23985,8581,53,6,4,2,2,1,1
10331,23985,8372,47,7,4,3,0,0,0
10332,23986,8370,43,4,3,1,1,0,1
10333,23986,8634,57,9,3,6,1,0,1
10334,23988,9864,55,8,6,2,6,2,4
10335,23988,7869,45,4,1,3,0,0,0
10336,23989,8305,47,7,6,1,4,1,3
10337,23989,8560,53,4,1,3,1,0,1
10338,23991,10267,52,9,5,4,1,1,0
10339,23991,9783,48,4,3,1,0,0,0
10340,23992,8302,54,5,3,2,1,1,0
10341,23992,10268,46,7,3,4,2,1,1
10342,23993,10205,61,14,7,7,2,2,0
10343,23993,9865,39,4,1,3,0,0,0
10344,23994,9910,60,6,1,5,2,1,1
10345,23994,8315,40,5,3,2,0,0,0
10346,23995,8633,68,8,5,3,2,0,2
10347,23995,8581,32,1,1,0,1,0,1
10348,23997,7878,38,4,4,0,4,2,2
10349,23997,8370,62,10,2,8,2,0,2
10350,23998,8560,69,3,2,1,3,2,1
10351,23998,7869,31,5,4,1,0,0,0
10352,23999,9906,53,5,4,1,3,2,1
10353,23999,8305,47,4,1,3,1,0,1
10354,24000,8558,44,3,2,1,4,2,2
10355,24000,9783,56,6,3,3,1,1,0
10356,24002,8302,44,5,4,1,2,0,2
10357,24002,10205,56,12,7,5,0,0,0
10358,24003,8315,60,14,9,5,1,1,0
10359,24003,9865,40,5,2,3,0,0,0
10360,24005,8634,52,6,2,4,2,2,0
10361,24005,8633,48,5,2,3,1,0,1
10362,24007,8370,51,8,3,5,5,0,5
10363,24007,9864,49,4,2,2,1,0,1
10364,24008,9864,54,13,4,9,2,0,2
10365,24008,8560,46,4,4,0,0,0,0
10366,24009,7869,55,5,2,3,1,1,0
10367,24009,9906,45,4,2,2,0,0,0
10368,24010,9783,53,4,1,3,3,1,2
10369,24010,8305,47,4,2,2,1,0,1
10370,24011,10268,55,4,1,3,1,1,0
10371,24011,8558,45,2,0,2,1,0,1
10372,24012,10205,49,4,2,2,2,1,1
10373,24012,10267,51,6,1,5,3,1,2
10374,24013,8302,47,7,5,2,4,2,2
10375,24013,8315,53,10,5,5,1,0,1
10376,24015,9910,38,2,1,1,2,1,1
10377,24015,8634,62,2,2,0,2,0,2
10378,24016,7878,39,6,1,5,2,1,1
10379,24016,8633,61,5,2,3,0,0,0
10380,24018,10267,59,7,4,3,1,0,1
10381,24018,8558,41,6,2,4,0,0,0
10382,24019,8302,58,6,3,3,2,1,1
10383,24019,8305,42,3,0,3,1,0,1
10384,24020,7869,49,3,2,1,3,2,1
10385,24020,9865,51,4,1,3,0,0,0
10386,24021,8560,49,9,3,6,2,0,2
10387,24021,9910,51,7,3,4,1,0,1
10388,24022,9906,35,4,2,2,2,1,1
10389,24022,8633,65,10,5,5,1,0,1
10390,24023,8372,58,6,3,3,3,2,1
10391,24023,9783,42,2,0,2,2,0,2
10392,24024,10268,38,3,2,1,3,1,2
10393,24024,8370,62,4,1,3,1,0,1
10394,24025,10205,60,6,1,5,1,1,0
10395,24025,7878,40,4,0,4,1,0,1
10396,24026,8315,39,4,2,2,1,1,0
10397,24026,8634,61,9,4,5,0,0,0
10398,24027,9864,58,8,6,2,1,1,0
10399,24027,8581,42,1,0,1,2,1,1
10400,24028,9906,53,4,3,1,1,1,0
10401,24028,8560,47,6,4,2,2,0,2
10402,24029,9783,52,5,4,1,2,0,2
10403,24029,7869,48,7,1,6,1,0,1
10404,24030,10268,55,6,2,4,2,1,1
10405,24030,8305,45,6,2,4,0,0,0
10406,24031,8558,47,7,5,2,3,2,1
10407,24031,10205,53,4,0,4,2,1,1
10408,24034,8634,67,9,3,6,1,1,0
10409,24034,9865,33,3,2,1,1,0,1
10410,24035,7878,30,3,2,1,2,1,1
10411,24035,9910,70,5,2,3,0,0,0
10412,24036,8370,54,13,6,7,2,1,1
10413,24036,8633,46,5,2,3,5,2,3
10414,24037,9864,53,6,1,5,4,2,2
10415,24037,8372,47,5,3,2,0,0,0
10416,24039,8560,48,6,3,3,2,1,1
10417,24039,9783,52,7,3,4,1,0,1
10418,24040,7869,51,4,1,3,3,2,1
10419,24040,10268,49,2,1,1,0,0,0
10420,24041,10205,48,3,1,2,3,1,2
10421,24041,8305,52,6,2,4,3,2,1
10422,24042,8315,52,3,0,3,3,1,2
10423,24042,8558,48,0,0,0,1,0,1
10424,24044,8634,65,9,5,4,1,1,0
10425,24044,8302,35,4,2,2,3,1,2
10426,24045,7878,40,10,4,6,5,2,3
10427,24045,9865,60,7,5,2,0,0,0
10428,24047,8372,37,3,2,1,4,2,2
10429,24047,8633,63,10,5,5,0,0,0
10430,24048,9783,54,5,2,3,2,2,0
10431,24048,9906,46,9,1,8,1,0,1
10432,24049,8560,51,3,2,1,4,3,1
10433,24049,10268,49,2,1,1,0,0,0
10434,24050,7869,42,10,8,2,3,1,2
10435,24050,10205,58,13,3,10,1,0,1
10436,24051,8315,62,9,5,4,0,0,0
10437,24051,8305,38,1,0,1,0,0,0
10438,24052,8581,49,6,3,3,0,0,0
10439,24052,8558,51,7,1,6,0,0,0
10440,24053,10267,37,4,2,2,0,0,0
10441,24053,8634,63,3,0,3,0,0,0
10442,24056,8372,39,5,2,3,0,0,0
10443,24056,9910,61,10,1,9,0,0,0
10444,24057,9864,33,3,2,1,0,0,0
10445,24057,8633,67,5,2,3,0,0,0
10446,24058,9783,47,4,2,2,0,0,0
10447,24058,9864,53,5,0,5,0,0,0
10448,24059,9906,55,9,7,2,0,0,0
10449,24059,10268,45,3,0,3,0,0,0
10450,24063,8634,66,7,3,4,0,0,0
10451,24063,8558,34,3,0,3,0,0,0
10452,24064,10267,61,6,4,2,0,0,0
10453,24064,7878,39,3,0,3,0,0,0
10454,24066,8372,46,5,3,2,0,0,0
10455,24066,9865,54,3,1,2,0,0,0
10456,24067,9910,52,7,4,3,0,0,0
10457,24067,8633,48,5,0,5,0,0,0
10458,24068,10268,59,5,1,4,0,0,0
10459,24068,9783,41,7,0,7,0,0,0
10460,24070,8315,56,4,4,0,0,0,0
10461,24070,8560,44,7,2,5,0,0,0
10462,24071,7869,54,2,2,0,0,0,0
10463,24071,8581,46,3,1,2,0,0,0
10464,24072,8634,71,8,3,5,0,0,0
10465,24072,8305,29,3,3,0,0,0,0
10466,24073,8558,47,2,1,1,0,0,0
10467,24073,7878,53,6,3,3,0,0,0
10468,24074,8370,49,5,3,2,0,0,0
10469,24074,10267,51,8,5,3,0,0,0
10470,24075,8302,41,7,3,4,0,0,0
10471,24075,8372,59,7,3,4,0,0,0
10472,24076,8633,58,5,2,3,0,0,0
10473,24076,9865,42,3,1,2,0,0,0
10474,24078,10268,40,2,2,0,0,0,0
10475,24078,9864,60,13,2,11,0,0,0
10476,24079,9783,55,3,2,1,0,0,0
10477,24079,10205,45,2,1,1,0,0,0
10478,24080,9906,54,5,2,3,0,0,0
10479,24080,8315,46,0,0,0,0,0,0
10480,24081,8581,44,6,2,4,0,0,0
10481,24081,8560,56,1,0,1,0,0,0
10482,24082,8634,66,9,6,3,0,0,0
10483,24082,7869,34,1,0,1,0,0,0
10484,24083,8305,51,7,2,5,0,0,0
10485,24083,7878,49,6,3,3,0,0,0
10486,24084,8558,49,6,4,2,0,0,0
10487,24084,8370,51,5,2,3,0,0,0
10488,24085,10267,63,3,3,0,0,0,0
10489,24085,8372,37,0,0,0,0,0,0
10490,24086,8633,56,7,3,4,0,0,0
10491,24086,8302,44,9,2,7,0,0,0
10492,24087,9865,42,4,1,3,0,0,0
10493,24087,9910,58,3,1,2,0,0,0
10494,24089,8315,48,5,2,3,0,0,0
10495,24089,9783,52,3,0,3,0,0,0
10496,24092,7878,59,11,6,5,0,0,0
10497,24092,7869,41,3,2,1,0,0,0
10498,24093,8305,43,4,1,3,0,0,0
10499,24093,8370,57,5,0,5,0,0,0
10500,24095,10267,41,3,1,2,0,0,0
10501,24095,8633,59,13,2,11,0,0,0
10502,24098,9864,49,6,3,3,0,0,0
10503,24098,10205,51,2,0,2,0,0,0
10504,24101,9906,31,5,1,4,0,0,0
10505,24101,8634,69,6,5,1,0,0,0
10506,24102,8560,64,6,3,3,0,0,0
10507,24102,7878,36,5,4,1,0,0,0
10508,24104,8305,55,6,5,1,0,0,0
10509,24104,8372,45,1,1,0,0,0,0
10510,24105,8633,59,6,3,3,0,0,0
10511,24105,8558,41,5,2,3,0,0,0
10512,24108,8315,51,6,3,3,0,0,0
10513,24108,10205,49,6,4,2,0,0,0
10514,24109,10268,55,9,5,4,0,0,0
10515,24109,8581,45,5,2,3,0,0,0
10516,24111,9906,53,1,0,1,0,0,0
10517,24111,7878,47,0,0,0,0,0,0
10518,24112,8370,62,3,3,0,0,0,0
10519,24112,8560,38,4,2,2,0,0,0
10520,24113,8372,43,2,1,1,0,0,0
10521,24113,7869,57,6,3,3,0,0,0
10522,24115,8558,48,3,3,0,0,0,0
10523,24115,9910,52,5,5,0,0,0,0
10524,24117,8302,49,6,5,1,0,0,0
10525,24117,9864,51,7,3,4,0,0,0
10526,24118,8558,35,8,2,6,0,0,0
10527,24118,9864,65,1,0,1,0,0,0
10528,24119,8305,56,8,3,5,0,0,0
10529,24119,10267,44,2,2,0,0,0,0
10530,24120,8302,42,10,5,5,0,0,0
10531,24120,7869,58,5,2,3,0,0,0
10532,24121,9865,43,7,4,3,0,0,0
10533,24121,8560,57,9,3,6,0,0,0
10534,24123,8633,59,7,5,2,0,0,0
10535,24123,9783,41,5,0,5,0,0,0
10536,24124,10268,63,9,3,6,0,0,0
10537,24124,8372,37,3,2,1,0,0,0
10538,24125,8370,55,4,3,1,0,0,0
10539,24125,10205,45,9,3,6,0,0,0
10540,24126,7878,35,1,1,0,0,0,0
10541,24126,8315,65,6,2,4,0,0,0
10542,24130,8302,54,8,4,4,0,0,0
10543,24130,8560,46,3,2,1,0,0,0
10544,24132,9910,54,4,1,3,0,0,0
10545,24132,9783,46,3,1,2,0,0,0
10546,24133,10268,36,4,2,2,0,0,0
10547,24133,8633,64,8,5,3,0,0,0
10548,24137,9864,33,3,1,2,0,0,0
10549,24137,8634,67,1,1,0,0,0,0
10550,24138,9864,64,4,4,0,0,0,0
10551,24138,8305,36,2,1,1,0,0,0
10552,24141,9906,48,4,2,2,0,0,0
10553,24141,8302,52,3,0,3,0,0,0
10554,24142,9865,47,7,5,2,0,0,0
10555,24142,9783,53,2,0,2,0,0,0
10556,24143,10268,43,6,2,4,0,0,0
10557,24143,9910,57,9,5,4,0,0,0
10558,24144,10205,48,11,8,3,0,0,0
10559,24144,8633,52,5,2,3,0,0,0
10560,24145,8315,70,5,1,4,0,0,0
10561,24145,8372,30,3,2,1,0,0,0
10562,24146,8370,57,3,3,0,0,0,0
10563,24146,8581,43,2,0,2,0,0,0
10564,24147,7878,29,2,2,0,0,0,0
10565,24147,8634,71,11,3,8,0,0,0
10566,24148,8305,57,5,2,3,0,0,0
10567,24148,7869,43,4,0,4,0,0,0
10568,24149,8558,46,5,3,2,0,0,0
10569,24149,8560,54,5,2,3,0,0,0
10570,24150,9906,59,7,3,4,0,0,0
10571,24150,10267,41,2,0,2,0,0,0
10572,24151,8302,56,7,2,5,0,0,0
10573,24151,9783,44,5,1,4,0,0,0
10574,24152,10268,45,1,1,0,0,0,0
10575,24152,9865,55,2,0,2,0,0,0
10576,24153,9910,65,9,3,6,0,0,0
10577,24153,10205,35,1,0,1,0,0,0
10578,24154,8315,34,6,3,3,0,0,0
10579,24154,8633,66,9,2,7,0,0,0
10580,24155,8581,43,4,3,1,0,0,0
10581,24155,8372,57,6,3,3,0,0,0
10582,24156,8370,38,6,2,4,0,0,0
10583,24156,8634,62,8,1,7,0,0,0
10584,24157,7878,45,4,1,3,0,0,0
10585,24157,9864,55,4,1,3,0,0,0
10586,24158,9864,42,3,1,2,0,0,0
10587,24158,7869,58,3,0,3,0,0,0
10588,24160,9906,59,11,6,5,0,0,0
10589,24160,8558,41,1,1,0,0,0,0
10590,24161,9783,41,6,4,2,0,0,0
10591,24161,10267,59,3,1,2,0,0,0
10592,24162,8302,38,8,1,7,0,0,0
10593,24162,10268,62,3,2,1,0,0,0
10594,24164,8315,45,9,6,3,0,0,0
10595,24164,9910,55,2,0,2,0,0,0
10596,24165,8633,62,10,4,6,0,0,0
10597,24165,8581,38,3,1,2,0,0,0
10598,24167,8370,59,4,2,2,0,0,0
10599,24167,7878,41,3,0,3,0,0,0
10600,24169,9906,61,8,7,1,0,0,0
10601,24169,8305,39,6,0,6,0,0,0
10602,24172,8302,55,7,3,4,0,0,0
10603,24172,10205,45,5,4,1,0,0,0
10604,24173,8315,56,2,1,1,0,0,0
10605,24173,9865,44,4,1,3,0,0,0
10606,24174,9910,70,4,2,2,0,0,0
10607,24174,8581,30,2,1,1,0,0,0
10608,24175,8633,41,9,5,4,0,0,0
10609,24175,8634,59,7,3,4,0,0,0
10610,24178,8581,36,3,3,0,0,0,0
10611,24178,9910,64,7,3,4,0,0,0
10612,24180,9864,53,9,4,5,0,0,0
10613,24180,8302,47,3,1,2,0,0,0
10614,24182,8372,42,4,3,1,0,0,0
10615,24182,7878,58,6,2,4,0,0,0
10616,24183,8305,63,6,2,4,0,0,0
10617,24183,8558,37,1,1,0,0,0,0
10618,24184,10205,38,3,1,2,0,0,0
10619,24184,8603,62,8,0,8,0,0,0
10620,24186,8560,42,8,5,3,0,0,0
10621,24186,9783,58,7,2,5,0,0,0
10622,24187,8370,58,6,5,1,0,0,0
10623,24187,10267,42,4,2,2,0,0,0
10624,24188,8372,46,4,3,1,0,0,0
10625,24188,8370,54,2,1,1,0,0,0
10626,24194,9906,55,6,5,1,0,0,0
10627,24194,9783,45,3,0,3,0,0,0
10628,24195,9864,57,5,2,3,0,0,0
10629,24195,9869,43,4,0,4,0,0,0
10630,24196,8315,51,9,3,6,0,0,0
10631,24196,8603,49,6,3,3,0,0,0
10632,24197,7878,44,5,3,2,0,0,0
10633,24197,8558,56,5,1,4,0,0,0
10634,24198,8305,57,3,1,2,0,0,0
10635,24198,8372,43,9,3,6,0,0,0
10636,24199,8634,60,6,3,3,0,0,0
10637,24199,10205,40,3,1,2,0,0,0
10638,24200,8633,55,14,6,8,0,0,0
10639,24200,8302,45,5,1,4,0,0,0
10640,24202,10267,41,2,1,1,0,0,0
10641,24202,9910,59,9,5,4,0,0,0
10642,24203,8581,55,9,2,7,0,0,0
10643,24203,9783,45,6,2,4,0,0,0
10644,24206,8558,54,2,2,0,0,0,0
10645,24206,8315,46,2,1,1,0,0,0
10646,24208,8370,60,2,1,1,0,0,0
10647,24208,8305,40,10,5,5,0,0,0
10648,24209,8372,43,10,5,5,0,0,0
10649,24209,10205,57,3,2,1,0,0,0
10650,24210,8634,58,6,3,3,0,0,0
10651,24210,8633,42,7,1,6,0,0,0
10652,24213,9910,59,5,3,2,0,0,0
10653,24213,9783,41,1,0,1,0,0,0
10654,24214,8581,44,3,2,1,0,0,0
10655,24214,9869,56,3,1,2,0,0,0
10656,24216,9864,55,10,7,3,0,0,0
10657,24216,8558,45,2,1,1,0,0,0
10658,24217,8315,58,10,5,5,0,0,0
10659,24217,7878,42,3,2,1,0,0,0
10660,24218,8305,41,7,6,1,0,0,0
10661,24218,10205,59,0,0,0,0,0,0
10662,24219,8372,38,4,2,2,0,0,0
10663,24219,8633,62,8,6,2,0,0,0
10664,24220,8560,44,5,1,4,0,0,0
10665,24220,8634,56,3,1,2,0,0,0
10666,24221,8302,61,8,4,4,0,0,0
10667,24221,10267,39,0,0,0,0,0,0
10668,24223,9910,52,2,2,0,0,0,0
10669,24223,9869,48,1,1,0,0,0,0
10670,24224,8603,49,5,2,3,0,0,0
10671,24224,8581,51,2,1,1,0,0,0
10672,24225,9906,51,7,3,4,0,0,0
10673,24225,8558,49,2,0,2,0,0,0
10674,24226,7878,56,5,4,1,0,0,0
10675,24226,9864,44,7,4,3,0,0,0
10676,24230,8372,39,4,1,3,0,0,0
10677,24230,8560,61,5,1,4,0,0,0
10678,24231,10267,36,6,2,4,0,0,0
10679,24231,8634,64,9,4,5,0,0,0
10680,24232,9783,45,3,1,2,0,0,0
10681,24232,8302,55,1,0,1,0,0,0
10682,24234,9910,40,3,2,1,0,0,0
10683,24234,8603,60,10,3,7,0,0,0
10684,24235,8581,44,5,2,3,0,0,0
10685,24235,8558,56,3,0,3,0,0,0
10686,24236,9906,54,4,3,1,0,0,0
10687,24236,7878,46,5,2,3,0,0,0
10688,24237,8315,47,3,1,2,0,0,0
10689,24237,9864,53,4,3,1,0,0,0
10690,24238,8633,57,5,3,2,0,0,0
10691,24238,10205,43,3,1,2,0,0,0
10692,24239,8560,58,5,3,2,0,0,0
10693,24239,8305,42,6,3,3,0,0,0
10694,24240,8372,51,8,4,4,0,0,0
10695,24240,10267,49,1,0,1,0,0,0
10696,24241,8634,68,7,3,4,0,0,0
10697,24241,9783,32,2,1,1,0,0,0
10698,24243,8306,61,8,5,3,0,0,0
10699,24243,8603,39,3,2,1,0,0,0
10700,24244,9910,56,5,3,2,0,0,0
10701,24244,8558,44,2,1,1,0,0,0
10702,24246,9906,48,3,2,1,0,0,0
10703,24246,8315,52,7,4,3,0,0,0
10704,24247,8370,52,4,3,1,0,0,0
10705,24247,9864,48,8,4,4,0,0,0
10706,24250,8305,39,3,1,2,0,0,0
10707,24250,10267,61,7,1,6,0,0,0
10708,24252,8634,70,6,3,3,0,0,0
10709,24252,9869,30,2,0,2,0,0,0
10710,24254,8306,46,5,4,1,0,0,0
10711,24254,8558,54,6,2,4,0,0,0
10712,24256,8315,53,7,2,5,0,0,0
10713,24256,8581,47,2,2,0,0,0,0
10714,24257,9864,56,5,2,3,0,0,0
10715,24257,9906,44,6,2,4,0,0,0
10716,24258,8633,52,11,7,4,0,0,0
10717,24258,8560,48,2,1,1,0,0,0
10718,24259,10205,52,4,3,1,0,0,0
10719,24259,10267,48,3,0,3,0,0,0
10720,24264,7878,41,8,3,5,0,0,0
10721,24264,8306,59,2,0,2,0,0,0
10722,24265,8315,42,6,4,2,0,0,0
10723,24265,9910,58,4,3,1,0,0,0
10724,24266,9864,55,7,2,5,0,0,0
10725,24266,8581,45,3,1,2,0,0,0
10726,24267,9906,41,7,5,2,0,0,0
10727,24267,8370,59,5,2,3,0,0,0
10728,24269,8633,53,8,4,4,0,0,0
10729,24269,10267,47,3,1,2,0,0,0
10730,24270,9783,56,4,1,3,0,0,0
10731,24270,10205,44,2,0,2,0,0,0
10732,24271,9869,47,5,4,1,0,0,0
10733,24271,8305,53,4,3,1,0,0,0
10734,24272,8603,59,6,1,5,0,0,0
10735,24272,8372,41,1,0,1,0,0,0
10736,24273,8558,26,3,2,1,0,0,0
10737,24273,8634,74,4,0,4,0,0,0
10738,24274,7878,39,3,2,1,0,0,0
10739,24274,8302,61,6,1,5,0,0,0
10740,24275,8306,60,6,3,3,0,0,0
10741,24275,8315,40,6,5,1,0,0,0
10742,24277,9906,53,5,3,2,0,0,0
10743,24277,8581,47,2,0,2,0,0,0
10744,24278,8560,52,11,2,9,0,0,0
10745,24278,10267,48,3,2,1,0,0,0
10746,24279,9783,47,7,3,4,0,0,0
10747,24279,8633,53,6,3,3,0,0,0
10748,24281,8603,49,4,2,2,0,0,0
10749,24281,8305,51,3,2,1,0,0,0
10750,24282,8372,53,8,3,5,0,0,0
10751,24282,8558,47,3,1,2,0,0,0
10752,24283,8634,60,5,3,2,0,0,0
10753,24283,7878,40,5,1,4,0,0,0
10754,24285,9864,42,2,2,0,0,0,0
10755,24285,8306,58,3,0,3,0,0,0
10756,24287,8370,54,5,1,4,0,0,0
10757,24287,8581,46,4,0,4,0,0,0
10758,24288,9910,66,5,3,2,0,0,0
10759,24288,8370,34,0,0,0,0,0,0
10760,24290,8302,56,17,4,13,0,0,0
10761,24290,9906,44,7,4,3,0,0,0
10762,24291,8634,66,17,7,10,0,0,0
10763,24291,9864,34,1,1,0,0,0,0
10764,24293,7878,42,4,3,1,0,0,0
10765,24293,8305,58,6,1,5,0,0,0
10766,24294,10205,57,4,2,2,0,0,0
10767,24294,8558,43,3,1,2,0,0,0
10768,24295,8633,67,10,4,6,0,0,0
10769,24295,8603,33,2,1,1,0,0,0
10770,24296,9869,38,5,3,2,0,0,0
10771,24296,8560,62,2,1,1,0,0,0
10772,24298,9910,54,7,3,4,0,0,0
10773,24298,8581,46,8,2,6,0,0,0
10774,24299,9906,44,6,2,4,0,0,0
10775,24299,8306,56,5,3,2,0,0,0
10776,24300,9864,45,6,2,4,0,0,0
10777,24300,8302,55,3,0,3,0,0,0
10778,24302,8372,53,4,3,1,0,0,0
10779,24302,7878,47,0,0,0,0,0,0
10780,24303,8305,42,4,3,1,0,0,0
10781,24303,8558,58,5,2,3,0,0,0
10782,24307,8370,52,8,3,5,0,0,0
10783,24307,10267,48,8,3,5,0,0,0
10784,24309,8306,58,6,3,3,0,0,0
10785,24309,8581,42,6,2,4,0,0,0
10786,24312,8372,47,2,1,1,0,0,0
10787,24312,8315,53,2,2,0,0,0,0
10788,24313,7878,51,9,4,5,0,0,0
10789,24313,8305,49,3,0,3,0,0,0
10790,24315,8603,39,1,1,0,0,0,0
10791,24315,8633,61,8,2,6,0,0,0
10792,24316,8560,58,3,1,2,0,0,0
10793,24316,9869,42,3,0,3,0,0,0
10794,24317,9783,49,4,3,1,0,0,0
10795,24317,10267,51,4,3,1,0,0,0
10796,24318,9910,46,4,2,2,0,0,0
10797,24318,8306,54,5,3,2,0,0,0
10798,24320,9906,35,4,1,3,0,0,0
10799,24320,8634,65,4,3,1,0,0,0
10800,24321,9864,47,2,1,1,0,0,0
10801,24321,8372,53,2,1,1,0,0,0
10802,24322,8315,43,5,2,3,0,0,0
10803,24322,8305,57,3,1,2,0,0,0
10804,24323,10205,58,6,5,1,0,0,0
10805,24323,7878,42,6,4,2,0,0,0
10806,24326,10267,57,5,4,1,0,0,0
10807,24326,9869,43,2,0,2,0,0,0
10808,24327,8370,48,3,2,1,0,0,0
10809,24327,9783,52,4,1,3,0,0,0
10810,24328,8370,49,8,4,4,0,0,0
10811,24328,8306,51,4,2,2,0,0,0
10812,24329,9910,74,13,2,11,0,0,0
10813,24329,8302,26,3,2,1,0,0,0
10814,24330,8581,38,4,1,3,0,0,0
10815,24330,8634,62,5,2,3,0,0,0
10816,24333,10205,40,5,2,3,0,0,0
10817,24333,8315,60,2,2,0,0,0,0
10818,24334,7878,36,6,3,3,0,0,0
10819,24334,8633,64,6,1,5,0,0,0
10820,24335,8560,44,3,0,3,0,0,0
10821,24335,8558,56,1,0,1,0,0,0
10822,24337,9783,55,4,1,3,0,0,0
10823,24337,9869,45,6,3,3,0,0,0
10824,24338,8306,48,8,4,4,0,0,0
10825,24338,8302,52,4,2,2,0,0,0
10826,24339,9910,31,4,3,1,0,0,0
10827,24339,8634,69,7,3,4,0,0,0
10828,24340,8372,49,6,3,3,0,0,0
10829,24340,8581,51,4,1,3,0,0,0
10830,24341,8305,56,6,3,3,0,0,0
10831,24341,9906,44,3,2,1,0,0,0
10832,24342,10205,52,6,5,1,0,0,0
10833,24342,9864,48,2,1,1,0,0,0
10834,24343,8315,40,4,4,0,0,0,0
10835,24343,8633,60,8,4,4,0,0,0
10836,24344,8560,48,3,1,2,0,0,0
10837,24344,7878,52,4,1,3,0,0,0
10838,24345,10267,60,9,6,3,0,0,0
10839,24345,8558,40,10,4,6,0,0,0
10840,24346,9783,55,17,8,9,0,0,0
10841,24346,8603,45,0,0,0,0,0,0
10842,24347,8370,59,6,3,3,0,0,0
10843,24347,9869,41,4,2,2,0,0,0
10844,24348,8302,43,6,4,2,0,0,0
10845,24348,8370,57,3,0,3,0,0,0
10846,24349,8634,54,8,4,4,0,0,0
10847,24349,8306,46,7,4,3,0,0,0
10848,24350,9910,64,6,4,2,0,0,0
10849,24350,8372,36,4,1,3,0,0,0
10850,24351,8581,54,3,3,0,0,0,0
10851,24351,8305,46,9,3,6,0,0,0
10852,24354,8560,45,5,4,1,0,0,0
10853,24354,8315,55,4,2,2,0,0,0
10854,24355,10267,49,7,5,2,0,0,0
10855,24355,7878,51,4,2,2,0,0,0
10856,24356,9783,54,11,5,6,0,0,0
10857,24356,8558,46,13,7,6,0,0,0
10858,24358,8634,68,9,3,6,0,0,0
10859,24358,8302,32,4,2,2,0,0,0
10860,24361,8581,47,3,2,1,0,0,0
10861,24361,10205,53,0,0,0,0,0,0
10862,24362,9906,31,5,3,2,0,0,0
10863,24362,8633,69,8,3,5,0,0,0
10864,24363,8560,60,4,2,2,0,0,0
10865,24363,9864,40,4,1,3,0,0,0
10866,24365,9783,64,5,2,3,0,0,0
10867,24365,7878,36,7,1,6,0,0,0
10868,24366,8558,44,5,2,3,0,0,0
10869,24366,9869,56,3,1,2,0,0,0
10870,24368,8370,36,3,2,1,0,0,0
10871,24368,8634,64,5,3,2,0,0,0
10872,24369,8302,53,7,2,5,0,0,0
10873,24369,8372,47,7,3,4,0,0,0
10874,24370,8305,44,6,5,1,0,0,0
10875,24370,8306,56,3,2,1,0,0,0
10876,24376,7878,52,7,4,3,0,0,0
10877,24376,9869,48,0,0,0,0,0,0
10878,24379,8302,54,5,5,0,0,0,0
10879,24379,8305,46,5,5,0,0,0,0
10880,24380,8306,43,4,3,1,0,0,0
10881,24380,10205,57,5,3,2,0,0,0
10882,24381,9910,44,3,1,2,0,0,0
10883,24381,8633,56,8,3,5,0,0,0
10884,24384,9783,57,6,5,1,0,0,0
10885,24384,9864,43,0,0,0,0,0,0
10886,24385,8315,55,4,1,3,0,0,0
10887,24385,9869,45,2,1,1,0,0,0
10888,24387,8558,34,7,3,4,0,0,0
10889,24387,8370,66,2,2,0,0,0,0
10890,24388,8370,58,3,2,1,0,0,0
10891,24388,8372,42,1,0,1,0,0,0
10892,24389,8634,65,4,2,2,0,0,0
10893,24389,8305,35,1,0,1,0,0,0
10894,24390,10205,45,7,2,5,0,0,0
10895,24390,8302,55,2,0,2,0,0,0
10896,24391,8306,48,7,3,4,0,0,0
10897,24391,8633,52,4,4,0,0,0,0
10898,24392,8560,57,7,1,6,0,0,0
10899,24392,9910,43,1,0,1,0,0,0
10900,24393,10267,54,4,1,3,0,0,0
10901,24393,8581,46,5,4,1,0,0,0
10902,24394,9906,52,7,1,6,0,0,0
10903,24394,9783,48,2,0,2,0,0,0
10904,24395,9869,52,5,2,3,0,0,0
10905,24395,9864,48,4,2,2,0,0,0
10906,24397,7878,42,5,2,3,0,0,0
10907,24397,8558,58,3,1,2,0,0,0
10908,24398,9910,62,14,6,8,0,0,0
10909,24398,8306,38,4,2,2,0,0,0
10910,24399,8581,52,6,1,5,0,0,0
10911,24399,8302,48,4,1,3,0,0,0
10912,24400,9906,30,4,1,3,0,0,0
10913,24400,8634,70,5,3,2,0,0,0
10914,24403,7878,52,6,1,5,0,0,0
10915,24403,10205,48,2,1,1,0,0,0
10916,24404,8558,47,6,3,3,0,0,0
10917,24404,8633,53,1,0,1,0,0,0
10918,24405,8560,59,5,3,2,0,0,0
10919,24405,8603,41,3,3,0,0,0,0
10920,24406,10267,55,9,4,5,0,0,0
10921,24406,9869,45,8,1,7,0,0,0
10922,24407,8370,65,3,2,1,0,0,0
10923,24407,9783,35,7,3,4,0,0,0
10924,24408,8305,46,3,1,2,0,0,0
10925,24408,8372,54,10,6,4,0,0,0
10926,24409,10205,37,9,4,5,0,0,0
10927,24409,8634,63,6,2,4,0,0,0
10928,24411,8560,62,7,3,4,0,0,0
10929,24411,8306,38,7,6,1,0,0,0
10930,24417,8370,67,5,3,2,0,0,0
10931,24417,7878,33,3,2,1,0,0,0
10932,24418,8305,44,8,2,6,0,0,0
10933,24418,8370,56,9,5,4,0,0,0
10934,24419,8372,49,6,3,3,0,0,0
10935,24419,10205,51,3,1,2,0,0,0
10936,24421,8302,64,8,4,4,0,0,0
10937,24421,8560,36,3,2,1,0,0,0
10938,24423,9783,39,3,2,1,0,0,0
10939,24423,9910,61,3,1,2,0,0,0
10940,24424,8581,52,8,3,5,0,0,0
10941,24424,9869,48,6,4,2,0,0,0
10942,24425,9906,52,10,4,6,0,0,0
10943,24425,8603,48,4,2,2,0,0,0
10944,24426,8558,37,2,1,1,0,0,0
10945,24426,9864,63,6,0,6,0,0,0
10946,24427,7878,47,3,1,2,0,0,0
10947,24427,8315,53,1,1,0,0,0,0
10948,24428,10205,52,4,1,3,0,0,0
10949,24428,8305,48,7,6,1,0,0,0
10950,24429,8372,45,3,1,2,0,0,0
10951,24429,8633,55,2,1,1,0,0,0
10952,24432,9783,45,7,2,5,0,0,0
10953,24432,8306,55,2,2,0,0,0,0
10954,24434,8581,49,4,2,2,0,0,0
10955,24434,8603,51,2,0,2,0,0,0
10956,24435,9906,49,4,3,1,0,0,0
10957,24435,8558,51,3,1,2,0,0,0
10958,24440,8372,43,4,1,3,0,0,0
10959,24440,8560,57,3,1,2,0,0,0
10960,24441,8634,65,14,9,5,0,0,0
10961,24441,10267,35,2,0,2,0,0,0
10962,24442,8302,58,4,3,1,0,0,0
10963,24442,9783,42,4,1,3,0,0,0
10964,24443,9869,44,4,2,2,0,0,0
10965,24443,8306,56,3,1,2,0,0,0
10966,24444,9910,63,8,5,3,0,0,0
10967,24444,8603,37,4,1,3,0,0,0
10968,24445,8581,52,5,3,2,0,0,0
10969,24445,8558,48,2,0,2,0,0,0
10970,24446,9906,55,2,1,1,0,0,0
10971,24446,7878,45,3,2,1,0,0,0
10972,24448,8633,61,8,4,4,0,0,0
10973,24448,10205,39,4,1,3,0,0,0
10974,24449,8560,57,8,2,6,0,0,0
10975,24449,8305,43,1,0,1,0,0,0
10976,24451,8634,66,4,3,1,0,0,0
10977,24451,9783,34,9,4,5,0,0,0
10978,24452,9869,47,6,4,2,0,0,0
10979,24452,8302,53,7,3,4,0,0,0
10980,24454,8558,40,5,2,3,0,0,0
10981,24454,9910,60,0,0,0,0,0,0
10982,24455,7878,49,5,3,2,0,0,0
10983,24455,8581,51,7,0,7,0,0,0
10984,24456,8315,68,7,2,5,0,0,0
10985,24456,9906,32,2,1,1,0,0,0
10986,24457,9864,52,4,2,2,0,0,0
10987,24457,8370,48,5,2,3,0,0,0
10988,24459,8560,57,2,1,1,0,0,0
10989,24459,10205,43,6,2,4,0,0,0
10990,24460,10267,56,2,1,1,0,0,0
10991,24460,8305,44,11,4,7,0,0,0
10992,24461,8372,49,4,1,3,0,0,0
10993,24461,9783,51,1,1,0,0,0,0
10994,24462,8634,73,7,3,4,0,0,0
10995,24462,9869,27,4,3,1,0,0,0
10996,24463,8302,56,3,2,1,0,0,0
10997,24463,8603,44,2,0,2,0,0,0
10998,24464,8306,62,8,5,3,0,0,0
10999,24464,8558,38,8,4,4,0,0,0
11000,24465,9910,59,8,7,1,0,0,0
11001,24465,7878,41,8,2,6,0,0,0
11002,24466,8315,65,8,4,4,0,0,0
11003,24466,8581,35,6,3,3,0,0,0
11004,24467,9864,47,4,3,1,0,0,0
11005,24467,9906,53,5,2,3,0,0,0
11006,24468,8633,54,8,6,2,0,0,0
11007,24468,8560,46,5,2,3,0,0,0
11008,24470,9783,53,10,5,5,0,0,0
11009,24470,8305,47,4,1,3,0,0,0
11010,24471,8372,53,7,2,5,0,0,0
11011,24471,9869,47,1,0,1,0,0,0
11012,24472,8603,33,1,1,0,0,0,0
11013,24472,8634,67,4,2,2,0,0,0
11014,24473,8558,49,6,1,5,0,0,0
11015,24473,8302,51,1,0,1,0,0,0
11016,24474,8306,59,5,2,3,0,0,0
11017,24474,7878,41,3,3,0,0,0,0
11018,24476,9864,54,10,6,4,0,0,0
11019,24476,8581,46,7,2,5,0,0,0
11020,24477,9906,38,7,4,3,0,0,0
11021,24477,8370,62,8,3,5,0,0,0
11022,24478,8560,38,6,2,4,0,0,0
11023,24478,8370,62,9,4,5,0,0,0
11024,24479,8633,46,7,4,3,0,0,0
11025,24479,10267,54,8,1,7,0,0,0
11026,24480,9783,38,3,2,1,0,0,0
11027,24480,10205,62,5,3,2,0,0,0
11028,24481,8305,52,10,5,5,0,0,0
11029,24481,9869,48,2,1,1,0,0,0
11030,24483,8634,72,4,4,0,0,0,0
11031,24483,8558,28,3,2,1,0,0,0
11032,24484,8302,61,9,4,5,0,0,0
11033,24484,7878,39,4,3,1,0,0,0
11034,24485,8315,40,4,1,3,0,0,0
11035,24485,8306,60,1,0,1,0,0,0
11036,24486,9864,40,6,2,4,0,0,0
11037,24486,9910,60,4,1,3,0,0,0
11038,24487,8581,51,5,2,3,0,0,0
11039,24487,9906,49,6,1,5,0,0,0
11040,24489,8633,60,5,3,2,0,0,0
11041,24489,9783,40,4,0,4,0,0,0
11042,24490,9869,52,9,4,5,0,0,0
11043,24490,10205,48,8,3,5,0,0,0
11044,24491,8305,40,6,2,4,0,0,0
11045,24491,8603,60,5,2,3,0,0,0
11046,24492,8558,53,3,2,1,0,0,0
11047,24492,8372,47,8,1,7,0,0,0
11048,24493,8634,67,6,4,2,0,0,0
11049,24493,7878,33,2,0,2,0,0,0
11050,24494,8302,43,5,3,2,0,0,0
11051,24494,8315,57,8,5,3,0,0,0
11052,24495,9864,42,8,4,4,0,0,0
11053,24495,8306,58,7,3,4,0,0,0
11054,24496,9906,47,4,2,2,0,0,0
11055,24496,9910,53,7,5,2,0,0,0
11056,24498,8370,49,5,3,2,0,0,0
11057,24498,8306,51,2,2,0,0,0,0
11058,24499,9910,57,7,3,4,0,0,0
11059,24499,8302,43,9,1,8,0,0,0
11060,24500,8634,64,8,6,2,0,0,0
11061,24500,8581,36,5,0,5,0,0,0
11062,24501,9906,53,6,4,2,0,0,0
11063,24501,8372,47,5,1,4,0,0,0
11064,24502,8305,44,5,1,4,0,0,0
11065,24502,9864,56,4,0,4,0,0,0
11066,24503,10205,47,6,3,3,0,0,0
11067,24503,8315,53,2,0,2,0,0,0
11068,24504,8633,63,11,6,5,0,0,0
11069,24504,7878,37,7,2,5,0,0,0
11070,24505,8560,51,4,1,3,0,0,0
11071,24505,8558,49,8,3,5,0,0,0
11072,24506,8603,34,3,3,0,0,0,0
11073,24506,10267,66,16,3,13,0,0,0
11074,24509,8634,54,9,5,4,0,0,0
11075,24509,9910,46,5,3,2,0,0,0
11076,24510,8372,45,4,2,2,0,0,0
11077,24510,8581,55,2,1,1,0,0,0
11078,24511,9906,52,7,2,5,0,0,0
11079,24511,8305,48,4,2,2,0,0,0
11080,24512,9864,58,8,1,7,0,0,0
11081,24512,10205,42,3,2,1,0,0,0
11082,24513,8633,55,9,7,2,0,0,0
11083,24513,8315,45,7,2,5,0,0,0
11084,24514,7878,49,6,2,4,0,0,0
11085,24514,8560,51,2,0,2,0,0,0
11086,24516,9783,44,2,1,1,0,0,0
11087,24516,8603,56,3,1,2,0,0,0
11088,24517,9869,44,4,3,1,0,0,0
11089,24517,8370,56,5,2,3,0,0,0
11090,24518,8370,51,4,3,1,0,0,0
11091,24518,8302,49,7,3,4,0,0,0
11092,24519,8634,63,7,2,5,0,0,0
11093,24519,8306,37,6,2,4,0,0,0
11094,24520,9910,66,3,3,0,0,0,0
11095,24520,8372,34,7,2,5,0,0,0
11096,24523,9864,36,7,4,3,0,0,0
11097,24523,8633,64,13,4,9,0,0,0
11098,24524,8560,51,9,5,4,0,0,0
11099,24524,8315,49,4,2,2,0,0,0
11100,24526,8558,56,6,4,2,0,0,0
11101,24526,9783,44,5,0,5,0,0,0
11102,24527,9869,51,7,2,5,0,0,0
11103,24527,8603,49,4,3,1,0,0,0
11104,24528,8634,58,18,3,15,0,0,0
11105,24528,8302,42,6,4,2,0,0,0
11106,24529,8306,60,7,1,6,0,0,0
11107,24529,8372,40,5,0,5,0,0,0
11108,24530,9910,60,10,5,5,0,0,0
11109,24530,8305,40,2,0,2,0,0,0
11110,24533,9864,39,6,4,2,0,0,0
11111,24533,8560,61,6,3,3,0,0,0
11112,24535,7878,54,2,2,0,0,0,0
11113,24535,9783,46,4,0,4,0,0,0
11114,24537,8603,36,5,2,3,0,0,0
11115,24537,8370,64,12,4,8,0,0,0
11116,24538,8634,47,5,4,1,0,0,0
11117,24538,8370,53,8,2,6,0,0,0
11118,24540,8305,45,6,3,3,0,0,0
11119,24540,8306,55,6,2,4,0,0,0
11120,24541,10205,37,4,3,1,0,0,0
11121,24541,9910,63,0,0,0,0,0,0
11122,24542,8581,45,8,4,4,0,0,0
11123,24542,8633,55,5,2,3,0,0,0
11124,24546,9869,61,6,2,4,0,0,0
11125,24546,7878,39,6,2,4,0,0,0
11126,24547,8558,44,4,1,3,0,0,0
11127,24547,8603,56,8,3,5,0,0,0
11128,24548,8372,31,3,2,1,0,0,0
11129,24548,8634,69,3,1,2,0,0,0
11130,24549,8302,56,10,8,2,0,0,0
11131,24549,8305,44,1,1,0,0,0,0
11132,24552,8560,42,3,3,0,0,0,0
11133,24552,8581,58,6,3,3,0,0,0
11134,24553,9906,49,9,4,5,0,0,0
11135,24553,10267,51,2,0,2,0,0,0
11136,24555,9869,48,2,1,1,0,0,0
11137,24555,8315,52,3,1,2,0,0,0
11138,24557,8558,38,3,1,2,0,0,0
11139,24557,8370,62,8,4,4,0,0,0
