,match_id,team_id,possession_only_second_half,shots_on,shots_on_first_half,shots_on_second_half,goals,goals_first_half,goals_second_half
0,1729,10260,56,11,6,5,1,1,0
1,1729,10261,44,1,0,1,1,1,0
2,1730,9825,71,12,7,5,1,1,0
3,1730,8659,29,2,0,2,0,0,0
4,1731,8472,49,4,2,2,1,0,1
5,1731,8650,51,11,4,7,0,0,0
6,1732,8654,48,5,3,2,2,2,0
7,1732,8528,52,7,1,6,1,0,1
8,1734,8668,43,2,1,1,3,1,2
9,1734,8655,57,8,4,4,2,1,1
10,1735,8549,57,7,3,4,4,1,3
11,1735,8586,43,2,0,2,0,0,0
12,1736,8559,47,5,3,2,3,3,0
13,1736,10194,53,1,0,1,1,0,1
14,1739,10260,62,11,6,5,2,2,0
15,1739,8654,38,3,2,1,0,0,0
16,1741,8456,67,11,3,8,2,0,2
17,1741,8549,33,5,5,0,0,0,0
18,1742,8559,51,13,7,6,1,0,1
19,1742,8668,49,6,5,1,0,0,0
20,1744,8472,46,4,3,1,1,0,1
21,1744,10194,54,4,4,0,0,0,0
22,1745,8650,54,9,5,4,1,0,1
23,1745,8462,46,1,1,0,0,0,0
24,1746,10252,65,2,2,0,2,1,1
25,1746,8655,35,7,4,3,3,1,2
26,1747,10261,51,4,2,2,2,2,0
27,1747,8659,49,5,1,4,1,0,1
28,1748,8528,56,4,3,1,2,1,1
29,1748,9879,44,1,0,1,0,0,0
30,1750,8650,49,5,2,3,2,1,1
31,1750,8586,51,5,2,3,1,0,1
32,1751,8668,60,5,4,1,1,0,1
33,1751,9879,40,7,3,4,0,0,0
34,1752,8654,39,8,1,7,1,1,0
35,1752,8549,61,8,2,6,1,0,1
36,1753,10261,66,5,3,2,2,0,2
37,1753,10252,34,1,1,0,0,0,0
38,1754,8559,59,8,3,5,1,0,1
39,1754,8456,41,7,3,4,1,0,1
40,1755,8659,61,7,2,5,2,1,1
41,1755,8655,39,4,1,3,2,0,2
42,1756,8528,57,9,4,5,2,1,1
43,1756,8462,43,8,3,5,1,0,1
44,1757,9825,47,4,3,1,2,1,1
45,1757,10194,53,3,2,1,1,0,1
46,1758,8455,56,8,6,2,5,3,2
47,1758,8472,44,0,0,0,0,0,0
48,1759,10260,53,9,5,4,2,1,1
49,1759,9825,47,6,3,3,2,1,1
50,1760,8650,37,8,7,1,3,2,1
51,1760,8659,63,2,1,1,0,0,0
52,1761,8462,38,3,3,0,1,1,0
53,1761,8472,62,4,2,2,2,0,2
54,1762,8654,53,11,7,4,1,0,1
55,1762,8668,47,3,1,2,3,0,3
56,1763,10252,45,10,7,3,2,1,1
57,1763,8549,55,5,2,3,1,1,0
58,1764,8456,42,6,2,4,1,1,0
59,1764,8586,58,5,2,3,2,1,1
60,1765,8455,63,9,6,3,2,1,1
61,1765,8655,37,3,1,2,0,0,0
62,1766,9879,57,5,4,1,2,1,1
63,1766,10261,43,6,1,5,1,0,1
64,1767,8667,57,8,2,6,1,0,1
65,1767,8559,43,7,1,6,0,0,0
66,1768,8528,63,9,2,7,5,2,3
67,1768,10194,37,1,0,1,0,0,0
68,1769,10260,57,11,5,6,2,1,1
69,1769,10194,43,0,0,0,1,0,1
70,1770,10252,52,4,4,0,1,1,0
71,1770,9825,48,8,3,5,1,0,1
72,1772,8549,51,2,1,1,2,1,1
73,1772,8668,49,7,5,2,2,0,2
74,1773,8528,42,4,2,2,1,1,0
75,1773,10261,58,6,1,5,2,0,2
76,1774,8655,40,8,4,4,2,1,1
77,1774,8472,60,5,3,2,1,0,1
78,1775,9879,49,13,3,10,2,1,1
79,1775,8586,51,5,3,2,1,1,0
80,1776,8650,43,7,4,3,2,1,1
81,1776,8559,57,10,1,9,2,2,0
82,1778,8667,51,3,0,3,1,1,0
83,1778,8456,49,3,0,3,0,0,0
84,1779,9879,37,5,4,1,1,1,0
85,1779,8650,63,8,5,3,0,0,0
86,1780,8472,67,4,3,1,3,2,1
87,1780,8654,33,6,5,1,1,0,1
88,1781,8655,53,10,4,6,3,1,2
89,1781,8586,47,10,2,8,0,0,0
90,1782,10252,40,7,3,4,3,1,2
91,1782,10260,60,5,4,1,1,0,1
92,1783,8559,51,2,2,0,1,0,1
93,1783,8549,49,10,4,6,0,0,0
94,1784,9825,39,5,2,3,1,0,1
95,1784,8456,61,4,1,3,0,0,0
96,1785,8462,51,4,3,1,2,2,0
97,1785,8667,49,7,2,5,4,3,1
98,1786,10194,51,9,4,5,1,0,1
99,1786,8659,49,3,1,2,0,0,0
100,1788,8455,60,17,8,9,1,0,1
101,1788,10261,40,0,0,0,0,0,0
102,1790,8472,51,6,2,4,1,1,0
103,1790,8559,49,4,1,3,0,0,0
104,1791,8668,45,5,3,2,3,0,3
105,1791,8586,55,6,1,5,2,0,2
106,1792,9879,44,2,1,1,1,1,0
107,1792,10252,56,6,0,6,1,0,1
108,1793,8549,60,7,1,6,1,0,1
109,1793,10261,40,6,2,4,2,0,2
110,1794,10260,48,8,4,4,1,0,1
111,1794,8456,52,1,0,1,0,0,0
112,1795,8462,49,2,1,1,1,1,0
113,1795,8655,51,2,2,0,0,0,0
114,1796,10194,52,8,4,4,2,0,2
115,1796,8667,48,5,0,5,0,0,0
116,1797,8528,61,7,3,4,2,2,0
117,1797,8659,39,9,2,7,2,0,2
118,1799,10260,85,10,5,5,3,0,3
119,1799,8472,15,1,0,1,1,0,1
120,1800,8528,29,7,3,4,1,1,0
121,1800,9825,71,3,1,2,1,1,0
122,1801,8586,52,9,3,6,2,2,0
123,1801,8654,48,5,1,4,0,0,0
124,1803,10261,38,4,3,1,2,0,2
125,1803,10194,62,4,0,4,1,0,1
126,1804,8655,48,2,2,0,1,1,0
127,1804,8650,52,5,0,5,3,3,0
128,1805,8456,38,7,2,5,4,3,1
129,1805,9879,62,7,3,4,0,0,0
130,1806,8559,45,8,3,5,1,0,1
131,1806,8455,55,4,2,2,0,0,0
132,1808,8549,45,6,3,3,3,2,1
133,1808,8667,55,6,3,3,3,1,2
134,1809,8650,83,12,7,5,3,2,1
135,1809,8667,17,3,2,1,0,0,0
136,1810,8472,44,7,5,2,1,1,0
137,1810,8659,56,13,7,6,1,1,0
138,1811,8586,44,5,3,2,1,0,1
139,1811,10260,56,10,5,5,0,0,0
140,1812,10252,57,4,1,3,1,0,1
141,1812,8559,43,1,0,1,0,0,0
142,1816,9879,55,7,2,5,2,1,1
143,1816,10194,45,0,0,0,1,1,0
144,1817,8528,-52,1,1,0,3,3,0
145,1817,8655,152,4,3,1,0,0,0
146,1820,8650,59,7,4,3,3,1,2
147,1820,9825,41,3,1,2,0,0,0
148,1821,8654,66,12,6,6,3,1,2
149,1821,10252,34,6,4,2,0,0,0
150,1822,8455,46,7,5,2,1,0,1
151,1822,8668,54,9,5,4,0,0,0
152,1823,8586,63,6,4,2,2,1,1
153,1823,10261,37,3,3,0,2,0,2
154,1824,10194,54,4,1,3,2,1,1
155,1824,8655,46,6,1,5,0,0,0
156,1825,8549,49,6,4,2,5,4,1
157,1825,9879,51,10,7,3,1,0,1
158,1829,8650,64,9,5,4,1,0,1
159,1829,8559,36,1,1,0,0,0,0
160,1830,8655,31,3,1,2,2,2,0
161,1830,8472,69,9,0,9,0,0,0
162,1831,9879,43,7,5,2,2,0,2
163,1831,8586,57,9,3,6,1,0,1
164,1832,10252,34,7,5,2,2,0,2
165,1832,9825,66,3,0,3,1,0,1
166,1833,8549,65,5,3,2,1,0,1
167,1833,8668,35,4,1,3,0,0,0
168,1834,8667,43,6,3,3,3,0,3
169,1834,8456,57,9,8,1,0,0,0
170,1836,10194,52,4,1,3,1,1,0
171,1836,10260,48,8,3,5,0,0,0
172,1838,8455,61,14,6,8,3,0,3
173,1838,8659,39,5,1,4,1,0,1
174,1839,8650,57,6,3,3,1,1,0
175,1839,8549,43,4,2,2,0,0,0
176,1840,8472,41,4,3,1,3,1,2
177,1840,8586,59,6,0,6,2,0,2
178,1841,10261,57,6,2,4,1,1,0
179,1841,8559,43,3,1,2,0,0,0
180,1842,8456,60,5,4,1,1,0,1
181,1842,8654,40,0,0,0,0,0,0
182,1844,9825,51,8,2,6,1,0,1
183,1844,9879,49,2,2,0,0,0,0
184,1845,8659,41,7,2,5,1,1,0
185,1845,8668,59,4,2,2,2,0,2
186,1846,10260,69,7,3,4,3,2,1
187,1846,8462,31,4,1,3,0,0,0
188,1847,10194,44,1,1,0,2,1,1
189,1847,10252,56,0,0,0,2,0,2
190,1848,8528,49,9,5,4,2,1,1
191,1848,8455,51,4,1,3,2,0,2
192,1849,10260,61,12,7,5,1,1,0
193,1849,8549,39,2,2,0,0,0,0
194,1850,9825,60,6,2,4,2,0,2
195,1850,8462,40,4,2,2,0,0,0
196,1851,10194,18,4,1,3,1,0,1
197,1851,8654,82,12,5,7,0,0,0
198,1852,8472,44,6,4,2,3,1,2
199,1852,8668,56,3,1,2,0,0,0
200,1854,8655,52,7,3,4,1,0,1
201,1854,8456,48,1,0,1,0,0,0
202,1855,8455,64,17,9,8,1,1,0
203,1855,9879,36,1,1,0,2,1,1
204,1856,8559,41,9,3,6,2,2,0
205,1856,8528,59,6,6,0,0,0,0
206,1857,8659,59,7,3,4,1,1,0
207,1857,8586,41,5,2,3,1,0,1
208,1858,10252,54,3,1,2,1,1,0
209,1858,8667,46,3,1,2,2,0,2
210,1859,8455,43,6,4,2,2,0,2
211,1859,10260,57,6,3,3,0,0,0
212,1860,9825,67,7,1,6,1,1,0
213,1860,8559,33,3,0,3,0,0,0
214,1861,8659,44,6,3,3,1,0,1
215,1861,10252,56,14,6,8,1,0,1
216,1862,8668,63,2,2,0,1,1,0
217,1862,8667,37,0,0,0,2,0,2
218,1863,8549,59,4,2,2,1,0,1
219,1863,8472,41,4,2,2,1,0,1
220,1865,9879,-43,8,5,3,4,1,3
221,1865,8655,143,7,3,4,1,1,0
222,1866,8462,57,6,2,4,1,0,1
223,1866,8456,43,8,4,4,0,0,0
224,1867,8650,71,5,2,3,3,0,3
225,1867,10194,29,0,0,0,0,0,0
226,1869,8668,38,5,3,2,1,0,1
227,1869,8650,62,5,3,2,0,0,0
228,1870,10252,40,2,1,1,3,1,2
229,1870,8472,60,4,2,2,1,0,1
230,1871,8586,52,15,10,5,1,0,1
231,1871,8462,48,4,4,0,2,0,2
232,1872,8654,64,6,4,2,1,0,1
233,1872,9879,36,5,1,4,0,0,0
234,1873,8456,47,2,2,0,3,3,0
235,1873,8528,53,8,1,7,1,0,1
236,1874,10261,39,3,3,0,3,2,1
237,1874,8655,61,3,1,2,0,0,0
238,1875,10260,64,13,6,7,6,2,4
239,1875,8559,36,3,3,0,0,0,0
240,1877,8667,43,4,3,1,1,1,0
241,1877,9825,57,5,2,3,1,0,1
242,1878,8455,59,19,10,9,1,0,1
243,1878,10194,41,1,1,0,1,0,1
244,1879,9879,44,9,4,5,2,1,1
245,1879,8472,56,12,5,7,1,0,1
246,1880,8586,57,11,6,5,2,2,0
247,1880,10194,43,1,0,1,3,0,3
248,1881,8667,57,12,7,5,2,0,2
249,1881,8654,43,10,4,6,0,0,0
250,1882,10260,65,6,4,2,1,1,0
251,1882,8659,35,4,3,1,0,0,0
252,1884,8528,52,2,2,0,2,0,2
253,1884,8650,48,3,1,2,0,0,0
254,1885,9825,53,4,2,2,1,1,0
255,1885,8668,47,4,2,2,2,0,2
256,1886,8456,62,4,2,2,3,1,2
257,1886,10261,38,0,0,0,1,0,1
258,1887,8655,60,11,3,8,3,1,2
259,1887,8559,40,1,1,0,2,0,2
260,1888,8455,59,12,6,6,2,1,1
261,1888,8549,41,6,3,3,2,0,2
262,1889,10260,51,11,6,5,1,1,0
263,1889,8668,49,5,1,4,0,0,0
264,1890,9825,47,9,3,6,2,0,2
265,1890,8654,53,2,1,1,0,0,0
266,1891,8455,38,4,3,1,2,1,1
267,1891,8650,62,14,5,9,0,0,0
268,1894,8472,43,10,8,2,3,1,2
269,1894,10261,57,14,6,8,0,0,0
270,1895,8462,54,7,4,3,1,1,0
271,1895,9879,46,4,1,3,3,2,1
272,1896,8586,52,8,3,5,2,0,2
273,1896,8559,48,5,3,2,4,0,4
274,1897,8667,43,10,5,5,3,2,1
275,1897,8659,57,4,0,4,1,1,0
276,1898,8456,63,6,1,5,1,1,0
277,1898,10194,37,3,2,1,0,0,0
278,1899,8472,70,6,4,2,1,1,0
279,1899,10194,30,2,1,1,0,0,0
280,1901,8654,53,5,3,2,2,0,2
281,1901,10260,47,8,5,3,1,0,1
282,1902,8668,70,8,4,4,2,2,0
283,1902,8559,30,5,0,5,1,0,1
284,1904,8655,49,11,5,6,2,1,1
285,1904,10252,51,5,2,3,1,1,0
286,1906,8462,53,4,3,1,1,0,1
287,1906,8650,47,4,1,3,3,0,3
288,1907,9879,44,3,3,0,1,1,0
289,1907,8528,56,4,1,3,1,0,1
290,1909,8655,42,6,1,5,1,0,1
291,1909,10260,58,5,2,3,0,0,0
292,1910,9825,63,8,5,3,3,2,1
293,1910,8472,37,2,2,0,0,0,0
294,1912,8455,54,9,5,4,1,1,0
295,1912,10252,46,6,2,4,2,0,2
296,1914,8668,58,7,3,4,1,0,1
297,1914,10261,42,1,0,1,0,0,0
298,1915,9879,55,10,3,7,2,2,0
299,1915,8659,45,7,3,4,1,0,1
300,1916,8559,37,6,3,3,2,1,1
301,1916,8654,63,9,3,6,1,0,1
302,1917,8586,58,6,1,5,4,3,1
303,1917,8667,42,3,1,2,2,1,1
304,1918,8462,43,3,1,2,3,3,0
305,1918,10194,57,2,2,0,1,1,0
306,1920,9879,39,4,2,2,1,0,1
307,1920,9825,61,6,3,3,0,0,0
308,1921,8586,40,8,5,3,2,1,1
309,1921,8472,60,4,0,4,1,0,1
310,1922,8456,45,5,2,3,1,1,0
311,1922,8654,55,10,6,4,0,0,0
312,1924,8659,51,10,4,6,2,0,2
313,1924,8668,49,6,4,2,0,0,0
314,1925,8650,31,9,6,3,1,1,0
315,1925,8549,69,3,2,1,2,1,1
316,1926,8559,55,5,3,2,2,1,1
317,1926,10261,45,12,4,8,0,0,0
318,1927,8655,43,5,3,2,1,0,1
319,1927,8667,57,4,2,2,0,0,0
320,1928,8528,35,6,5,1,1,1,0
321,1928,8455,65,12,8,4,4,2,2
322,1929,8549,44,4,3,1,1,1,0
323,1929,8586,56,4,3,1,3,0,3
324,1930,8659,45,6,2,4,2,1,1
325,1930,9825,55,4,0,4,1,0,1
326,1931,8462,52,6,3,3,3,2,1
327,1931,8455,48,10,7,3,1,0,1
328,1932,8559,48,9,4,5,1,1,0
329,1932,10194,52,3,0,3,1,0,1
330,1933,8528,69,8,2,6,2,2,0
331,1933,8654,31,2,0,2,3,1,2
332,1934,8472,39,2,2,0,1,1,0
333,1934,8650,61,11,7,4,1,1,0
334,1935,10261,23,5,3,2,5,4,1
335,1935,10260,77,7,4,3,0,0,0
336,1936,8456,46,6,2,4,3,2,1
337,1936,10252,54,5,0,5,0,0,0
338,1938,9879,44,10,3,7,3,1,2
339,1938,8667,56,2,1,1,0,0,0
340,1939,10260,58,8,3,5,3,1,2
341,1939,8650,42,3,1,2,4,3,1
342,1940,9825,60,9,2,7,2,0,2
343,1940,8655,40,4,2,2,0,0,0
344,1943,8586,61,9,5,4,1,1,0
345,1943,10252,39,5,3,2,4,1,3
346,1944,8668,51,9,4,5,5,3,2
347,1944,10194,49,2,1,1,0,0,0
348,1945,8462,49,3,3,0,1,0,1
349,1945,8549,51,8,1,7,0,0,0
350,1946,8559,44,5,3,2,2,1,1
351,1946,9879,56,4,2,2,3,0,3
352,1947,10261,53,4,1,3,2,1,1
353,1947,8667,47,1,0,1,0,0,0
354,1949,10260,57,8,5,3,1,1,0
355,1949,9879,43,1,1,0,1,0,1
356,1950,9825,47,12,6,6,2,1,1
357,1950,10261,53,1,0,1,0,0,0
358,1951,8456,62,6,3,3,1,1,0
359,1951,8472,38,4,3,1,2,0,2
360,1952,8655,52,7,3,4,1,1,0
361,1952,8654,48,4,1,3,2,1,1
362,1953,8650,58,5,1,4,1,0,1
363,1953,10252,42,2,1,1,0,0,0
364,1956,8559,68,10,3,7,1,0,1
365,1956,8659,32,7,4,3,0,0,0
366,1957,8528,47,1,1,0,3,1,2
367,1957,8667,53,4,1,3,2,1,1
368,1959,8650,57,4,2,2,2,1,1
369,1959,10252,43,4,3,1,0,0,0
370,1960,8455,42,11,3,8,4,1,3
371,1960,8586,58,6,5,1,0,0,0
372,1961,9825,68,10,6,4,2,0,2
373,1961,10261,32,4,1,3,0,0,0
374,1962,8456,68,10,3,7,1,1,0
375,1962,8472,32,4,2,2,2,0,2
376,1963,8655,63,12,6,6,1,0,1
377,1963,8654,37,1,1,0,0,0,0
378,1964,9879,46,11,9,2,4,2,2
379,1964,10260,54,13,1,12,1,1,0
380,1965,8659,47,2,1,1,2,1,1
381,1965,8559,53,9,5,4,0,0,0
382,1966,8462,40,9,4,5,2,1,1
383,1966,8668,60,3,0,3,1,0,1
384,1967,10194,43,2,1,1,1,0,1
385,1967,8549,57,6,3,3,0,0,0
386,1968,8667,56,3,2,1,3,2,1
387,1968,8528,44,6,4,2,3,1,2
388,1969,10260,48,6,3,3,3,2,1
389,1969,10252,52,4,4,0,1,1,0
390,1971,8472,44,8,3,5,1,1,0
391,1971,8654,56,7,1,6,3,0,3
392,1972,8668,52,7,3,4,2,1,1
393,1972,8528,48,10,2,8,2,0,2
394,1973,8455,52,10,2,8,1,1,0
395,1973,10261,48,6,2,4,1,0,1
396,1974,8586,49,4,3,1,1,1,0
397,1974,8655,51,5,0,5,4,0,4
398,1975,8650,52,9,5,4,2,1,1
399,1975,9879,48,2,0,2,0,0,0
400,1976,8559,49,7,4,3,1,1,0
401,1976,8549,51,4,2,2,0,0,0
402,1977,10194,41,5,5,0,1,1,0
403,1977,8659,59,12,2,10,1,0,1
404,1978,8462,45,1,1,0,4,2,2
405,1978,8667,55,1,0,1,2,1,1
406,1980,8472,60,7,7,0,1,0,1
407,1980,10260,40,4,2,2,0,0,0
408,1981,8586,56,9,3,6,1,0,1
409,1981,8654,44,5,2,3,0,0,0
410,1982,10252,47,6,3,3,1,1,0
411,1982,8668,53,3,3,0,2,0,2
412,1983,8549,45,9,4,5,2,2,0
413,1983,8667,55,4,1,3,5,0,5
414,1984,9879,59,9,3,6,2,1,1
415,1984,8456,41,6,0,6,0,0,0
416,1985,8659,52,4,3,1,2,1,1
417,1985,8462,48,2,0,2,1,0,1
418,1986,10194,-44,9,4,5,1,1,0
419,1986,10261,144,5,2,3,0,0,0
420,1987,8528,31,3,1,2,1,1,0
421,1987,9825,69,1,0,1,1,0,1
422,1990,8472,49,5,2,3,3,1,2
423,1990,8667,51,2,2,0,0,0,0
424,1991,8586,51,18,8,10,3,1,2
425,1991,10261,49,5,3,2,1,0,1
426,1992,8654,52,9,4,5,3,2,1
427,1992,10252,48,7,6,1,0,0,0
428,1993,8549,56,18,10,8,2,0,2
429,1993,9879,44,6,1,5,0,0,0
430,1994,8456,58,9,3,6,2,1,1
431,1994,8659,42,12,3,9,0,0,0
432,1995,8462,58,13,9,4,1,1,0
433,1995,8559,42,1,1,0,0,0,0
434,1996,8655,32,4,2,2,2,1,1
435,1996,10194,68,2,0,2,0,0,0
436,1997,8528,47,6,4,2,3,3,0
437,1997,10260,53,6,2,4,2,0,2
438,1998,8668,51,6,3,3,3,2,1
439,1998,8455,49,10,3,7,0,0,0
440,1999,8586,36,2,1,1,1,1,0
441,1999,10260,64,12,8,4,0,0,0
442,2000,9825,52,11,3,8,4,3,1
443,2000,8549,48,6,2,4,1,1,0
444,2002,8456,45,7,2,5,2,2,0
445,2002,8668,55,5,1,4,0,0,0
446,2005,9879,55,5,1,4,3,2,1
447,2005,10194,45,4,0,4,2,0,2
448,2006,8559,52,5,3,2,4,3,1
449,2006,10252,48,6,5,1,0,0,0
450,2007,8472,56,4,4,0,4,2,2
451,2007,8659,44,6,3,3,0,0,0
452,2008,8650,55,7,5,2,3,1,2
453,2008,8667,45,2,0,2,1,0,1
454,2009,10261,44,4,3,1,3,1,2
455,2009,8650,56,11,6,5,1,1,0
456,2010,8668,60,6,4,2,4,1,3
457,2010,8472,40,6,1,5,1,1,0
458,2011,8586,58,13,9,4,3,2,1
459,2011,8659,42,7,4,3,1,0,1
460,2012,8667,51,5,2,3,1,1,0
461,2012,10252,49,6,3,3,3,1,2
462,2013,8549,40,8,7,1,1,1,0
463,2013,10260,60,3,0,3,1,0,1
464,2014,8655,58,8,2,6,1,1,0
465,2014,8456,42,6,4,2,1,0,1
466,2015,8462,54,5,1,4,2,1,1
467,2015,9825,46,6,2,4,1,0,1
468,2017,8528,-45,13,9,4,2,0,2
469,2017,8559,145,2,0,2,0,0,0
470,2018,9879,48,2,2,0,2,1,1
471,2018,8455,52,4,2,2,0,0,0
472,2019,10260,30,6,3,3,2,1,1
473,2019,8456,70,5,2,3,2,0,2
474,2020,9825,32,9,2,7,3,0,3
475,2020,8455,68,5,4,1,2,0,2
476,2021,8650,45,7,2,5,2,1,1
477,2021,8654,55,2,1,1,1,0,1
478,2022,8668,64,6,3,3,1,1,0
479,2022,8586,36,0,0,0,0,0,0
480,2023,8549,42,4,3,1,2,1,1
481,2023,10261,58,7,3,4,0,0,0
482,2024,8655,62,4,2,2,1,1,0
483,2024,8462,38,4,1,3,0,0,0
484,2025,10252,42,5,3,2,2,1,1
485,2025,9879,58,8,5,3,1,0,1
486,2026,8472,57,2,2,0,1,1,0
487,2026,8559,43,2,0,2,3,1,2
488,2027,8528,45,6,5,1,2,2,0
489,2027,8659,55,6,3,3,1,0,1
490,2030,8586,59,9,8,1,3,2,1
491,2030,8456,41,4,1,3,1,0,1
492,2031,8668,67,6,2,4,1,0,1
493,2031,8654,33,6,1,5,0,0,0
494,2033,10261,55,4,1,3,1,1,0
495,2033,9879,45,4,2,2,3,2,1
496,2034,8667,39,9,5,4,2,2,0
497,2034,8559,61,8,5,3,1,1,0
498,2035,8659,41,7,3,4,1,1,0
499,2035,8650,59,7,3,4,3,0,3
500,2037,8528,46,3,2,1,1,1,0
501,2037,10194,54,6,4,2,1,0,1
502,2038,8655,47,5,4,1,2,0,2
503,2038,8455,53,11,6,5,0,0,0
504,2040,8586,44,3,2,1,1,1,0
505,2040,8650,56,2,0,2,3,0,3
506,2041,8455,47,6,3,3,3,0,3
507,2041,8472,53,4,0,4,0,0,0
508,2042,8654,62,7,2,5,2,2,0
509,2042,8549,38,4,1,3,1,0,1
510,2043,10261,41,3,3,0,2,1,1
511,2043,10252,59,7,5,2,0,0,0
512,2046,8668,44,12,6,6,2,2,0
513,2046,9879,56,8,2,6,1,1,0
514,2047,10260,48,4,2,2,3,2,1
515,2047,8667,52,9,4,5,1,0,1
516,2050,8586,63,14,5,9,2,2,0
517,2050,10252,37,9,5,4,2,1,1
518,2052,8455,57,5,2,3,2,2,0
519,2052,8456,43,3,1,2,3,0,3
520,2054,9879,69,11,5,6,2,1,1
521,2054,8559,31,5,1,4,0,0,0
522,2059,8650,64,13,6,7,1,0,1
523,2059,10194,36,2,0,2,0,0,0
524,2062,8654,61,4,3,1,2,1,1
525,2062,10261,39,9,3,6,1,0,1
526,2064,9879,54,5,2,3,1,0,1
527,2064,8655,46,2,2,0,0,0,0
528,2065,8559,46,7,3,4,2,2,0
529,2065,9825,54,5,0,5,0,0,0
530,2066,8659,43,7,3,4,5,1,4
531,2066,10252,57,4,2,2,0,0,0
532,2067,8667,44,4,3,1,1,1,0
533,2067,8668,56,7,3,4,3,0,3
534,2068,10260,53,8,4,4,2,2,0
535,2068,8455,47,16,7,9,3,1,2
536,2069,8559,23,5,3,2,5,1,4
537,2069,10260,77,19,12,7,0,0,0
538,2070,9825,71,12,4,8,3,1,2
539,2070,8667,29,3,0,3,1,1,0
540,2072,8650,53,8,2,6,1,0,1
541,2072,8668,47,2,1,1,0,0,0
542,2074,8655,45,6,5,1,2,0,2
543,2074,10261,55,1,0,1,0,0,0
544,2077,8455,61,13,6,7,3,1,2
545,2077,10194,39,6,1,5,1,1,0
546,2078,8456,49,8,2,6,2,1,1
547,2078,8528,51,4,1,3,1,1,0
548,2081,8654,45,5,2,3,1,0,1
549,2081,8559,55,6,3,3,1,0,1
550,2082,8668,16,3,1,2,1,1,0
551,2082,10261,84,9,4,5,1,0,1
552,2083,8650,45,6,3,3,3,1,2
553,2083,8456,55,2,2,0,0,0,0
554,2084,8655,39,4,2,2,1,0,1
555,2084,10260,61,8,6,2,1,0,1
556,2085,8659,59,6,1,5,3,0,3
557,2085,9879,41,5,4,1,0,0,0
558,2086,10194,41,3,3,0,2,1,1
559,2086,8462,59,11,3,8,1,0,1
560,2087,8528,55,11,3,8,1,1,0
561,2087,8549,45,2,1,1,0,0,0
562,2088,8455,49,15,9,6,1,1,0
563,2088,10252,51,2,2,0,0,0,0
564,2089,10260,79,10,6,4,2,1,1
565,2089,8659,21,2,1,1,1,0,1
566,2090,9825,69,11,4,7,2,1,1
567,2090,8668,31,4,3,1,0,0,0
568,2091,8650,69,8,4,4,7,4,3
569,2091,8528,31,3,2,1,1,0,1
570,2092,8462,40,3,3,0,2,1,1
571,2092,10252,60,6,1,5,0,0,0
572,2093,8455,60,8,4,4,2,1,1
573,2093,8549,40,4,1,3,0,0,0
574,2094,8456,55,10,4,6,1,1,0
575,2094,10261,45,2,1,1,0,0,0
576,2095,8472,61,7,3,4,1,1,0
577,2095,9879,39,10,5,5,0,0,0
578,2096,8559,59,5,2,3,1,1,0
579,2096,8655,41,1,0,1,1,1,0
580,2097,8667,40,3,2,1,1,1,0
581,2097,8654,60,7,5,2,3,1,2
582,2098,10194,49,3,1,2,1,1,0
583,2098,8586,51,5,5,0,4,0,4
584,2099,10261,37,6,5,1,3,2,1
585,2099,8472,63,3,2,1,2,1,1
586,2101,9825,56,10,3,7,2,1,1
587,2101,8654,44,6,2,4,1,0,1
588,2102,8668,73,10,6,4,2,2,0
589,2102,10260,27,10,8,2,2,0,2
590,2103,8456,60,8,1,7,1,0,1
591,2103,10194,40,6,3,3,1,0,1
592,2104,8655,51,2,2,0,2,0,2
593,2104,8549,49,1,0,1,0,0,0
594,2105,8667,54,6,3,3,4,2,2
595,2105,8659,46,14,6,8,0,0,0
596,2106,8462,55,11,7,4,3,1,2
597,2106,9879,45,5,2,3,1,0,1
598,2108,8455,85,6,5,1,3,1,2
599,2108,8650,15,2,1,1,1,1,0
600,2109,10260,57,18,11,7,1,1,0
601,2109,8658,43,3,1,2,1,0,1
602,2110,8586,57,9,3,6,2,1,1
603,2110,8650,43,3,0,3,0,0,0
604,2111,10252,38,4,4,0,5,2,3
605,2111,8528,62,8,4,4,0,0,0
606,2112,9825,60,4,2,2,1,0,1
607,2112,8668,40,5,1,4,0,0,0
608,2113,8654,44,9,6,3,3,2,1
609,2113,8602,56,10,2,8,0,0,0
610,2114,8655,46,8,7,1,2,2,0
611,2114,8456,54,3,1,2,2,0,2
612,2115,8559,43,4,3,1,2,2,0
613,2115,8472,57,9,5,4,2,1,1
614,2116,9879,46,3,2,1,1,1,0
615,2116,8462,54,4,3,1,1,1,0
616,2117,8191,47,10,4,6,3,2,1
617,2117,10194,53,4,2,2,2,1,1
618,2119,8528,52,5,5,0,2,1,1
619,2119,8191,48,8,3,5,1,0,1
620,2120,8455,72,14,8,6,2,1,1
621,2120,8655,28,4,2,2,1,0,1
622,2121,8668,53,9,7,2,2,1,1
623,2121,8559,47,4,0,4,2,2,0
624,2122,8472,64,6,3,3,1,1,0
625,2122,8658,36,11,5,6,3,0,3
626,2124,8654,54,6,3,3,1,0,1
627,2124,9825,46,6,4,2,0,0,0
628,2125,10252,45,6,2,4,1,1,0
629,2125,8602,55,4,4,0,0,0,0
630,2126,8667,54,2,1,1,1,0,1
631,2126,8462,46,3,0,3,0,0,0
632,2127,8650,48,6,4,2,1,1,0
633,2127,10260,52,7,2,5,1,0,1
634,2129,8462,56,8,3,5,1,1,0
635,2129,8528,44,4,1,3,1,0,1
636,2130,8655,35,2,1,1,4,3,1
637,2130,10260,65,9,5,4,0,0,0
638,2131,8650,36,4,3,1,3,2,1
639,2131,9879,64,2,0,2,3,3,0
640,2132,8668,46,3,3,0,3,1,2
641,2132,10252,54,6,3,3,1,0,1
642,2133,8667,39,4,1,3,1,1,0
643,2133,8191,61,4,2,2,1,0,1
644,2134,8455,51,15,8,7,4,1,3
645,2134,8559,49,6,4,2,1,1,0
646,2135,8658,46,5,4,1,5,3,2
647,2135,8456,54,8,4,4,3,0,3
648,2136,9825,53,8,5,3,1,1,0
649,2136,8586,47,6,1,5,0,0,0
650,2137,8602,54,5,3,2,1,1,0
651,2137,10194,46,4,4,0,1,0,1
652,2138,8654,46,6,4,2,3,3,0
653,2138,8472,54,5,1,4,1,0,1
654,2139,8528,59,13,5,8,1,1,0
655,2139,9879,41,6,1,5,1,0,1
656,2141,8602,29,3,1,2,2,1,1
657,2141,9825,71,8,4,4,1,1,0
658,2142,8654,56,8,3,5,1,0,1
659,2142,8668,44,4,1,3,0,0,0
660,2143,8586,49,4,1,3,3,1,2
661,2143,8472,51,8,3,5,0,0,0
662,2145,8650,72,15,9,6,4,1,3
663,2145,8658,28,0,0,0,0,0,0
664,2147,8655,70,5,1,4,2,1,1
665,2147,8462,30,2,0,2,3,0,3
666,2148,8455,48,6,4,2,2,1,1
667,2148,10260,52,8,2,6,1,0,1
668,2149,8658,40,1,1,0,3,2,1
669,2149,9879,60,5,2,3,1,0,1
670,2150,9825,60,5,4,1,1,1,0
671,2150,8472,40,1,1,0,0,0,0
672,2151,8462,40,10,2,8,3,0,3
673,2151,10194,60,3,1,2,2,0,2
674,2152,8191,32,3,1,2,3,2,1
675,2152,10252,68,5,0,5,0,0,0
676,2153,8602,29,4,3,1,3,2,1
677,2153,8455,71,12,5,7,0,0,0
678,2154,8654,44,8,4,4,1,1,0
679,2154,8667,56,6,5,1,0,0,0
680,2156,10260,64,7,5,2,3,1,2
681,2156,8668,36,6,1,5,2,1,1
682,2158,8655,60,8,3,5,1,1,0
683,2158,8559,40,7,3,4,0,0,0
684,2159,10260,65,4,2,2,2,1,1
685,2159,8462,35,11,6,5,1,0,1
686,2160,8191,56,9,3,6,1,1,0
687,2160,8654,44,3,1,2,0,0,0
688,2161,8658,44,7,5,2,1,0,1
689,2161,8602,56,3,0,3,1,0,1
690,2163,9879,51,10,3,7,3,1,2
691,2163,8559,49,2,2,0,0,0,0
692,2164,8650,51,8,5,3,2,1,1
693,2164,8668,49,7,3,4,0,0,0
694,2166,8586,62,18,9,9,4,4,0
695,2166,10252,38,2,1,1,2,0,2
696,2167,9825,53,9,6,3,3,2,1
697,2167,8455,47,4,3,1,0,0,0
698,2168,8528,51,8,3,5,4,3,1
699,2168,8472,49,0,0,0,1,0,1
700,2169,8462,45,2,2,0,1,1,0
701,2169,8191,55,7,3,4,2,1,1
702,2170,10260,61,3,2,1,3,0,3
703,2170,8654,39,6,1,5,1,0,1
704,2171,8658,61,10,5,5,3,2,1
705,2171,8528,39,7,5,2,1,0,1
706,2172,8559,42,8,4,4,2,1,1
707,2172,8602,58,7,5,2,1,0,1
708,2173,8455,49,6,3,3,2,1,1
709,2173,8456,51,8,5,3,1,0,1
710,2174,8472,65,5,2,3,3,1,2
711,2174,9879,35,3,2,1,1,0,1
712,2175,8586,57,8,5,3,2,1,1
713,2175,8668,43,5,4,1,0,0,0
714,2176,8650,62,11,3,8,1,1,0
715,2176,8655,38,3,2,1,3,0,3
716,2177,10252,54,6,4,2,2,1,1
717,2177,8667,46,2,2,0,0,0,0
718,2178,9825,59,7,3,4,3,1,2
719,2178,10194,41,4,1,3,0,0,0
720,2179,10260,64,10,3,7,1,1,0
721,2179,10252,36,4,3,1,1,1,0
722,2180,8528,44,7,5,2,2,1,1
723,2180,10194,56,6,3,3,0,0,0
724,2182,8586,60,17,6,11,1,1,0
725,2182,8602,40,1,0,1,1,0,1
726,2183,8650,43,4,4,0,1,1,0
727,2183,9825,57,4,1,3,1,0,1
728,2184,8667,49,8,5,3,2,1,1
729,2184,8655,51,9,2,7,0,0,0
730,2186,9879,68,4,3,1,1,1,0
731,2186,8191,32,8,5,3,1,0,1
732,2189,8456,60,4,1,3,2,2,0
733,2189,8586,40,3,2,1,0,0,0
734,2190,8472,44,7,3,4,2,1,1
735,2190,10252,56,2,1,1,2,0,2
736,2191,10194,47,5,3,2,1,1,0
737,2191,9879,53,4,1,3,1,0,1
738,2192,10260,62,11,4,7,1,1,0
739,2192,8602,38,1,0,1,0,0,0
740,2193,8667,42,4,2,2,3,0,3
741,2193,8668,58,3,1,2,0,0,0
742,2194,9825,53,10,4,6,2,2,0
743,2194,8191,47,3,1,2,4,1,3
744,2195,8654,53,8,3,5,1,1,0
745,2195,8559,47,6,2,4,3,0,3
746,2196,8658,47,5,2,3,2,1,1
747,2196,8655,53,6,1,5,2,0,2
748,2197,8650,48,8,2,6,3,1,2
749,2197,8528,52,7,4,3,0,0,0
750,2198,8455,54,10,6,4,1,0,1
751,2198,8462,46,2,1,1,0,0,0
752,2199,9825,70,7,5,2,5,3,2
753,2199,8667,30,3,0,3,1,1,0
754,2200,8191,51,6,1,5,1,1,0
755,2200,8602,49,9,4,5,1,1,0
756,2201,8528,58,3,2,1,1,1,0
757,2201,8559,42,0,0,0,0,0,0
758,2202,8455,55,6,4,2,4,2,2
759,2202,8654,45,3,1,2,0,0,0
760,2203,8462,49,4,1,3,2,1,1
761,2203,8650,51,2,0,2,0,0,0
762,2205,10260,47,5,4,1,3,1,2
763,2205,9879,53,6,3,3,0,0,0
764,2206,8668,43,8,5,3,1,0,1
765,2206,8658,57,3,1,2,0,0,0
766,2207,8655,52,10,4,6,2,1,1
767,2207,8586,48,2,2,0,3,1,2
768,2208,10252,49,7,5,2,2,0,2
769,2208,10194,51,7,0,7,0,0,0
770,2209,8528,57,3,1,2,2,1,1
771,2209,8655,43,2,0,2,1,0,1
772,2210,8462,43,7,3,4,2,1,1
773,2210,8654,57,7,2,5,2,0,2
774,2211,8668,66,4,2,2,2,0,2
775,2211,8472,34,4,1,3,2,0,2
776,2212,8456,77,4,1,3,1,0,1
777,2212,10194,23,4,2,2,0,0,0
778,2214,10260,28,9,6,3,5,3,2
779,2214,8667,72,5,4,1,0,0,0
780,2215,9879,52,6,3,3,2,1,1
781,2215,8586,48,3,1,2,2,2,0
782,2216,8191,64,6,2,4,3,1,2
783,2216,8559,36,4,4,0,1,0,1
784,2217,8455,55,16,10,6,4,2,2
785,2217,8658,45,7,1,6,1,0,1
786,2218,9825,75,8,4,4,3,1,2
787,2218,10252,25,3,2,1,0,0,0
788,2219,9825,61,10,6,4,1,1,0
789,2219,8559,39,4,2,2,1,1,0
790,2220,8455,66,8,5,3,1,0,1
791,2220,8472,34,2,1,1,0,0,0
792,2221,8654,60,9,6,3,1,1,0
793,2221,10252,40,9,6,3,1,0,1
794,2222,8655,57,3,3,0,5,1,4
795,2222,9879,43,0,0,0,0,0,0
796,2223,8658,44,8,3,5,2,1,1
797,2223,8462,56,7,3,4,0,0,0
798,2224,8586,74,7,2,5,3,2,1
799,2224,8667,26,6,2,4,1,0,1
800,2225,10260,69,10,3,7,2,2,0
801,2225,8191,31,2,1,1,1,0,1
802,2226,8602,42,3,2,1,1,0,1
803,2226,8528,58,6,4,2,1,0,1
804,2227,8650,52,11,5,6,3,1,2
805,2227,10194,48,3,1,2,0,0,0
806,2228,8456,62,10,5,5,3,0,3
807,2228,8668,38,4,1,3,0,0,0
808,2229,8456,51,4,1,3,2,2,0
809,2229,8602,49,4,2,2,0,0,0
810,2231,10194,46,8,5,3,7,4,3
811,2231,8658,54,7,1,6,2,0,2
812,2232,8462,52,5,3,2,1,1,0
813,2232,9825,48,6,3,3,2,1,1
814,2233,8668,58,11,4,7,2,1,1
815,2233,8191,42,9,4,5,0,0,0
816,2234,8455,59,11,6,5,1,0,1
817,2234,9879,41,3,1,2,0,0,0
818,2235,8667,38,5,2,3,2,1,1
819,2235,8559,62,4,0,4,0,0,0
820,2236,8472,45,8,4,4,1,0,1
821,2236,8655,55,7,1,6,1,0,1
822,2237,10252,45,5,3,2,4,1,3
823,2237,8650,55,8,5,3,0,0,0
824,2238,10260,65,9,6,3,1,1,0
825,2238,8528,35,5,1,4,0,0,0
826,2239,8528,69,6,4,2,2,2,0
827,2239,10252,31,9,5,4,0,0,0
828,2240,8654,60,8,4,4,3,2,1
829,2240,8602,40,0,0,0,0,0,0
830,2241,8655,36,2,0,2,2,1,1
831,2241,8456,64,2,0,2,1,0,1
832,2242,8586,48,8,3,5,1,0,1
833,2242,8650,52,5,1,4,0,0,0
834,2243,8455,52,11,4,7,2,2,0
835,2243,8667,48,4,0,4,0,0,0
836,2244,8462,43,9,8,1,1,1,0
837,2244,9879,57,8,4,4,1,0,1
838,2245,8191,53,4,2,2,3,1,2
839,2245,10194,47,3,0,3,1,0,1
840,2246,8559,49,6,2,4,2,1,1
841,2246,8472,51,4,2,2,1,0,1
842,2247,10260,68,13,6,7,3,2,1
843,2247,8658,32,5,1,4,1,0,1
844,2248,8668,41,5,2,3,1,0,1
845,2248,9825,59,5,1,4,1,0,1
846,2249,8462,46,6,4,2,3,1,2
847,2249,8658,54,4,2,2,2,1,1
848,2250,10194,44,3,1,2,3,2,1
849,2250,8650,56,4,3,1,0,0,0
850,2252,8528,57,12,7,5,2,1,1
851,2252,8602,43,6,2,4,2,0,2
852,2253,10260,55,10,5,5,2,2,0
853,2253,8191,45,8,1,7,0,0,0
854,2254,8456,49,5,3,2,2,1,1
855,2254,8668,51,5,4,1,1,0,1
856,2255,8472,37,2,2,0,1,0,1
857,2255,8455,63,9,3,6,0,0,0
858,2256,9825,58,3,3,0,1,1,0
859,2256,8559,42,5,2,3,2,0,2
860,2257,9879,61,9,7,2,1,0,1
861,2257,8655,39,3,2,1,0,0,0
862,2258,10252,52,5,2,3,3,2,1
863,2258,8654,48,2,0,2,0,0,0
864,2260,8586,38,5,2,3,1,1,0
865,2260,9879,62,5,2,3,0,0,0
866,2262,8654,52,6,3,3,1,1,0
867,2262,8462,48,8,4,4,1,0,1
868,2263,10260,52,10,8,2,1,1,0
869,2263,8667,48,4,3,1,1,0,1
870,2264,8191,58,2,2,0,1,1,0
871,2264,8559,42,7,2,5,0,0,0
872,2265,8668,47,4,3,1,2,2,0
873,2265,8472,53,3,0,3,0,0,0
874,2266,8455,52,11,6,5,1,1,0
875,2266,8658,48,2,1,1,3,2,1
876,2267,8528,46,4,3,1,2,1,1
877,2267,8655,54,2,0,2,0,0,0
878,2268,10252,48,1,1,0,3,1,2
879,2268,9825,52,11,5,6,0,0,0
880,2269,8654,51,3,1,2,1,1,0
881,2269,8655,49,3,0,3,2,0,2
882,2270,8668,57,4,3,1,3,1,2
883,2270,8528,43,3,1,2,0,0,0
884,2271,10194,49,3,1,2,3,1,2
885,2271,8472,51,4,3,1,0,0,0
886,2272,8462,40,4,2,2,1,1,0
887,2272,8456,60,5,4,1,3,1,2
888,2273,8559,40,4,3,1,2,1,1
889,2273,8650,60,13,4,9,0,0,0
890,2274,8667,43,3,1,2,3,1,2
891,2274,8602,57,4,2,2,0,0,0
892,2276,8191,45,4,3,1,2,1,1
893,2276,8455,55,5,1,4,0,0,0
894,2277,10260,38,3,2,1,2,1,1
895,2277,9825,62,2,0,2,5,1,4
896,2278,8658,53,7,3,4,2,2,0
897,2278,8586,47,10,6,4,1,0,1
898,2279,8462,42,5,4,1,1,1,0
899,2279,10260,58,7,3,4,3,1,2
900,2280,8655,41,4,3,1,3,1,2
901,2280,10194,59,3,0,3,0,0,0
902,2282,8586,64,13,5,8,2,2,0
903,2282,10252,36,3,2,1,1,1,0
904,2283,8654,54,10,4,6,2,1,1
905,2283,8191,46,1,0,1,0,0,0
906,2284,9825,55,7,5,2,2,1,1
907,2284,8455,45,2,0,2,4,1,3
908,2285,8559,49,11,7,4,4,2,2
909,2285,9879,51,3,1,2,1,1,0
910,2286,8667,45,3,2,1,1,1,0
911,2286,8456,55,7,3,4,0,0,0
912,2287,8650,41,4,2,2,1,1,0
913,2287,8668,59,5,1,4,0,0,0
914,2288,8658,46,9,7,2,2,2,0
915,2288,8602,54,6,3,3,1,0,1
916,2289,9825,49,4,3,1,1,0,1
917,2289,8650,51,6,1,5,0,0,0
918,2290,9879,45,9,5,4,5,1,4
919,2290,8191,55,2,1,1,0,0,0
920,2292,8602,64,6,5,1,2,1,1
921,2292,8586,36,4,2,2,1,0,1
922,2293,8528,64,8,7,1,2,2,0
923,2293,10194,36,7,3,4,1,1,0
924,2294,8472,56,3,2,1,3,1,2
925,2294,8462,44,7,1,6,1,0,1
926,2295,8655,55,8,5,3,1,0,1
927,2295,8667,45,3,1,2,0,0,0
928,2296,10260,64,7,4,3,1,0,1
929,2296,10252,36,4,2,2,0,0,0
930,2297,8455,91,8,3,5,4,2,2
931,2297,8668,9,4,3,1,1,1,0
932,2298,8456,51,2,2,0,2,1,1
933,2298,8559,49,5,3,2,2,1,1
934,2299,8658,51,7,3,4,2,1,1
935,2299,9879,49,5,2,3,2,1,1
936,2300,8462,52,5,2,3,1,0,1
937,2300,10194,48,3,1,2,2,0,2
938,2301,8654,54,8,4,4,2,1,1
939,2301,8667,46,3,2,1,0,0,0
940,2302,8559,43,8,5,3,2,1,1
941,2302,8655,57,4,1,3,0,0,0
942,2303,8668,51,4,3,1,1,0,1
943,2303,10260,49,2,1,1,0,0,0
944,2304,9825,68,11,4,7,1,0,1
945,2304,8472,32,4,1,3,0,0,0
946,2305,8586,52,9,4,5,1,1,0
947,2305,8528,48,6,3,3,1,0,1
948,2306,8602,46,8,3,5,5,0,5
949,2306,8455,54,1,1,0,0,0,0
950,2307,8456,45,3,0,3,3,1,2
951,2307,8650,55,1,0,1,1,0,1
952,2308,8191,39,5,3,2,3,0,3
953,2308,10252,61,4,1,3,0,0,0
954,2309,8472,46,5,3,2,4,3,1
955,2309,9879,54,1,0,1,1,0,1
956,2310,8586,10,7,1,6,2,1,1
957,2310,8668,90,4,0,4,1,1,0
958,2311,10194,30,4,3,1,2,2,0
959,2311,9825,70,10,2,8,2,1,1
960,2312,8654,43,8,3,5,4,1,3
961,2312,10260,57,8,5,3,0,0,0
962,2313,8655,70,5,3,2,1,1,0
963,2313,8650,30,0,0,0,2,0,2
964,2314,10252,52,4,1,3,4,1,3
965,2314,8667,48,5,2,3,1,1,0
966,2315,8455,42,15,5,10,1,0,1
967,2315,8456,58,4,1,3,0,0,0
968,2317,8191,45,6,2,4,3,2,1
969,2317,8462,55,2,1,1,1,0,1
970,2318,8559,56,8,5,3,2,1,1
971,2318,8602,44,4,3,1,1,1,0
972,2319,8650,54,3,2,1,3,2,1
973,2319,8528,46,5,1,4,1,1,0
974,2320,8654,65,9,5,4,1,1,0
975,2320,8559,35,6,5,1,1,0,1
976,2321,8456,51,9,7,2,2,1,1
977,2321,8586,49,7,2,5,3,1,2
978,2322,8455,63,6,3,3,2,0,2
979,2322,8462,37,3,3,0,0,0,0
980,2324,8658,47,2,2,0,2,2,0
981,2324,8655,53,2,0,2,1,0,1
982,2325,10252,54,7,3,4,1,1,0
983,2325,8472,46,3,1,2,3,2,1
984,2326,8191,36,4,3,1,2,0,2
985,2326,9825,64,11,2,9,1,0,1
986,2327,10260,61,4,3,1,3,2,1
987,2327,8602,39,7,4,3,0,0,0
988,2328,9879,54,4,2,2,3,0,3
989,2328,10194,46,2,1,1,0,0,0
990,2329,9825,56,15,9,6,2,2,0
991,2329,8462,44,5,1,4,0,0,0
992,2330,10252,56,3,3,0,1,1,0
993,2330,8650,44,15,5,10,3,0,3
994,2331,8655,43,7,4,3,2,1,1
995,2331,8472,57,4,3,1,0,0,0
996,2332,8586,53,9,5,4,7,2,5
997,2332,8654,47,8,4,4,1,1,0
998,2333,8456,61,11,8,3,2,2,0
999,2333,8602,39,4,1,3,0,0,0
1000,2334,8455,65,5,2,3,1,0,1
1001,2334,9879,35,1,0,1,1,0,1
1002,2335,8658,48,5,2,3,2,1,1
1003,2335,10194,52,2,1,1,0,0,0
1004,2336,8667,48,3,2,1,2,1,1
1005,2336,8559,52,12,4,8,1,0,1
1006,2337,8191,34,5,3,2,1,1,0
1007,2337,8668,66,11,7,4,2,0,2
1008,2338,10260,46,9,6,3,2,1,1
1009,2338,8528,54,7,3,4,3,1,2
1010,2339,8655,54,8,4,4,6,5,1
1011,2339,8586,46,4,2,2,1,0,1
1012,2341,10252,75,4,2,2,1,1,0
1013,2341,10194,25,5,0,5,0,0,0
1014,2342,9879,28,5,3,2,1,0,1
1015,2342,10260,72,16,8,8,0,0,0
1016,2343,8650,62,8,2,6,1,0,1
1017,2343,8462,38,2,0,2,0,0,0
1018,2344,9825,61,7,4,3,1,1,0
1019,2344,8667,39,2,1,1,0,0,0
1020,2345,8658,57,4,3,1,2,1,1
1021,2345,8668,43,6,3,3,1,0,1
1022,2346,8559,45,4,2,2,5,3,2
1023,2346,8528,55,6,4,2,1,1,0
1024,2347,8191,71,11,3,8,1,1,0
1025,2347,8602,29,4,2,2,4,1,3
1026,2348,8455,63,12,6,6,1,1,0
1027,2348,8654,37,3,0,3,0,0,0
1028,2349,8191,45,6,5,1,3,1,2
1029,2349,8528,55,11,2,9,1,0,1
1030,2350,8472,53,7,5,2,2,2,0
1031,2350,8658,47,11,4,7,2,1,1
1032,2351,9825,46,4,2,2,2,2,0
1033,2351,8654,54,4,3,1,1,0,1
1034,2352,10252,54,8,3,5,1,1,0
1035,2352,8602,46,4,1,3,2,0,2
1036,2353,8455,62,8,5,3,1,1,0
1037,2353,8655,38,2,2,0,3,2,1
1038,2354,8462,54,5,2,3,2,2,0
1039,2354,8667,46,1,1,0,1,0,1
1040,2355,8559,36,4,4,0,3,1,2
1041,2355,8668,64,11,4,7,2,0,2
1042,2356,8456,48,5,3,2,1,0,1
1043,2356,9879,52,4,1,3,0,0,0
1044,2357,10260,65,4,2,2,1,1,0
1045,2357,8650,35,1,0,1,1,0,1
1046,2358,8586,57,7,3,4,4,3,1
1047,2358,10194,43,4,4,0,1,0,1
1048,2359,8650,47,15,7,8,3,0,3
1049,2359,8472,53,2,0,2,1,0,1
1050,2360,8456,54,6,2,4,7,3,4
1051,2360,8528,46,4,4,0,0,0,0
1052,2361,8462,45,4,3,1,4,0,4
1053,2361,8586,55,7,3,4,0,0,0
1054,2362,10260,62,4,3,1,2,2,0
1055,2362,8559,38,12,7,5,2,0,2
1056,2364,8668,51,12,4,8,2,1,1
1057,2364,8602,49,2,2,0,2,1,1
1058,2365,9879,53,8,4,4,1,1,0
1059,2365,8667,47,3,2,1,0,0,0
1060,2366,8455,38,5,4,1,1,1,0
1061,2366,10252,62,2,0,2,0,0,0
1062,2367,8655,55,5,3,2,3,2,1
1063,2367,8191,45,1,0,1,1,1,0
1064,2368,9825,56,8,3,5,1,1,0
1065,2368,8658,44,3,3,0,3,2,1
1066,2370,10194,49,2,1,1,2,2,0
1067,2370,8667,51,3,0,3,1,0,1
1068,2371,8462,44,4,4,0,1,1,0
1069,2371,8655,56,8,3,5,2,1,1
1070,2372,8455,35,3,3,0,2,1,1
1071,2372,10260,65,3,2,1,3,0,3
1072,2373,8528,38,7,4,3,2,1,1
1073,2373,9879,62,3,2,1,0,0,0
1074,2374,8668,52,4,2,2,8,2,6
1075,2374,8654,48,3,1,2,0,0,0
1076,2375,8456,77,5,4,1,2,1,1
1077,2375,8191,23,7,3,4,2,0,2
1078,2376,8559,46,6,3,3,1,0,1
1079,2376,10252,54,8,5,3,0,0,0
1080,2378,9825,67,12,5,7,3,2,1
1081,2378,8602,33,4,0,4,1,1,0
1082,2379,8654,41,7,5,2,3,2,1
1083,2379,8472,59,4,2,2,1,0,1
1084,2380,10194,69,4,2,2,1,1,0
1085,2380,8602,31,7,3,4,1,1,0
1086,2381,8528,60,11,4,7,3,1,2
1087,2381,8462,40,2,1,1,1,0,1
1088,2382,9825,67,10,3,7,2,0,2
1089,2382,8586,33,9,2,7,1,0,1
1090,2383,8456,58,6,3,3,1,1,0
1091,2383,8658,42,2,0,2,1,0,1
1092,2384,8650,65,11,5,6,1,0,1
1093,2384,9879,35,2,1,1,2,0,2
1094,2385,8191,68,3,2,1,1,1,0
1095,2385,8667,32,4,1,3,1,0,1
1096,2386,8559,44,4,2,2,2,1,1
1097,2386,8455,56,9,2,7,3,1,2
1098,2387,8655,49,7,3,4,2,2,0
1099,2387,10260,51,7,4,3,0,0,0
1100,2388,8668,47,7,4,3,1,1,0
1101,2388,10252,53,4,3,1,0,0,0
1102,2390,8455,40,8,4,4,4,1,3
1103,2390,8586,60,12,7,5,0,0,0
1104,2391,8191,44,2,1,1,5,2,3
1105,2391,8472,56,7,4,3,0,0,0
1106,2392,10194,48,4,2,2,3,1,2
1107,2392,8559,52,5,1,4,2,1,1
1108,2393,8462,41,10,5,5,1,1,0
1109,2393,10252,59,6,3,3,3,2,1
1110,2394,8650,69,9,4,5,3,1,2
1111,2394,8654,31,2,1,1,3,0,3
1112,2395,9879,56,2,2,0,3,1,2
1113,2395,8602,44,0,0,0,1,0,1
1114,2396,8668,72,2,1,1,1,1,0
1115,2396,8655,28,10,8,2,2,0,2
1116,2397,8667,48,4,3,1,1,0,1
1117,2397,8658,52,5,4,1,0,0,0
1118,2398,10260,53,5,3,2,3,2,1
1119,2398,8456,47,4,2,2,2,1,1
1120,2401,8655,46,6,2,4,1,1,0
1121,2401,8602,54,5,0,5,2,1,1
1122,2402,8654,51,2,1,1,1,0,1
1123,2402,8528,49,6,2,4,0,0,0
1124,2403,10260,62,7,3,4,4,1,3
1125,2403,8586,38,2,1,1,3,1,2
1126,2404,8455,74,12,7,5,4,1,3
1127,2404,10194,26,2,1,1,1,0,1
1128,2405,8650,55,6,4,2,3,2,1
1129,2405,8191,45,7,2,5,2,2,0
1130,2406,8559,51,7,4,3,2,2,0
1131,2406,8462,49,3,1,2,0,0,0
1132,2409,8667,57,1,1,0,3,1,2
1133,2409,8528,43,3,0,3,0,0,0
1134,2410,8559,43,5,1,4,2,1,1
1135,2410,8586,57,8,5,3,1,0,1
1136,2411,10260,55,8,4,4,1,0,1
1137,2411,8472,45,5,4,1,1,0,1
1138,2413,8602,39,11,7,4,1,0,1
1139,2413,8462,61,4,2,2,0,0,0
1140,2414,8456,48,11,5,6,3,1,2
1141,2414,10252,52,5,2,3,1,1,0
1142,2415,8658,58,4,3,1,3,1,2
1143,2415,8191,42,5,3,2,1,0,1
1144,2416,8655,47,5,3,2,3,1,2
1145,2416,9825,53,4,2,2,1,0,1
1146,2417,9879,59,3,1,2,5,1,4
1147,2417,8654,41,3,2,1,2,0,2
1148,2418,8455,54,8,1,7,2,0,2
1149,2418,8650,46,2,0,2,0,0,0
1150,2421,8528,40,3,2,1,1,1,0
1151,2421,8455,60,3,1,2,0,0,0
1152,2423,8658,69,5,2,3,1,0,1
1153,2423,8559,31,4,3,1,0,0,0
1154,2424,10252,51,10,7,3,1,1,0
1155,2424,8655,49,2,1,1,2,1,1
1156,2425,9825,46,6,2,4,2,1,1
1157,2425,9879,54,1,0,1,1,0,1
1158,2426,10260,59,11,8,3,3,1,2
1159,2426,10194,41,7,3,4,1,0,1
1160,2427,8456,55,7,4,3,1,1,0
1161,2427,8654,45,6,1,5,0,0,0
1162,2428,8650,51,5,3,2,2,1,1
1163,2428,8667,49,8,4,4,2,0,2
1164,2429,9825,54,4,2,2,1,0,1
1165,2429,10260,46,6,2,4,1,0,1
1166,2430,8586,40,15,10,5,2,0,2
1167,2430,8658,60,4,4,0,0,0,0
1168,2431,9879,49,2,1,1,2,0,2
1169,2431,10252,51,1,1,0,1,0,1
1170,2432,8668,53,14,8,6,2,1,1
1171,2432,8528,47,5,1,4,2,1,1
1172,2433,8602,52,14,8,6,2,0,2
1173,2433,8667,48,2,1,1,1,0,1
1174,2434,8654,39,4,3,1,1,1,0
1175,2434,8655,61,8,3,5,1,0,1
1176,2435,8650,61,13,4,9,2,2,0
1177,2435,8559,39,3,3,0,6,3,3
1178,2436,8462,43,7,3,4,2,1,1
1179,2436,8456,57,7,2,5,1,1,0
1180,2437,8472,49,6,2,4,2,1,1
1181,2437,10194,51,5,1,4,1,1,0
1182,2438,8455,70,17,9,8,2,1,1
1183,2438,8191,30,2,0,2,0,0,0
1184,2439,8650,70,11,7,4,1,0,1
1185,2439,8191,30,4,3,1,1,0,1
1186,2440,8667,39,5,4,1,2,1,1
1187,2440,8472,61,4,1,3,3,3,0
1188,2441,10260,62,12,8,4,1,1,0
1189,2441,8586,38,7,2,5,2,1,1
1190,2442,8456,29,3,1,2,1,1,0
1191,2442,9825,71,7,0,7,0,0,0
1192,2443,8655,62,4,1,3,1,1,0
1193,2443,8602,38,3,1,2,1,0,1
1194,2444,9879,59,10,3,7,2,2,0
1195,2444,8668,41,9,4,5,1,0,1
1196,2445,8658,64,7,3,4,3,2,1
1197,2445,10252,36,4,1,3,1,1,0
1198,2446,8559,38,6,3,3,1,1,0
1199,2446,8462,62,8,2,6,0,0,0
1200,2447,8455,71,14,4,10,1,1,0
1201,2447,10194,29,1,0,1,3,0,3
1202,2448,8654,51,6,4,2,2,2,0
1203,2448,8528,49,6,4,2,1,0,1
1204,2449,8456,25,3,2,1,4,3,1
1205,2449,10260,75,8,0,8,1,0,1
1206,2450,9825,85,10,8,2,2,1,1
1207,2450,8528,15,5,3,2,0,0,0
1208,2451,8650,53,10,4,6,1,0,1
1209,2451,8654,47,4,1,3,0,0,0
1210,2452,10252,51,5,2,3,1,1,0
1211,2452,8462,49,12,3,9,2,1,1
1212,2453,8668,51,9,4,5,1,1,0
1213,2453,8655,49,6,3,3,0,0,0
1214,2454,8602,44,3,0,3,2,2,0
1215,2454,9879,56,5,0,5,0,0,0
1216,2455,10194,52,6,2,4,2,0,2
1217,2455,8559,48,5,1,4,2,0,2
1218,2456,8667,41,8,4,4,2,2,0
1219,2456,8658,59,8,4,4,0,0,0
1220,2457,8472,41,4,2,2,2,1,1
1221,2457,8191,59,1,1,0,2,1,1
1222,2458,8586,43,3,2,1,3,1,2
1223,2458,8455,57,13,2,11,2,0,2
1224,2461,8455,47,6,4,2,1,1,0
1225,2461,8528,53,8,8,0,1,0,1
1226,2462,8602,48,13,5,8,1,0,1
1227,2462,8472,52,7,4,3,1,0,1
1228,2463,10260,57,5,5,0,2,1,1
1229,2463,10194,43,1,0,1,1,0,1
1230,2464,8462,41,12,6,6,3,1,2
1231,2464,8668,59,8,5,3,2,0,2
1232,2466,9879,44,11,4,7,2,0,2
1233,2466,9825,56,3,1,2,0,0,0
1234,2467,8655,53,9,3,6,1,0,1
1235,2467,10252,47,3,1,2,0,0,0
1236,2468,8658,46,5,2,3,3,1,2
1237,2468,8559,54,4,0,4,0,0,0
1238,2469,10260,54,13,3,10,2,2,0
1239,2469,8472,46,1,1,0,3,0,3
1240,2470,8602,62,5,4,1,3,3,0
1241,2470,8462,38,5,4,1,0,0,0
1242,2471,9879,38,6,4,2,2,1,1
1243,2471,8654,62,11,4,7,2,1,1
1244,2472,10194,46,4,2,2,4,3,1
1245,2472,8668,54,15,9,6,1,0,1
1246,2473,8455,46,9,5,4,5,2,3
1247,2473,8650,54,7,4,3,1,0,1
1248,2474,8191,56,10,7,3,3,2,1
1249,2474,8658,44,5,2,3,2,1,1
1250,2475,8559,47,10,5,5,4,1,3
1251,2475,8586,53,7,1,6,2,0,2
1252,2476,8667,56,4,1,3,1,1,0
1253,2476,8528,44,4,3,1,1,0,1
1254,2477,10252,61,6,2,4,1,0,1
1255,2477,8456,39,7,5,2,1,0,1
1256,2478,8655,36,4,1,3,2,1,1
1257,2478,9825,64,12,4,8,1,1,0
1258,2479,8654,32,10,5,5,1,1,0
1259,2479,10194,68,3,0,3,0,0,0
1260,2480,10260,42,8,2,6,4,4,0
1261,2480,8559,58,10,3,7,0,0,0
1262,2481,9879,58,12,7,5,3,1,2
1263,2481,8667,42,4,0,4,1,0,1
1264,2482,8602,45,9,5,4,1,1,0
1265,2482,8668,55,4,0,4,0,0,0
1266,2483,8655,44,4,2,2,1,0,1
1267,2483,8191,56,3,1,2,0,0,0
1268,2484,10252,35,2,2,0,1,0,1
1269,2484,8455,65,13,3,10,0,0,0
1270,2485,8650,45,7,1,6,1,1,0
1271,2485,8472,55,6,3,3,0,0,0
1272,2486,8528,61,8,4,4,1,0,1
1273,2486,8456,39,4,2,2,1,0,1
1274,2487,8586,33,3,2,1,2,1,1
1275,2487,8462,67,9,4,5,0,0,0
1276,2488,9825,57,12,7,5,1,1,0
1277,2488,8658,43,1,1,0,1,0,1
1278,2490,8655,39,3,1,2,4,2,2
1279,2490,8668,61,8,4,4,0,0,0
1280,2495,8472,40,2,1,1,2,0,2
1281,2495,8658,60,3,0,3,1,0,1
1282,2497,8602,46,8,4,4,2,2,0
1283,2497,10194,54,3,0,3,1,0,1
1284,2498,8528,61,7,4,3,2,0,2
1285,2498,8483,39,4,3,1,0,0,0
1286,2499,10260,42,8,5,3,1,1,0
1287,2499,8586,58,6,5,1,2,1,1
1288,2500,9825,56,18,6,12,3,1,2
1289,2500,8654,44,5,3,2,2,0,2
1290,2501,8658,44,7,3,4,1,1,0
1291,2501,10252,56,3,0,3,1,0,1
1292,2505,8655,32,6,5,1,2,0,2
1293,2505,8455,68,5,1,4,2,0,2
1294,2510,9825,48,6,4,2,1,0,1
1295,2510,10261,52,2,0,2,0,0,0
1296,2511,8455,84,6,2,4,2,0,2
1297,2511,8650,16,4,1,3,0,0,0
1298,2515,8654,49,9,6,3,2,2,0
1299,2515,8658,51,5,1,4,0,0,0
1300,2517,8659,47,4,2,2,1,1,0
1301,2517,8456,53,5,2,3,2,0,2
1302,2520,8659,52,8,7,1,2,1,1
1303,2520,8654,48,3,2,1,2,1,1
1304,2522,10194,36,6,6,0,1,1,0
1305,2522,8658,64,8,1,7,1,0,1
1306,2523,8650,41,1,1,0,1,1,0
1307,2523,8528,59,10,5,5,0,0,0
1308,2525,8559,39,3,1,2,2,1,1
1309,2525,8668,61,9,5,4,1,0,1
1310,2532,8668,41,13,5,8,1,0,1
1311,2532,9825,59,5,2,3,0,0,0
1312,2533,10261,75,8,3,5,5,3,2
1313,2533,9879,25,8,7,1,0,0,0
1314,2535,8602,59,7,4,3,3,2,1
1315,2535,8559,41,8,2,6,2,0,2
1316,2536,10194,72,5,4,1,1,0,1
1317,2536,8650,28,6,3,3,1,0,1
1318,2537,8528,52,3,1,2,3,1,2
1319,2537,8659,48,8,3,5,4,1,3
1320,2538,8455,44,5,3,2,2,1,1
1321,2538,8472,56,3,2,1,3,1,2
1322,2540,8586,48,5,3,2,1,0,1
1323,2540,9825,52,6,2,4,1,0,1
1324,2541,8650,56,9,6,3,2,0,2
1325,2541,8654,44,3,2,1,0,0,0
1326,2542,8472,45,4,1,3,1,1,0
1327,2542,8668,55,7,4,3,0,0,0
1328,2544,9879,47,7,4,3,2,1,1
1329,2544,8456,53,3,1,2,2,0,2
1330,2546,8559,40,8,5,3,1,0,1
1331,2546,10261,60,1,0,1,1,0,1
1332,2553,8668,40,2,2,0,4,2,2
1333,2553,8659,60,2,0,2,0,0,0
1334,2555,8472,43,6,1,5,2,2,0
1335,2555,8602,57,6,2,4,1,0,1
1336,2556,9879,62,5,1,4,1,1,0
1337,2556,8658,38,3,0,3,2,0,2
1338,2558,10194,44,9,6,3,1,0,1
1339,2558,8456,56,6,2,4,0,0,0
1340,2559,9825,49,8,6,2,2,1,1
1341,2559,9879,51,5,3,2,2,2,0
1342,2562,8456,67,11,6,5,3,3,0
1343,2562,8559,33,7,3,4,1,1,0
1344,2567,10194,53,3,1,2,2,1,1
1345,2567,8528,47,6,3,3,3,1,2
1346,2571,8456,51,7,5,2,1,0,1
1347,2571,8654,49,4,2,2,0,0,0
1348,2573,8668,56,7,1,6,2,1,1
1349,2573,8528,44,4,1,3,0,0,0
1350,2575,8602,53,9,6,3,1,1,0
1351,2575,8658,47,0,0,0,2,1,1
1352,2578,10194,39,12,5,7,3,0,3
1353,2578,8483,61,3,3,0,2,0,2
1354,2580,8650,56,6,4,2,2,2,0
1355,2580,9879,44,8,2,6,0,0,0
1356,2581,8559,46,8,4,4,1,1,0
1357,2581,8472,54,5,3,2,1,1,0
1358,2583,8655,54,4,3,1,1,1,0
1359,2583,8654,46,1,1,0,2,2,0
1360,2584,10261,54,4,3,1,1,1,0
1361,2584,8658,46,5,2,3,0,0,0
1362,2585,8602,52,1,1,0,1,0,1
1363,2585,8659,48,11,2,9,0,0,0
1364,2586,8586,65,11,7,4,1,0,1
1365,2586,8483,35,2,0,2,0,0,0
1366,2587,10252,77,9,5,4,1,1,0
1367,2587,8528,23,9,4,5,1,0,1
1368,2594,8528,34,5,2,3,2,1,1
1369,2594,8602,66,4,3,1,1,1,0
1370,2595,10194,53,7,3,4,2,1,1
1371,2595,8655,47,8,2,6,2,0,2
1372,2598,8483,53,4,1,3,3,2,1
1373,2598,8650,47,8,2,6,0,0,0
1374,2600,8559,52,5,3,2,4,4,0
1375,2600,8654,48,6,4,2,2,0,2
1376,2601,8602,43,3,1,2,4,1,3
1377,2601,8668,57,5,4,1,0,0,0
1378,2605,8658,55,6,4,2,1,1,0
1379,2605,8655,45,5,2,3,2,1,1
1380,2609,8650,53,7,6,1,2,0,2
1381,2609,8602,47,2,0,2,0,0,0
1382,2610,8483,38,2,2,0,2,1,1
1383,2610,8472,62,11,2,9,2,0,2
1384,2616,9879,42,2,1,1,4,2,2
1385,2616,10194,58,11,4,7,1,0,1
1386,2619,8650,58,10,3,7,3,1,2
1387,2619,8559,42,6,0,6,1,0,1
1388,2625,8659,42,8,5,3,1,1,0
1389,2625,10260,58,1,0,1,1,1,0
1390,2626,10194,38,3,2,1,3,3,0
1391,2626,8668,62,6,3,3,0,0,0
1392,2631,8602,49,2,2,0,3,3,0
1393,2631,8455,51,9,6,3,2,2,0
1394,2633,8483,63,11,5,6,2,0,2
1395,2633,8658,37,5,2,3,0,0,0
1396,2634,10252,57,5,3,2,3,1,2
1397,2634,8472,43,5,1,4,0,0,0
1398,2636,10261,47,4,3,1,2,0,2
1399,2636,8654,53,5,1,4,4,0,4
1400,2637,8655,52,4,3,1,1,1,0
1401,2637,8650,48,4,1,3,1,1,0
1402,2640,10261,43,2,2,0,1,1,0
1403,2640,8472,57,6,4,2,1,0,1
1404,2643,8456,58,10,5,5,1,1,0
1405,2643,8602,42,5,4,1,1,1,0
1406,2645,8659,55,9,3,6,1,0,1
1407,2645,8483,45,0,0,0,0,0,0
1408,2647,9879,69,5,2,3,3,1,2
1409,2647,8528,31,3,2,1,0,0,0
1410,2648,8655,46,4,3,1,2,2,0
1411,2648,8455,54,8,1,7,1,1,0
1412,2651,10252,48,7,5,2,1,1,0
1413,2651,8456,52,10,4,6,0,0,0
1414,2652,8654,42,4,2,2,1,1,0
1415,2652,8668,58,5,2,3,2,1,1
1416,2653,8586,34,7,4,3,2,0,2
1417,2653,10261,66,5,1,4,1,0,1
1418,2657,8559,26,7,4,3,1,1,0
1419,2657,8455,74,8,3,5,1,0,1
1420,2658,8483,46,9,6,3,2,2,0
1421,2658,8472,54,5,0,5,1,1,0
1422,2660,9825,55,5,1,4,1,1,0
1423,2660,8668,45,6,3,3,2,0,2
1424,2663,8559,55,6,4,2,2,1,1
1425,2663,8602,45,5,2,3,0,0,0
1426,2664,8659,35,7,3,4,3,1,2
1427,2664,8528,65,4,2,2,3,1,2
1428,2665,8483,65,10,3,7,3,1,2
1429,2665,8654,35,7,6,1,0,0,0
1430,2676,8472,55,6,3,3,2,2,0
1431,2676,10194,45,4,2,2,4,0,4
1432,2678,8455,53,5,1,4,2,1,1
1433,2678,8650,47,3,1,2,2,1,1
1434,2680,9825,58,8,4,4,2,1,1
1435,2680,8602,42,1,0,1,0,0,0
1436,2682,8472,56,8,2,6,4,1,3
1437,2682,8586,44,4,1,3,1,1,0
1438,2683,10261,66,7,2,5,3,2,1
1439,2683,8655,34,2,1,1,1,0,1
1440,2691,10252,60,8,6,2,2,1,1
1441,2691,8655,40,1,0,1,1,0,1
1442,2692,8668,58,9,3,6,1,1,0
1443,2692,8472,42,7,2,5,1,1,0
1444,2693,8559,66,9,5,4,2,1,1
1445,2693,10261,34,5,4,1,0,0,0
1446,2699,8472,25,5,3,2,4,1,3
1447,2699,9825,75,9,4,5,2,0,2
1448,2702,8668,41,7,1,6,2,1,1
1449,2702,10261,59,8,2,6,1,0,1
1450,2703,8456,43,3,1,2,1,1,0
1451,2703,8528,57,4,1,3,1,0,1
1452,2710,8650,57,9,2,7,1,0,1
1453,2710,8659,43,6,2,4,0,0,0
1454,2711,8472,46,6,1,5,1,1,0
1455,2711,8456,54,7,3,4,2,1,1
1456,2714,10261,55,10,4,6,2,1,1
1457,2714,8602,45,2,2,0,1,0,1
1458,2715,9825,67,9,4,5,1,1,0
1459,2715,8655,33,12,8,4,2,1,1
1460,2716,8559,55,9,7,2,2,1,1
1461,2716,8658,45,3,1,2,0,0,0
1462,2718,8455,63,8,3,5,3,3,0
1463,2718,10194,37,4,2,2,0,0,0
1464,2724,8655,66,6,1,5,4,0,4
1465,2724,8483,34,5,1,4,0,0,0
1466,2726,10261,63,9,3,6,3,1,2
1467,2726,10194,37,1,0,1,1,0,1
1468,2727,8528,49,15,5,10,4,0,4
1469,2727,8658,51,5,3,2,0,0,0
1470,2728,8456,51,2,2,0,2,1,1
1471,2728,8455,49,9,4,5,0,0,0
1472,2731,8668,52,7,4,3,3,2,1
1473,2731,10252,48,4,3,1,0,0,0
1474,2732,10261,65,8,6,2,2,1,1
1475,2732,8602,35,11,5,6,3,1,2
1476,2735,8658,46,5,3,2,1,0,1
1477,2735,8559,54,13,6,7,0,0,0
1478,2737,8455,61,13,6,7,2,1,1
1479,2737,10194,39,5,1,4,3,1,2
1480,2740,8650,52,7,3,4,2,1,1
1481,2740,8456,48,4,2,2,1,0,1
1482,2742,8586,51,8,3,5,2,1,1
1483,2742,10194,49,6,2,4,1,1,0
1484,2752,8668,52,6,3,3,2,1,1
1485,2752,8655,48,3,1,2,1,0,1
1486,2755,8559,48,7,6,1,1,1,0
1487,2755,9879,52,3,3,0,2,1,1
1488,2761,8472,58,3,1,2,1,1,0
1489,2761,8528,42,7,3,4,4,2,2
1490,2763,10252,62,3,1,2,4,2,2
1491,2763,10194,38,3,2,1,2,1,1
1492,2764,9879,57,7,3,4,1,1,0
1493,2764,8602,43,2,0,2,0,0,0
1494,2767,10261,46,7,4,3,5,1,4
1495,2767,8483,54,6,5,1,1,0,1
1496,2769,10260,72,7,2,5,4,2,2
1497,2769,9825,28,2,0,2,0,0,0
1498,2771,8472,56,6,4,2,2,2,0
1499,2771,9879,44,2,0,2,1,0,1
1500,2772,8456,58,12,5,7,3,1,2
1501,2772,8654,42,3,1,2,0,0,0
1502,2773,8655,35,9,4,5,1,1,0
1503,2773,8559,65,1,1,0,2,1,1
1504,2777,8668,58,4,1,3,2,0,2
1505,2777,8528,42,10,1,9,1,0,1
1506,2780,8483,47,6,4,2,2,0,2
1507,2780,8586,53,12,5,7,1,0,1
1508,2781,8655,38,4,2,2,1,1,0
1509,2781,8654,62,9,6,3,1,0,1
1510,2784,10261,73,12,7,5,3,1,2
1511,2784,8658,27,1,0,1,2,0,2
1512,2787,8559,58,7,4,3,1,1,0
1513,2787,8472,42,4,2,2,1,1,0
1514,2794,9879,40,13,6,7,2,1,1
1515,2794,8658,60,2,1,1,2,1,1
1516,2799,10260,61,7,4,3,2,1,1
1517,2799,8483,39,7,1,6,1,0,1
1518,2801,8654,21,11,9,2,2,2,0
1519,2801,8472,79,9,6,3,1,0,1
1520,2804,10261,69,8,6,2,1,0,1
1521,2804,8659,31,5,3,2,0,0,0
1522,2806,9825,55,5,3,2,3,2,1
1523,2806,9879,45,2,0,2,0,0,0
1524,2807,8559,48,9,6,3,3,2,1
1525,2807,8456,52,8,5,3,3,2,1
1526,2809,9825,56,13,6,7,1,1,0
1527,2809,8559,44,8,5,3,1,1,0
1528,2810,8654,52,4,2,2,1,0,1
1529,2810,8455,48,9,5,4,1,0,1
1530,2820,9825,58,5,2,3,2,1,1
1531,2820,8472,42,8,3,5,0,0,0
1532,2822,10252,60,8,6,2,3,0,3
1533,2822,8559,40,7,1,6,0,0,0
1534,2827,8528,53,2,2,0,1,1,0
1535,2827,8456,47,4,0,4,1,0,1
1536,2829,9825,38,16,6,10,1,1,0
1537,2829,8659,62,5,2,3,1,0,1
1538,2832,10261,56,9,4,5,1,0,1
1539,2832,10194,44,3,1,2,0,0,0
1540,2842,8654,49,6,2,4,1,1,0
1541,2842,9879,51,5,2,3,3,1,2
1542,2846,10194,44,11,9,2,4,2,2
1543,2846,8655,56,4,3,1,0,0,0
1544,2850,9825,57,15,7,8,1,0,1
1545,2850,8658,43,4,3,1,0,0,0
1546,2857,10194,45,3,1,2,3,2,1
1547,2857,8559,55,3,1,2,1,0,1
1548,2862,8654,43,1,1,0,1,0,1
1549,2862,10261,57,7,2,5,0,0,0
1550,2864,8483,46,10,5,5,2,2,0
1551,2864,8658,54,6,4,2,0,0,0
1552,2865,8659,48,6,5,1,3,2,1
1553,2865,9879,52,2,0,2,0,0,0
1554,2872,8456,60,13,7,6,1,1,0
1555,2872,10003,40,3,0,3,2,1,1
1556,2874,10172,46,8,4,4,1,0,1
1557,2874,8559,54,9,1,8,1,0,1
1558,2875,8455,67,10,0,10,3,1,2
1559,2875,10194,33,3,0,3,2,0,2
1560,2885,10003,63,8,3,5,2,1,1
1561,2885,8559,37,3,3,0,0,0,0
1562,2888,9879,30,2,2,0,3,1,2
1563,2888,8528,70,9,4,5,2,2,0
1564,2889,9825,49,5,2,3,2,1,1
1565,2889,8659,51,4,0,4,0,0,0
1566,2890,9850,60,8,4,4,1,1,0
1567,2890,10252,40,6,4,2,3,2,1
1568,2891,8455,67,6,1,5,1,0,1
1569,2891,8655,33,9,1,8,1,0,1
1570,2897,10172,58,8,4,4,2,1,1
1571,2897,8456,42,5,3,2,1,1,0
1572,2899,8455,61,6,2,4,2,0,2
1573,2899,8650,39,1,1,0,0,0,0
1574,2904,9879,43,7,3,4,1,1,0
1575,2904,8472,57,7,3,4,2,0,2
1576,2907,8659,61,6,2,4,1,0,1
1577,2907,8559,39,6,5,1,2,0,2
1578,2914,10172,59,5,3,2,2,1,1
1579,2914,9850,41,8,5,3,1,0,1
1580,2916,8528,55,1,1,0,2,1,1
1581,2916,8472,45,9,8,1,0,0,0
1582,2918,8586,64,12,5,7,2,0,2
1583,2918,8659,36,5,2,3,1,0,1
1584,2920,8655,43,6,6,0,1,0,1
1585,2920,10003,57,3,1,2,2,0,2
1586,2921,10194,40,3,2,1,2,1,1
1587,2921,8668,60,5,1,4,3,0,3
1588,2923,8456,72,4,1,3,5,4,1
1589,2923,9850,28,2,0,2,0,0,0
1590,2924,10261,55,10,4,6,3,1,2
1591,2924,8455,45,10,4,6,0,0,0
1592,2925,10172,56,2,1,1,2,2,0
1593,2925,8659,44,9,5,4,2,0,2
1594,2926,8586,82,13,6,7,4,2,2
1595,2926,8559,18,7,4,3,0,0,0
1596,2931,8456,43,2,1,1,1,1,0
1597,2931,8455,57,8,4,4,1,1,0
1598,2937,10003,53,4,3,1,1,1,0
1599,2937,9879,47,7,1,6,2,1,1
1600,2940,8659,61,6,2,4,1,1,0
1601,2940,8655,39,11,4,7,1,0,1
1602,2941,8668,52,17,6,11,2,1,1
1603,2941,9850,48,0,0,0,0,0,0
1604,2944,10261,52,6,2,4,1,1,0
1605,2944,10003,48,0,0,0,0,0,0
1606,2949,10172,30,9,3,6,1,0,1
1607,2949,8472,70,7,2,5,1,0,1
1608,2950,8586,51,9,4,5,3,2,1
1609,2950,8455,49,8,2,6,0,0,0
1610,2952,8602,40,7,3,4,1,0,1
1611,2952,9850,60,12,7,5,1,0,1
1612,2953,10252,55,3,3,0,3,1,2
1613,2953,9825,45,5,2,3,1,0,1
1614,2954,8559,43,2,2,0,1,1,0
1615,2954,8655,57,5,0,5,1,0,1
1616,2955,8668,56,8,5,3,2,2,0
1617,2955,10003,44,3,0,3,1,0,1
1618,2957,8456,60,14,6,8,3,2,1
1619,2957,10194,40,1,0,1,3,1,2
1620,2958,8659,46,4,2,2,2,1,1
1621,2958,10261,54,9,1,8,1,1,0
1622,2959,8602,22,3,3,0,2,0,2
1623,2959,9825,78,14,5,9,3,0,3
1624,2961,9879,44,5,3,2,1,1,0
1625,2961,8455,56,16,4,12,1,0,1
1626,2962,8650,72,11,3,8,2,1,1
1627,2962,8655,28,2,1,1,2,1,1
1628,2964,9850,27,3,3,0,2,1,1
1629,2964,8586,73,8,4,4,0,0,0
1630,2966,8668,44,2,2,0,1,1,0
1631,2966,8472,56,8,5,3,2,0,2
1632,2967,10172,47,5,3,2,1,1,0
1633,2967,10003,53,3,1,2,1,0,1
1634,2968,8456,61,8,4,4,4,1,3
1635,2968,8659,39,2,2,0,0,0,0
1636,2969,10172,38,5,2,3,2,1,1
1637,2969,9825,62,10,4,6,1,1,0
1638,2971,8455,64,4,3,1,3,2,1
1639,2971,10252,36,6,3,3,0,0,0
1640,2972,8650,55,5,4,1,4,1,3
1641,2972,10261,45,1,0,1,1,0,1
1642,2978,8668,56,7,3,4,2,1,1
1643,2978,8659,44,1,1,0,0,0,0
1644,2980,10252,51,3,2,1,1,1,0
1645,2980,8655,49,3,1,2,0,0,0
1646,2986,8472,47,5,3,2,6,2,4
1647,2986,10261,53,3,2,1,1,0,1
1648,2988,8602,45,5,2,3,1,1,0
1649,2988,9879,55,4,2,2,1,1,0
1650,2993,8650,53,8,4,4,1,0,1
1651,2993,8456,47,5,4,1,2,0,2
1652,2995,9850,65,5,2,3,1,0,1
1653,2995,10172,35,5,1,4,0,0,0
1654,2999,10252,63,8,3,5,1,1,0
1655,2999,8668,37,5,1,4,0,0,0
1656,3000,8655,40,8,5,3,6,4,2
1657,3000,9879,60,8,1,7,1,0,1
1658,3002,10194,44,1,1,0,3,2,1
1659,3002,8650,56,7,2,5,0,0,0
1660,3017,10003,76,9,4,5,1,1,0
1661,3017,8472,24,5,0,5,1,1,0
1662,3018,8602,46,7,6,1,2,1,1
1663,3018,10252,54,3,2,1,0,0,0
1664,3022,10003,18,3,3,0,3,1,2
1665,3022,8455,82,8,5,3,3,2,1
1666,3025,10172,29,2,1,1,1,1,0
1667,3025,10252,71,15,4,11,1,0,1
1668,3028,8659,48,9,5,4,1,0,1
1669,3028,9879,52,6,4,2,0,0,0
1670,3031,8586,54,5,4,1,2,1,1
1671,3031,8650,46,13,4,9,4,3,1
1672,3032,8456,44,7,4,3,2,0,2
1673,3032,9879,56,6,1,5,0,0,0
1674,3034,8559,72,6,3,3,2,1,1
1675,3034,9850,28,8,4,4,0,0,0
1676,3035,10172,53,7,2,5,3,2,1
1677,3035,8602,47,4,0,4,2,2,0
1678,3037,10003,34,7,2,5,2,1,1
1679,3037,8659,66,11,5,6,3,2,1
1680,3041,8528,51,4,2,2,1,1,0
1681,3041,8559,49,4,0,4,0,0,0
1682,3042,8668,47,6,2,4,1,1,0
1683,3042,8455,53,8,7,1,1,1,0
1684,3044,8650,56,4,1,3,4,2,2
1685,3044,10260,44,4,3,1,0,0,0
1686,3045,9825,43,8,4,4,1,1,0
1687,3045,8472,57,4,0,4,1,0,1
1688,3046,10003,62,7,3,4,1,1,0
1689,3046,9850,38,6,3,3,3,1,2
1690,3047,10261,29,6,3,3,2,1,1
1691,3047,8586,71,4,3,1,2,0,2
1692,3052,8456,69,12,8,4,3,2,1
1693,3052,8655,31,4,1,3,0,0,0
1694,3053,8602,42,7,4,3,3,2,1
1695,3053,10261,58,7,4,3,0,0,0
1696,3057,8659,60,10,5,5,3,0,3
1697,3057,8472,40,6,1,5,0,0,0
1698,3058,10252,44,4,3,1,4,2,2
1699,3058,8528,56,5,1,4,1,0,1
1700,3064,10172,45,9,4,5,2,0,2
1701,3064,8668,55,3,3,0,0,0,0
1702,3069,9825,62,9,2,7,1,1,0
1703,3069,10261,38,3,1,2,0,0,0
1704,3075,9850,43,7,3,4,4,0,4
1705,3075,8528,57,6,4,2,0,0,0
1706,3078,8655,51,7,4,3,6,3,3
1707,3078,8602,49,7,1,6,0,0,0
1708,3081,9825,45,7,3,4,2,2,0
1709,3081,8668,55,3,0,3,2,2,0
1710,3087,8528,56,10,3,7,3,2,1
1711,3087,8659,44,2,2,0,1,0,1
1712,3089,10252,46,7,1,6,4,1,3
1713,3089,8602,54,1,1,0,1,0,1
1714,3099,9825,66,10,7,3,3,1,2
1715,3099,10252,34,1,0,1,1,1,0
1716,3105,10194,47,4,2,2,2,1,1
1717,3105,8456,53,7,2,5,1,1,0
1718,3106,8472,62,5,3,2,3,1,2
1719,3106,10172,38,5,4,1,1,0,1
1720,3111,8668,49,7,2,5,1,1,0
1721,3111,8659,51,4,3,1,0,0,0
1722,3112,9879,45,8,4,4,1,0,1
1723,3112,9850,55,6,2,4,0,0,0
1724,3113,8472,49,2,1,1,5,2,3
1725,3113,8456,51,11,3,8,0,0,0
1726,3115,9825,41,7,2,5,4,1,3
1727,3115,10172,59,6,3,3,0,0,0
1728,3118,8602,43,12,8,4,1,1,0
1729,3118,8559,57,9,2,7,0,0,0
1730,3122,8650,54,4,2,2,2,2,0
1731,3122,10252,46,2,1,1,0,0,0
1732,3124,8668,41,6,3,3,1,1,0
1733,3124,9850,59,9,1,8,1,0,1
1734,3127,10003,58,9,4,5,1,1,0
1735,3127,10261,42,2,2,0,0,0,0
1736,3128,8659,47,5,3,2,1,0,1
1737,3128,8655,53,12,5,7,0,0,0
1738,3129,10252,43,4,2,2,1,0,1
1739,3129,10194,57,3,3,0,1,0,1
1740,3133,8456,70,10,5,5,1,1,0
1741,3133,8659,30,2,1,1,2,0,2
1742,3136,8586,51,9,5,4,1,1,0
1743,3136,9850,49,5,3,2,0,0,0
1744,3138,9825,69,10,3,7,3,0,3
1745,3138,8602,31,5,0,5,1,0,1
1746,3140,8559,47,6,3,3,3,0,3
1747,3140,8586,53,5,3,2,0,0,0
1748,3141,8455,52,6,1,5,5,1,4
1749,3141,10261,48,3,3,0,0,0,0
1750,3142,9879,37,5,1,4,1,1,0
1751,3142,8650,63,5,3,2,1,0,1
1752,3144,8456,61,9,1,8,1,1,0
1753,3144,9850,39,9,6,3,0,0,0
1754,3152,10003,43,10,5,5,1,1,0
1755,3152,8559,57,3,3,0,1,0,1
1756,3153,9879,58,6,3,3,3,1,2
1757,3153,8528,42,3,2,1,0,0,0
1758,3154,8650,63,19,7,12,2,1,1
1759,3154,8659,37,5,4,1,0,0,0
1760,3157,8586,59,11,6,5,1,1,0
1761,3157,10172,41,4,2,2,5,0,5
1762,3159,8455,60,11,7,4,1,1,0
1763,3159,10172,40,5,3,2,1,1,0
1764,3162,8650,60,6,2,4,1,0,1
1765,3162,9850,40,2,0,2,2,0,2
1766,3163,9825,51,9,3,6,3,3,0
1767,3163,10194,49,1,0,1,1,1,0
1768,3166,8586,63,7,5,2,1,1,0
1769,3166,8655,37,0,0,0,1,1,0
1770,3169,9850,32,2,1,1,2,0,2
1771,3169,9825,68,9,1,8,0,0,0
1772,3170,8586,66,9,3,6,1,1,0
1773,3170,10252,34,2,2,0,0,0,0
1774,3171,8528,58,7,3,4,1,1,0
1775,3171,8655,42,4,0,4,1,1,0
1776,3174,8650,39,9,6,3,3,2,1
1777,3174,8455,61,2,1,1,0,0,0
1778,3176,8456,58,10,8,2,2,2,0
1779,3176,10261,42,7,5,2,1,1,0
1780,3186,8586,60,7,4,3,1,1,0
1781,3186,9879,40,6,2,4,3,0,3
1782,3187,9825,62,6,5,1,2,1,1
1783,3187,8659,38,7,1,6,1,0,1
1784,3188,8528,64,5,1,4,1,0,1
1785,3188,8602,36,5,3,2,0,0,0
1786,3189,9825,60,7,4,3,4,3,1
1787,3189,10003,40,6,4,2,4,0,4
1788,3192,8655,38,5,2,3,3,2,1
1789,3192,9879,62,8,1,7,1,0,1
1790,3193,8456,52,6,3,3,3,2,1
1791,3193,8528,48,7,3,4,1,0,1
1792,3199,10261,45,10,4,6,2,1,1
1793,3199,10252,55,2,1,1,0,0,0
1794,3202,8668,58,6,5,1,1,0,1
1795,3202,8528,42,2,0,2,0,0,0
1796,3203,8456,46,9,4,5,4,2,2
1797,3203,9879,54,8,4,4,0,0,0
1798,3206,10003,44,3,2,1,1,0,1
1799,3206,8659,56,13,5,8,0,0,0
1800,3208,10172,60,9,8,1,1,0,1
1801,3208,8602,40,3,0,3,0,0,0
1802,3209,8559,41,2,1,1,1,1,0
1803,3209,9825,59,13,4,9,0,0,0
1804,3210,8455,38,5,3,2,1,1,0
1805,3210,10003,62,2,0,2,1,0,1
1806,3212,8456,57,8,2,6,1,0,1
1807,3212,8668,43,4,0,4,0,0,0
1808,3217,8659,49,4,2,2,1,1,0
1809,3217,9879,51,6,5,1,3,2,1
1810,3220,8456,58,6,4,2,2,0,2
1811,3220,8655,42,3,1,2,1,0,1
1812,3223,10172,44,10,5,5,3,1,2
1813,3223,9879,56,8,5,3,0,0,0
1814,3225,8659,49,3,2,1,3,2,1
1815,3225,8472,51,6,5,1,4,1,3
1816,3230,8668,33,3,2,1,1,1,0
1817,3230,8455,67,2,0,2,0,0,0
1818,3232,10252,38,5,3,2,3,2,1
1819,3232,8456,62,5,3,2,0,0,0
1820,3239,10194,32,2,0,2,3,1,2
1821,3239,9825,68,1,0,1,0,0,0
1822,3241,8655,70,7,5,2,1,1,0
1823,3241,8586,30,5,3,2,2,1,1
1824,3243,8668,76,4,1,3,2,1,1
1825,3243,9879,24,6,4,2,2,1,1
1826,3247,8455,54,5,1,4,2,1,1
1827,3247,10172,46,4,1,3,1,0,1
1828,3250,10260,65,9,6,3,1,1,0
1829,3250,8668,35,7,5,2,1,0,1
1830,3251,9850,38,4,1,3,2,1,1
1831,3251,9879,62,8,5,3,3,0,3
1832,3256,8650,65,7,4,3,3,1,2
1833,3256,8659,35,3,0,3,0,0,0
1834,3257,10252,51,5,2,3,4,2,2
1835,3257,8654,49,4,2,2,1,0,1
1836,3258,8528,49,4,3,1,2,1,1
1837,3258,8455,51,2,0,2,0,0,0
1838,3260,8650,61,11,4,7,1,1,0
1839,3260,10261,39,2,0,2,1,0,1
1840,3262,9850,56,11,6,5,2,2,0
1841,3262,10194,44,3,1,2,2,0,2
1842,3264,8472,56,3,1,2,1,1,0
1843,3264,10252,44,4,3,1,1,0,1
1844,3265,8455,46,7,3,4,4,4,0
1845,3265,10003,54,7,2,5,1,0,1
1846,3268,8456,64,11,4,7,2,1,1
1847,3268,8654,36,0,0,0,2,0,2
1848,3273,8456,60,5,3,2,2,2,0
1849,3273,8586,40,1,0,1,1,0,1
1850,3274,10261,54,9,4,5,2,1,1
1851,3274,8654,46,4,0,4,2,0,2
1852,3275,9850,46,3,1,2,3,2,1
1853,3275,9798,54,2,1,1,3,1,2
1854,3280,8472,57,4,1,3,3,1,2
1855,3280,9879,43,9,3,6,2,0,2
1856,3281,8650,59,7,4,3,1,0,1
1857,3281,8528,41,3,2,1,0,0,0
1858,3282,10252,42,8,5,3,2,1,1
1859,3282,8456,58,8,7,1,2,0,2
1860,3288,10194,43,5,2,3,1,0,1
1861,3288,8654,57,8,3,5,2,0,2
1862,3289,10252,65,5,3,2,2,0,2
1863,3289,9825,35,6,3,3,1,0,1
1864,3291,8668,44,8,3,5,2,1,1
1865,3291,9850,56,5,0,5,1,1,0
1866,3293,8466,44,8,5,3,1,0,1
1867,3293,10261,56,3,0,3,2,0,2
1868,3294,10194,48,4,2,2,3,1,2
1869,3294,9879,52,4,1,3,3,2,1
1870,3298,8528,67,9,4,5,3,2,1
1871,3298,9798,33,9,4,5,0,0,0
1872,3301,9850,52,9,3,6,2,1,1
1873,3301,8466,48,6,1,5,1,0,1
1874,3302,10261,45,6,1,5,3,1,2
1875,3302,10194,55,3,1,2,2,1,1
1876,3304,10003,57,4,1,3,1,1,0
1877,3304,8659,43,0,0,0,0,0,0
1878,3308,8668,62,8,3,5,2,1,1
1879,3308,9825,38,9,1,8,1,1,0
1880,3309,10003,51,7,4,3,3,1,2
1881,3309,9825,49,9,2,7,2,1,1
1882,3311,8650,65,13,7,6,1,0,1
1883,3311,8466,35,5,1,4,0,0,0
1884,3312,8456,53,6,3,3,1,0,1
1885,3312,8668,47,4,2,2,0,0,0
1886,3313,8528,52,3,2,1,1,1,0
1887,3313,10261,48,7,4,3,3,1,2
1888,3314,9850,44,2,1,1,2,1,1
1889,3314,8472,56,6,1,5,2,1,1
1890,3318,8455,58,7,2,5,4,1,3
1891,3318,8654,42,8,2,6,2,2,0
1892,3322,9879,40,6,3,3,2,1,1
1893,3322,10261,60,11,5,6,2,1,1
1894,3324,8466,56,9,6,3,2,1,1
1895,3324,9798,44,2,1,1,3,1,2
1896,3326,9850,48,8,5,3,2,1,1
1897,3326,10003,52,2,1,1,0,0,0
1898,3330,10252,43,3,1,2,2,1,1
1899,3330,8650,57,16,5,11,0,0,0
1900,3332,10261,65,6,4,2,1,1,0
1901,3332,8456,35,6,3,3,0,0,0
1902,3336,8668,55,4,3,1,3,2,1
1903,3336,10194,45,8,2,6,1,1,0
1904,3337,8586,62,13,9,4,1,1,0
1905,3337,10003,38,0,0,0,2,0,2
1906,3340,8650,60,5,2,3,4,2,2
1907,3340,9879,40,5,1,4,0,0,0
1908,3341,8456,72,9,4,5,3,2,1
1909,3341,9798,28,1,0,1,1,0,1
1910,3342,10172,41,5,2,3,1,0,1
1911,3342,10261,59,6,0,6,0,0,0
1912,3343,8472,51,5,4,1,3,2,1
1913,3343,8466,49,6,3,3,2,1,1
1914,3352,8466,45,3,2,1,1,0,1
1915,3352,9879,55,0,0,0,1,0,1
1916,3356,10003,64,3,0,3,2,1,1
1917,3356,9798,36,1,0,1,0,0,0
1918,3357,8650,55,9,4,5,1,1,0
1919,3357,10194,45,6,3,3,0,0,0
1920,3368,8586,53,11,4,7,1,1,0
1921,3368,8659,47,7,0,7,1,1,0
1922,3370,10252,52,4,2,2,6,2,4
1923,3370,8528,48,3,0,3,1,1,0
1924,3374,8456,40,7,2,5,2,2,0
1925,3374,9850,60,4,0,4,0,0,0
1926,3376,8654,61,7,3,4,1,1,0
1927,3376,9798,39,0,0,0,0,0,0
1928,3380,8472,31,6,6,0,3,1,2
1929,3380,8650,69,14,7,7,0,0,0
1930,3381,8456,70,5,3,2,2,0,2
1931,3381,10194,30,1,0,1,1,0,1
1932,3382,8668,38,12,8,4,1,1,0
1933,3382,10261,62,10,0,10,1,0,1
1934,3384,10252,36,5,3,2,1,1,0
1935,3384,10003,64,11,4,7,2,0,2
1936,3386,9879,58,3,1,2,2,1,1
1937,3386,8659,42,7,0,7,0,0,0
1938,3392,8528,49,8,3,5,2,1,1
1939,3392,9879,51,4,2,2,1,0,1
1940,3394,10261,53,3,3,0,3,1,2
1941,3394,9850,47,3,1,2,1,0,1
1942,3395,8586,59,9,3,6,1,1,0
1943,3395,10172,41,2,2,0,0,0,0
1944,3396,8659,61,3,1,2,3,1,2
1945,3396,9798,39,5,1,4,2,1,1
1946,3398,8472,61,8,3,5,4,2,2
1947,3398,8654,39,4,1,3,2,0,2
1948,3400,9850,41,2,2,0,3,2,1
1949,3400,8650,59,8,6,2,1,1,0
1950,3401,8456,58,8,5,3,3,3,0
1951,3401,9879,42,0,0,0,4,2,2
1952,3405,8586,53,16,6,10,5,1,4
1953,3405,10260,47,3,1,2,0,0,0
1954,3406,8659,45,7,4,3,3,1,2
1955,3406,10252,55,5,3,2,1,0,1
1956,3407,8654,55,14,4,10,1,1,0
1957,3407,10172,45,4,1,3,1,1,0
1958,3408,8528,61,9,4,5,1,1,0
1959,3408,8472,39,7,3,4,1,0,1
1960,3409,8650,38,4,3,1,1,0,1
1961,3409,9825,62,7,4,3,0,0,0
1962,3410,10261,48,5,3,2,1,0,1
1963,3410,10252,52,8,3,5,2,0,2
1964,3414,8455,73,4,1,3,1,1,0
1965,3414,9798,27,0,0,0,1,0,1
1966,3416,10003,55,8,4,4,2,1,1
1967,3416,8472,45,1,0,1,1,0,1
1968,3420,8668,61,8,3,5,1,0,1
1969,3420,10252,39,0,0,0,1,0,1
1970,3423,10261,31,11,8,3,4,2,2
1971,3423,8455,69,6,2,4,3,0,3
1972,3424,9850,47,9,1,8,1,0,1
1973,3424,10172,53,5,0,5,0,0,0
1974,3428,8466,46,12,4,8,3,1,2
1975,3428,8528,54,2,2,0,0,0,0
1976,3431,8650,65,14,5,9,2,2,0
1977,3431,8659,35,2,0,2,2,0,2
1978,3435,10194,53,10,7,3,1,1,0
1979,3435,9798,47,3,0,3,3,1,2
1980,3438,10261,47,5,1,4,2,2,0
1981,3438,8586,53,7,1,6,2,1,1
1982,3442,8456,44,7,6,1,1,1,0
1983,3442,8455,56,4,0,4,0,0,0
1984,3443,8466,39,3,2,1,4,0,4
1985,3443,10261,61,4,3,1,1,0,1
1986,3446,8528,68,7,3,4,3,2,1
1987,3446,9798,32,1,0,1,2,1,1
1988,3447,8472,62,4,2,2,2,2,0
1989,3447,8659,38,3,1,2,1,0,1
1990,3448,8654,14,8,4,4,2,1,1
1991,3448,8586,86,12,4,8,1,0,1
1992,3450,8455,46,19,10,9,1,1,0
1993,3450,8659,54,5,1,4,4,2,2
1994,3453,10172,45,3,1,2,1,0,1
1995,3453,8466,55,11,5,6,0,0,0
1996,3461,8586,65,7,4,3,1,1,0
1997,3461,8650,35,3,3,0,1,0,1
1998,3462,8528,58,9,5,4,2,1,1
1999,3462,8456,42,5,2,3,0,0,0
2000,3464,8466,54,8,4,4,2,1,1
2001,3464,9850,46,4,4,0,0,0,0
2002,3465,10172,43,5,4,1,2,2,0
2003,3465,8472,57,2,0,2,5,2,3
2004,3468,8654,39,2,2,0,2,0,2
2005,3468,10260,61,8,1,7,0,0,0
2006,3469,8455,64,9,4,5,1,1,0
2007,3469,9798,36,3,1,2,1,1,0
2008,3478,8528,59,7,3,4,1,1,0
2009,3478,10194,41,9,4,5,0,0,0
2010,3479,10172,35,7,6,1,1,1,0
2011,3479,10252,65,5,1,4,3,0,3
2012,3480,8455,29,11,5,6,3,2,1
2013,3480,8654,71,9,2,7,3,0,3
2014,3481,8668,52,4,3,1,1,1,0
2015,3481,8456,48,13,3,10,0,0,0
2016,3482,10260,57,6,4,2,2,1,1
2017,3482,9798,43,3,0,3,0,0,0
2018,3483,8466,62,9,6,3,5,2,3
2019,3483,8650,38,8,4,4,1,1,0
2020,3490,8650,57,12,9,3,2,2,0
2021,3490,10252,43,6,3,3,1,0,1
2022,3493,8456,69,10,4,6,2,2,0
2023,3493,10261,31,1,0,1,2,0,2
2024,3497,8659,46,10,4,6,3,2,1
2025,3497,8654,54,5,2,3,0,0,0
2026,3498,9850,57,5,2,3,1,1,0
2027,3498,8528,43,4,1,3,3,0,3
2028,3503,10003,65,9,4,5,4,1,3
2029,3503,9850,35,4,1,3,0,0,0
2030,3516,8466,53,13,6,7,2,1,1
2031,3516,8654,47,4,3,1,2,1,1
2032,3523,10172,55,8,4,4,3,1,2
2033,3523,10194,45,7,5,2,0,0,0
2034,3524,8472,51,4,3,1,4,1,3
2035,3524,8668,49,7,3,4,3,2,1
2036,3529,9825,37,9,4,5,1,0,1
2037,3529,10260,63,5,2,3,1,0,1
2038,3530,8472,41,5,3,2,2,2,0
2039,3530,10252,59,6,3,3,0,0,0
2040,3531,8455,62,17,9,8,1,1,0
2041,3531,10003,38,6,2,4,4,0,4
2042,3532,8668,60,10,5,5,1,0,1
2043,3532,9879,40,5,4,1,1,0,1
2044,3535,9798,55,6,4,2,2,1,1
2045,3535,10172,45,5,0,5,3,1,2
2046,3536,8659,41,6,5,1,2,1,1
2047,3536,8466,59,4,3,1,1,1,0
2048,3540,8650,55,7,1,6,2,1,1
2049,3540,8668,45,2,0,2,0,0,0
2050,3542,9850,58,5,5,0,2,2,0
2051,3542,10252,42,5,2,3,1,1,0
2052,3544,10194,42,6,2,4,4,1,3
2053,3544,8472,58,5,1,4,1,0,1
2054,3548,8654,56,6,2,4,1,1,0
2055,3548,10261,44,6,4,2,1,0,1
2056,3550,8455,54,9,6,3,2,1,1
2057,3550,10252,46,7,3,4,1,1,0
2058,3551,8668,60,11,4,7,5,2,3
2059,3551,8654,40,2,1,1,1,0,1
2060,3553,10260,38,5,4,1,3,3,0
2061,3553,10003,62,3,0,3,1,0,1
2062,3554,9850,44,5,3,2,2,0,2
2063,3554,8659,56,6,1,5,1,0,1
2064,3560,8650,75,19,9,10,1,0,1
2065,3560,10172,25,4,3,1,0,0,0
2066,3561,9850,57,6,5,1,1,1,0
2067,3561,8456,43,3,1,2,0,0,0
2068,3567,9798,46,4,2,2,3,2,1
2069,3567,8654,54,6,2,4,2,2,0
2070,3568,10252,39,4,4,0,1,1,0
2071,3568,8528,61,8,3,5,2,2,0
2072,3569,8466,43,6,3,3,1,1,0
2073,3569,9825,57,10,5,5,6,2,4
2074,3573,10260,59,6,4,2,6,0,6
2075,3573,8528,41,4,0,4,0,0,0
2076,3576,8586,61,8,5,3,1,0,1
2077,3576,9798,39,1,0,1,0,0,0
2078,3577,10194,53,3,2,1,1,0,1
2079,3577,8456,47,9,3,6,0,0,0
2080,3578,8650,56,8,4,4,3,1,2
2081,3578,8472,44,3,0,3,3,2,1
2082,3579,8455,55,10,6,4,1,1,0
2083,3579,10194,45,3,2,1,2,1,1
2084,3580,8650,43,7,4,3,1,0,1
2085,3580,10260,57,4,2,2,0,0,0
2086,3581,9825,42,5,4,1,1,0,1
2087,3581,8456,58,9,5,4,1,0,1
2088,3585,10172,48,5,3,2,1,0,1
2089,3585,8586,52,11,1,10,0,0,0
2090,3590,8659,47,5,2,3,2,2,0
2091,3590,10252,53,6,2,4,1,0,1
2092,3594,8650,57,7,2,5,2,1,1
2093,3594,9850,43,7,4,3,0,0,0
2094,3598,8528,43,4,4,0,2,1,1
2095,3598,8472,57,2,1,1,0,0,0
2096,3601,8472,40,6,3,3,4,2,2
2097,3601,8456,60,10,2,8,1,0,1
2098,3604,10003,63,12,4,8,2,0,2
2099,3604,9798,37,11,4,7,0,0,0
2100,3607,9825,60,8,3,5,2,1,1
2101,3607,8654,40,2,1,1,1,1,0
2102,3608,8668,44,10,5,5,4,3,1
2103,3608,8528,56,2,1,1,4,1,3
2104,3610,9798,43,8,3,5,1,1,0
2105,3610,8650,57,6,2,4,2,0,2
2106,3618,8654,53,5,2,3,2,0,2
2107,3618,8466,47,3,1,2,0,0,0
2108,3621,10260,56,5,3,2,3,2,1
2109,3621,8455,44,9,6,3,1,0,1
2110,3626,8586,44,2,1,1,1,0,1
2111,3626,8466,56,5,0,5,0,0,0
2112,3627,10194,53,8,3,5,2,2,0
2113,3627,8472,47,2,1,1,2,1,1
2114,3628,8528,56,13,6,7,3,2,1
2115,3628,8654,44,6,4,2,1,1,0
2116,3629,9825,54,9,4,5,2,2,0
2117,3629,10252,46,3,1,2,5,4,1
2118,3631,9826,47,4,1,3,1,1,0
2119,3631,8586,53,6,2,4,0,0,0
2120,3632,8650,46,14,7,7,5,3,2
2121,3632,10194,54,6,2,4,0,0,0
2122,3637,8466,43,5,4,1,2,1,1
2123,3637,8659,57,7,2,5,2,0,2
2124,3638,8654,46,6,3,3,1,0,1
2125,3638,8344,54,4,3,1,1,0,1
2126,3641,8586,38,12,7,5,5,1,4
2127,3641,8668,62,6,1,5,2,1,1
2128,3644,9850,32,4,3,1,2,0,2
2129,3644,8456,68,13,4,9,0,0,0
2130,3645,10261,37,10,4,6,2,1,1
2131,3645,8455,63,9,5,4,2,0,2
2132,3646,10194,43,4,1,3,1,1,0
2133,3646,8466,57,3,0,3,1,0,1
2134,3651,8668,73,4,2,2,1,1,0
2135,3651,9826,27,3,1,2,0,0,0
2136,3653,10260,37,1,1,0,3,2,1
2137,3653,9825,63,5,1,4,0,0,0
2138,3654,8654,49,8,6,2,1,1,0
2139,3654,9850,51,2,0,2,1,0,1
2140,3657,10003,64,12,7,5,2,2,0
2141,3657,10194,36,1,0,1,0,0,0
2142,3658,10261,35,5,4,1,2,0,2
2143,3658,8586,65,19,6,13,0,0,0
2144,3659,8466,54,6,2,4,5,4,1
2145,3659,9825,46,2,0,2,1,0,1
2146,3664,8456,56,5,5,0,2,2,0
2147,3664,8586,44,6,3,3,2,2,0
2148,3665,9850,56,7,3,4,1,0,1
2149,3665,10261,44,6,3,3,0,0,0
2150,3667,10252,44,9,5,4,1,1,0
2151,3667,8659,56,2,1,1,1,0,1
2152,3668,8455,55,12,4,8,4,2,2
2153,3668,8654,45,4,2,2,1,0,1
2154,3671,8455,51,9,6,3,4,1,3
2155,3671,8466,49,4,2,2,0,0,0
2156,3672,8668,58,14,6,8,4,3,1
2157,3672,10194,42,4,1,3,1,0,1
2158,3673,8667,43,5,2,3,4,2,2
2159,3673,8650,57,6,3,3,0,0,0
2160,3674,8456,47,3,3,0,1,0,1
2161,3674,10003,53,5,4,1,0,0,0
2162,3684,8472,44,6,4,2,5,4,1
2163,3684,8455,56,7,2,5,2,1,1
2164,3689,9825,49,7,4,3,1,0,1
2165,3689,8668,51,4,1,3,0,0,0
2166,3691,9879,57,12,5,7,1,1,0
2167,3691,10252,43,6,2,4,1,0,1
2168,3692,8650,65,20,7,13,1,1,0
2169,3692,8654,35,6,4,2,3,2,1
2170,3693,10260,48,6,3,3,4,2,2
2171,3693,10261,52,2,2,0,1,0,1
2172,3695,8455,59,5,3,2,3,1,2
2173,3695,10194,41,2,2,0,0,0,0
2174,3696,8586,48,13,6,7,1,0,1
2175,3696,8472,52,6,2,4,0,0,0
2176,3698,8659,66,14,3,11,1,1,0
2177,3698,9850,34,1,1,0,1,0,1
2178,3701,8455,65,9,2,7,1,1,0
2179,3701,9826,35,6,2,4,0,0,0
2180,3702,8668,53,10,7,3,4,0,4
2181,3702,9879,47,4,1,3,0,0,0
2182,3705,8466,58,7,3,4,1,1,0
2183,3705,10261,42,7,2,5,0,0,0
2184,3710,9826,36,6,4,2,4,0,4
2185,3710,10261,64,4,1,3,0,0,0
2186,3711,9879,46,8,6,2,3,1,2
2187,3711,8456,54,11,6,5,0,0,0
2188,3712,8650,62,11,7,4,2,1,1
2189,3712,8344,38,6,2,4,0,0,0
2190,3715,10194,51,4,3,1,1,0,1
2191,3715,10252,49,8,4,4,0,0,0
2192,3716,8472,63,8,4,4,1,1,0
2193,3716,9850,37,9,6,3,2,0,2
2194,3719,9826,36,7,2,5,1,1,0
2195,3719,10252,64,5,2,3,1,0,1
2196,3721,8455,46,12,10,2,2,0,2
2197,3721,10003,54,2,1,1,1,0,1
2198,3723,8667,38,5,1,4,2,1,1
2199,3723,10260,62,5,3,2,0,0,0
2200,3724,8456,46,12,5,7,4,1,3
2201,3724,8650,54,8,3,5,2,0,2
2202,3725,10261,67,8,3,5,1,1,0
2203,3725,10194,33,4,4,0,0,0,0
2204,3733,9879,51,4,1,3,3,2,1
2205,3733,8667,49,13,6,7,6,2,4
2206,3734,8456,81,13,11,2,6,4,2
2207,3734,9826,19,4,1,3,0,0,0
2208,3735,9825,55,5,3,2,3,1,2
2209,3735,10261,45,6,4,2,2,1,1
2210,3738,8659,49,16,8,8,3,3,0
2211,3738,8654,51,6,3,3,0,0,0
2212,3744,8455,44,6,2,4,1,0,1
2213,3744,10260,56,7,1,6,0,0,0
2214,3745,8654,45,3,1,2,2,2,0
2215,3745,10261,55,3,0,3,0,0,0
2216,3746,8466,55,9,2,7,2,2,0
2217,3746,8472,45,3,0,3,3,1,2
2218,3748,8586,47,9,6,3,2,2,0
2219,3748,10003,53,5,3,2,0,0,0
2220,3755,10194,40,5,4,1,1,1,0
2221,3755,8668,60,8,1,7,1,0,1
2222,3758,8659,61,5,2,3,1,0,1
2223,3758,10261,39,6,3,3,0,0,0
2224,3759,9825,58,4,1,3,1,1,0
2225,3759,10252,42,6,1,5,4,2,2
2226,3760,8654,31,2,2,0,1,0,1
2227,3760,8344,69,10,2,8,0,0,0
2228,3761,9850,42,7,4,3,2,1,1
2229,3761,8668,58,7,4,3,1,0,1
2230,3762,9879,66,5,2,3,2,0,2
2231,3762,8472,34,3,2,1,1,0,1
2232,3763,8667,52,5,4,1,3,1,2
2233,3763,8455,48,7,4,3,0,0,0
2234,3765,8456,47,6,1,5,5,2,3
2235,3765,10261,53,7,2,5,0,0,0
2236,3767,10194,57,8,3,5,4,1,3
2237,3767,8650,43,5,1,4,0,0,0
2238,3768,8586,75,3,3,0,1,1,0
2239,3768,9826,25,3,3,0,0,0,0
2240,3769,9825,65,12,5,7,2,1,1
2241,3769,9879,35,6,2,4,1,1,0
2242,3770,10260,54,5,4,1,1,0,1
2243,3770,8455,46,4,2,2,0,0,0
2244,3771,10194,56,8,5,3,3,1,2
2245,3771,9826,44,6,2,4,1,0,1
2246,3775,8466,57,14,8,6,1,1,0
2247,3775,8472,43,9,1,8,0,0,0
2248,3778,10261,53,10,6,4,1,0,1
2249,3778,8654,47,4,3,1,0,0,0
2250,3779,8659,58,3,1,2,4,4,0
2251,3779,10252,42,4,2,2,3,1,2
2252,3780,8667,62,6,3,3,1,1,0
2253,3780,9826,38,3,2,1,2,1,1
2254,3781,8650,33,8,6,2,2,2,0
2255,3781,8668,67,15,6,9,0,0,0
2256,3783,10261,53,12,9,3,1,1,0
2257,3783,9850,47,4,1,3,2,1,1
2258,3784,8466,47,10,3,7,3,2,1
2259,3784,9825,53,2,1,1,2,0,2
2260,3786,10003,60,7,3,4,3,1,2
2261,3786,9879,40,7,6,1,2,1,1
2262,3787,8654,28,1,1,0,1,0,1
2263,3787,8455,72,19,6,13,0,0,0
2264,3788,8586,30,2,1,1,2,2,0
2265,3788,8456,70,8,3,5,0,0,0
2266,3789,9825,71,5,3,2,2,1,1
2267,3789,9826,29,4,1,3,0,0,0
2268,3790,8344,43,6,3,3,4,1,3
2269,3790,9850,57,7,1,6,0,0,0
2270,3793,8586,56,8,3,5,1,1,0
2271,3793,8667,44,3,0,3,0,0,0
2272,3794,8455,39,7,5,2,1,1,0
2273,3794,8456,61,8,3,5,0,0,0
2274,3795,10261,53,15,5,10,4,4,0
2275,3795,8472,47,5,3,2,0,0,0
2276,3797,8650,47,6,1,5,2,1,1
2277,3797,8659,53,5,1,4,3,2,1
2278,3798,10003,73,7,2,5,1,1,0
2279,3798,8654,27,2,2,0,0,0,0
2280,3800,10252,76,4,3,1,3,1,2
2281,3800,8654,24,5,4,1,0,0,0
2282,3802,8650,37,8,2,6,1,1,0
2283,3802,9825,63,6,0,6,1,1,0
2284,3805,10194,30,1,1,0,3,1,2
2285,3805,8466,70,7,3,4,0,0,0
2286,3809,10260,37,2,1,1,2,1,1
2287,3809,9825,63,11,6,5,2,0,2
2288,3811,8466,61,9,3,6,2,1,1
2289,3811,8667,39,5,3,2,0,0,0
2290,3813,8455,55,6,1,5,2,2,0
2291,3813,8659,45,2,0,2,1,1,0
2292,3816,9879,25,5,2,3,1,1,0
2293,3816,8650,75,6,3,3,0,0,0
2294,3818,8586,42,6,2,4,1,1,0
2295,3818,10261,58,8,3,5,1,0,1
2296,3819,9825,56,6,4,2,2,1,1
2297,3819,8472,44,2,0,2,0,0,0
2298,3820,8344,51,13,9,4,3,1,2
2299,3820,8667,49,2,1,1,1,0,1
2300,3821,8455,48,14,8,6,2,1,1
2301,3821,8668,52,7,5,2,2,2,0
2302,3823,8650,58,10,3,7,2,0,2
2303,3823,10003,42,5,3,2,0,0,0
2304,3826,9850,35,7,3,4,1,0,1
2305,3826,8586,65,4,1,3,0,0,0
2306,3827,8659,69,11,2,9,4,2,2
2307,3827,9879,31,2,1,1,1,0,1
2308,3828,8654,30,2,2,0,2,2,0
2309,3828,8466,70,6,0,6,3,1,2
2310,3832,10261,55,7,2,5,1,1,0
2311,3832,8667,45,5,3,2,1,1,0
2312,3834,8466,56,7,2,5,3,1,2
2313,3834,8650,44,3,1,2,0,0,0
2314,3835,10194,38,6,3,3,2,1,1
2315,3835,9825,62,6,2,4,3,0,3
2316,3837,9826,46,4,1,3,2,0,2
2317,3837,10003,54,4,2,2,2,0,2
2318,3838,8586,59,8,4,4,1,1,0
2319,3838,8344,41,5,2,3,0,0,0
2320,3841,8586,39,3,2,1,3,2,1
2321,3841,8455,61,2,0,2,1,0,1
2322,3842,8466,62,6,5,1,2,0,2
2323,3842,9826,38,3,2,1,1,0,1
2324,3844,8456,79,9,4,5,1,1,0
2325,3844,10252,21,1,0,1,1,0,1
2326,3845,10261,60,11,7,4,2,1,1
2327,3845,8668,40,3,2,1,3,2,1
2328,3857,10003,55,7,2,5,3,1,2
2329,3857,8659,45,5,3,2,1,0,1
2330,3858,10194,49,5,5,0,2,1,1
2331,3858,8654,51,3,3,0,0,0,0
2332,3859,8659,41,7,2,5,1,1,0
2333,3859,10003,59,7,4,3,2,0,2
2334,3860,8455,61,7,4,3,3,0,3
2335,3860,10252,39,5,3,2,0,0,0
2336,3861,8668,71,12,6,6,1,1,0
2337,3861,8344,29,5,3,2,1,0,1
2338,3863,8667,60,7,2,5,4,1,3
2339,3863,8456,40,1,0,1,1,0,1
2340,3865,8466,63,4,2,2,2,1,1
2341,3865,9850,37,2,1,1,0,0,0
2342,3868,8586,54,8,3,5,1,1,0
2343,3868,9825,46,2,1,1,4,1,3
2344,3870,8344,37,3,2,1,2,1,1
2345,3870,8650,63,6,4,2,1,1,0
2346,3871,9825,49,8,4,4,1,1,0
2347,3871,8455,51,9,6,3,1,0,1
2348,3872,10003,60,11,5,6,2,1,1
2349,3872,8668,40,3,0,3,2,1,1
2350,3873,8667,40,3,2,1,2,0,2
2351,3873,8659,60,7,3,4,2,0,2
2352,3875,10261,74,10,7,3,3,1,2
2353,3875,9826,26,3,2,1,1,0,1
2354,3876,9850,45,7,4,3,0,0,0
2355,3876,8472,55,6,2,4,0,0,0
2356,3877,8586,55,4,3,1,2,1,1
2357,3877,8466,45,4,3,1,1,0,1
2358,3878,10260,59,5,4,1,1,0,1
2359,3878,8654,41,5,4,1,0,0,0
2360,3879,8456,47,8,2,6,1,1,0
2361,3879,9825,53,3,0,3,2,1,1
2362,3880,8455,67,11,4,7,2,1,1
2363,3880,9826,33,5,2,3,1,0,1
2364,3883,10260,51,4,1,3,2,1,1
2365,3883,10252,49,2,1,1,0,0,0
2366,3885,10194,55,8,2,6,1,0,1
2367,3885,8667,45,4,1,3,1,0,1
2368,3886,8472,58,10,2,8,2,1,1
2369,3886,8654,42,5,1,4,1,0,1
2370,3889,10252,48,4,1,3,4,1,3
2371,3889,9879,52,10,4,6,0,0,0
2372,3890,9826,36,7,3,4,1,1,0
2373,3890,8344,64,6,3,3,0,0,0
2374,3891,8455,43,8,7,1,1,1,0
2375,3891,10194,57,3,1,2,2,1,1
2376,3895,10261,37,6,3,3,1,0,1
2377,3895,10260,63,0,0,0,0,0,0
2378,3896,8659,28,5,4,1,1,1,0
2379,3896,9850,72,4,4,0,3,1,2
2380,3898,8654,27,2,2,0,2,0,2
2381,3898,8650,73,7,1,6,0,0,0
2382,3900,10252,56,5,2,3,2,2,0
2383,3900,9826,44,3,1,2,1,0,1
2384,3903,10260,48,9,1,8,2,1,1
2385,3903,8667,52,1,0,1,0,0,0
2386,3905,10261,59,7,4,3,2,0,2
2387,3905,10194,41,2,0,2,1,0,1
2388,3906,8668,48,9,5,4,1,1,0
2389,3906,8472,52,14,5,9,1,0,1
2390,3908,8659,31,2,2,0,2,2,0
2391,3908,8586,69,9,3,6,0,0,0
2392,3911,8455,64,23,12,11,2,1,1
2393,3911,8472,36,1,1,0,1,0,1
2394,3912,10260,58,7,2,5,1,1,0
2395,3912,8668,42,8,4,4,2,0,2
2396,3915,10003,56,4,3,1,1,1,0
2397,3915,10261,44,5,2,3,2,1,1
2398,3916,8650,49,4,2,2,1,0,1
2399,3916,9850,51,7,4,3,0,0,0
2400,3917,9879,32,4,2,2,2,2,0
2401,3917,8586,68,4,3,1,1,1,0
2402,3918,8654,65,7,4,3,1,1,0
2403,3918,9826,35,8,4,4,1,0,1
2404,3920,9826,49,2,1,1,1,0,1
2405,3920,8456,51,5,1,4,0,0,0
2406,3922,8455,24,7,4,3,3,2,1
2407,3922,8650,76,18,6,12,0,0,0
2408,3923,10260,58,12,7,5,1,1,0
2409,3923,9850,42,4,0,4,1,1,0
2410,3928,8654,56,6,5,1,1,1,0
2411,3928,8659,44,10,3,7,2,2,0
2412,3929,8659,45,2,2,0,1,0,1
2413,3929,9825,55,5,4,1,0,0,0
2414,3930,8667,57,5,2,3,1,0,1
2415,3930,10252,43,5,3,2,0,0,0
2416,3933,8456,36,7,4,3,1,0,1
2417,3933,8668,64,1,0,1,0,0,0
2418,3934,10260,65,4,2,2,1,1,0
2419,3934,8472,35,1,0,1,1,0,1
2420,3935,10261,48,10,5,5,4,2,2
2421,3935,8344,52,5,1,4,0,0,0
2422,3938,8654,51,9,3,6,2,1,1
2423,3938,8586,49,6,3,3,1,1,0
2424,3939,8455,64,12,5,7,2,0,2
2425,3939,8344,36,5,3,2,0,0,0
2426,3940,9879,62,6,4,2,1,1,0
2427,3940,9826,38,7,4,3,0,0,0
2428,3943,8456,59,14,6,8,1,1,0
2429,3943,8654,41,0,0,0,2,2,0
2430,3947,8586,51,8,8,0,3,2,1
2431,3947,10252,49,2,1,1,0,0,0
2432,3950,8668,40,4,2,2,1,1,0
2433,3950,8455,60,8,3,5,1,0,1
2434,3951,8659,55,5,3,2,1,1,0
2435,3951,9879,45,2,0,2,4,2,2
2436,3953,10260,61,10,2,8,1,1,0
2437,3953,9826,39,0,0,0,2,1,1
2438,3956,8472,29,6,2,4,1,1,0
2439,3956,9825,71,9,8,1,0,0,0
2440,3957,10003,75,9,6,3,1,1,0
2441,3957,8650,25,5,3,2,0,0,0
2442,3961,9879,33,2,1,1,2,0,2
2443,3961,8455,67,12,5,7,1,0,1
2444,3963,8650,57,8,5,3,2,0,2
2445,3963,8466,43,8,1,7,0,0,0
2446,3964,8456,29,3,2,1,4,3,1
2447,3964,10260,71,3,0,3,2,0,2
2448,3965,10261,61,5,4,1,5,2,3
2449,3965,8667,39,7,5,2,1,0,1
2450,3966,10252,35,3,2,1,1,0,1
2451,3966,9850,65,3,0,3,1,0,1
2452,3967,8472,46,4,3,1,2,1,1
2453,3967,8659,54,3,3,0,0,0,0
2454,3969,8456,66,9,3,6,1,1,0
2455,3969,10252,34,1,0,1,1,1,0
2456,3973,10260,57,10,7,3,2,2,0
2457,3973,8659,43,2,0,2,2,0,2
2458,3975,9850,35,4,3,1,3,2,1
2459,3975,10194,65,3,0,3,0,0,0
2460,3976,8650,59,7,1,6,1,1,0
2461,3976,8472,41,10,6,4,1,1,0
2462,3977,9825,46,3,1,2,2,1,1
2463,3977,10003,54,3,0,3,1,0,1
2464,3978,8586,59,3,2,1,1,1,0
2465,3978,8455,41,7,2,5,1,0,1
2466,3981,10252,51,8,4,4,1,1,0
2467,3981,8667,49,2,1,1,0,0,0
2468,3983,8456,51,6,2,4,2,1,1
2469,3983,8668,49,4,1,3,2,1,1
2470,3984,8455,58,12,3,9,3,0,3
2471,3984,9850,42,7,4,3,1,0,1
2472,3985,10003,68,9,6,3,1,0,1
2473,3985,8466,32,5,5,0,0,0,0
2474,3986,10260,61,5,3,2,2,2,0
2475,3986,8472,39,4,3,1,3,1,2
2476,3987,8586,64,7,1,6,1,1,0
2477,3987,8654,36,5,0,5,2,0,2
2478,3988,8659,47,4,2,2,2,1,1
2479,3988,9825,53,4,2,2,0,0,0
2480,3989,9825,55,8,4,4,2,2,0
2481,3989,9850,45,6,4,2,1,1,0
2482,3990,8586,55,7,3,4,2,1,1
2483,3990,10252,45,7,3,4,0,0,0
2484,3991,8455,55,9,4,5,3,2,1
2485,3991,8344,45,6,1,5,1,0,1
2486,3993,8667,35,2,2,0,1,0,1
2487,3993,8668,65,7,5,2,0,0,0
2488,3994,8466,58,9,4,5,2,1,1
2489,3994,10260,42,6,3,3,0,0,0
2490,3995,10261,28,4,4,0,3,1,2
2491,3995,8650,72,6,3,3,1,0,1
2492,3997,10003,62,8,4,4,3,2,1
2493,3997,8472,38,3,1,2,1,0,1
2494,3998,8456,59,11,5,6,1,1,0
2495,3998,8654,41,0,0,0,3,1,2
2496,4004,8344,41,7,4,3,1,1,0
2497,4004,9850,59,17,10,7,0,0,0
2498,4006,10261,52,7,2,5,1,1,0
2499,4006,8472,48,5,1,4,1,1,0
2500,4007,8586,69,7,5,2,1,1,0
2501,4007,8667,31,7,6,1,0,0,0
2502,4008,8654,31,7,4,3,2,1,1
2503,4008,10003,69,8,3,5,2,2,0
2504,4009,9825,80,7,4,3,3,2,1
2505,4009,9826,20,3,1,2,1,0,1
2506,4012,8650,53,4,2,2,2,2,0
2507,4012,8466,47,5,2,3,2,0,2
2508,4014,8456,54,7,4,3,1,1,0
2509,4014,10261,46,5,0,5,1,0,1
2510,4015,10172,53,11,5,6,4,1,3
2511,4015,8667,47,5,0,5,0,0,0
2512,4021,10172,31,5,1,4,1,1,0
2513,4021,8455,69,9,4,5,1,1,0
2514,4022,8472,41,5,4,1,2,2,0
2515,4022,9826,59,8,0,8,0,0,0
2516,4023,8668,64,7,5,2,2,2,0
2517,4023,10003,36,4,3,1,2,0,2
2518,4024,8667,48,3,2,1,3,0,3
2519,4024,8466,52,3,1,2,2,0,2
2520,4030,8650,61,7,3,4,2,1,1
2521,4030,8455,39,9,7,2,0,0,0
2522,4031,10260,71,9,5,4,1,1,0
2523,4031,9826,29,2,0,2,1,1,0
2524,4032,8456,53,13,5,8,3,1,2
2525,4032,10172,47,10,5,5,5,3,2
2526,4033,8466,66,8,4,4,1,1,0
2527,4033,8197,34,1,0,1,1,1,0
2528,4036,8586,62,6,4,2,3,2,1
2529,4036,10194,38,5,3,2,0,0,0
2530,4037,8659,59,4,4,0,3,2,1
2531,4037,10261,41,1,0,1,1,1,0
2532,4038,8654,54,14,7,7,2,1,1
2533,4038,10252,46,6,5,1,0,0,0
2534,4039,9825,69,13,6,7,1,0,1
2535,4039,10260,31,1,0,1,2,0,2
2536,4040,10252,37,4,3,1,1,0,1
2537,4040,8466,63,9,4,5,1,0,1
2538,4041,8455,78,12,9,3,1,1,0
2539,4041,8659,22,1,1,0,0,0,0
2540,4043,8668,49,5,4,1,1,0,1
2541,4043,8654,51,6,2,4,0,0,0
2542,4044,8586,84,12,6,6,1,1,0
2543,4044,8667,16,2,2,0,0,0,0
2544,4045,8197,38,6,2,4,2,1,1
2545,4045,8472,62,8,3,5,0,0,0
2546,4046,8456,57,11,4,7,1,0,1
2547,4046,10003,43,3,0,3,0,0,0
2548,4047,10261,61,10,5,5,2,1,1
2549,4047,10172,39,9,5,4,0,0,0
2550,4048,8191,24,2,1,1,1,1,0
2551,4048,10194,76,6,4,2,0,0,0
2552,4049,8191,45,7,4,3,2,1,1
2553,4049,10252,55,14,10,4,0,0,0
2554,4050,10194,53,10,2,8,2,0,2
2555,4050,8650,47,7,0,7,0,0,0
2556,4051,10260,78,5,3,2,5,4,1
2557,4051,8667,22,3,1,2,0,0,0
2558,4054,8472,33,9,4,5,2,2,0
2559,4054,8455,67,15,6,9,2,0,2
2560,4055,10003,64,5,2,3,3,0,3
2561,4055,9826,36,5,2,3,0,0,0
2562,4056,8668,65,6,3,3,5,1,4
2563,4056,8586,35,6,3,3,0,0,0
2564,4057,9825,58,10,6,4,1,1,0
2565,4057,8659,42,3,0,3,1,1,0
2566,4058,8654,46,5,2,3,1,1,0
2567,4058,10261,54,1,0,1,0,0,0
2568,4059,9825,62,10,3,7,3,1,2
2569,4059,8466,38,3,1,2,1,1,0
2570,4060,8191,37,4,2,2,2,0,2
2571,4060,10261,63,5,2,3,0,0,0
2572,4061,8650,53,4,3,1,2,2,0
2573,4061,8197,47,11,3,8,2,1,1
2574,4062,10260,67,1,1,0,1,0,1
2575,4062,10194,33,3,0,3,0,0,0
2576,4063,10003,64,11,7,4,3,2,1
2577,4063,10172,36,2,1,1,1,1,0
2578,4064,9826,54,11,9,2,2,2,0
2579,4064,10252,46,2,1,1,0,0,0
2580,4065,8659,69,12,4,8,3,2,1
2581,4065,8654,31,10,8,2,0,0,0
2582,4066,8586,69,4,2,2,2,1,1
2583,4066,8455,31,6,4,2,1,0,1
2584,4067,8667,47,3,2,1,2,2,0
2585,4067,8668,53,7,5,2,2,1,1
2586,4068,8472,39,7,3,4,1,0,1
2587,4068,8456,61,1,0,1,0,0,0
2588,4069,8197,40,4,2,2,1,1,0
2589,4069,10252,60,8,2,6,1,0,1
2590,4070,8659,43,3,1,2,1,0,1
2591,4070,8667,57,4,1,3,1,0,1
2592,4072,8456,47,16,8,8,1,1,0
2593,4072,8668,53,6,1,5,2,0,2
2594,4073,8455,74,11,5,6,1,0,1
2595,4073,10261,26,3,2,1,1,0,1
2596,4074,10172,43,9,6,3,2,2,0
2597,4074,8191,57,5,3,2,1,0,1
2598,4076,9825,61,7,3,4,3,2,1
2599,4076,10194,39,3,2,1,1,1,0
2600,4079,10261,55,8,4,4,3,1,2
2601,4079,9825,45,3,0,3,2,1,1
2602,4080,8191,36,4,2,2,2,2,0
2603,4080,8466,64,4,1,3,0,0,0
2604,4081,8667,39,1,1,0,1,1,0
2605,4081,8455,61,6,0,6,2,1,1
2606,4082,10194,57,4,2,2,2,2,0
2607,4082,9826,43,5,1,4,1,0,1
2608,4083,10172,57,6,2,4,1,0,1
2609,4083,8668,43,7,3,4,3,0,3
2610,4085,8650,47,11,5,6,2,1,1
2611,4085,10260,53,5,0,5,1,1,0
2612,4086,8654,42,12,6,6,5,3,2
2613,4086,8472,58,8,2,6,0,0,0
2614,4087,10003,54,7,2,5,2,1,1
2615,4087,8586,46,3,0,3,0,0,0
2616,4089,10260,66,11,4,7,1,1,0
2617,4089,10252,34,6,1,5,0,0,0
2618,4090,10003,43,4,1,3,1,1,0
2619,4090,8667,57,6,2,4,2,1,1
2620,4091,8650,62,12,3,9,2,1,1
2621,4091,9825,38,4,1,3,0,0,0
2622,4092,9826,21,1,1,0,1,0,1
2623,4092,8456,79,3,1,2,0,0,0
2624,4093,10261,54,9,3,6,1,1,0
2625,4093,8472,46,4,3,1,3,0,3
2626,4094,8659,63,6,4,2,2,1,1
2627,4094,10172,37,8,2,6,1,1,0
2628,4095,8668,55,7,1,6,3,0,3
2629,4095,8466,45,3,1,2,0,0,0
2630,4096,10194,53,6,2,4,2,1,1
2631,4096,8455,47,9,0,9,1,0,1
2632,4097,8586,63,10,3,7,1,1,0
2633,4097,8191,37,5,0,5,0,0,0
2634,4098,8654,44,4,4,0,3,1,2
2635,4098,8197,56,8,3,5,1,0,1
2636,4099,9825,47,5,3,2,2,1,1
2637,4099,10172,53,6,0,6,1,0,1
2638,4100,8191,42,4,2,2,1,1,0
2639,4100,8650,58,6,3,3,1,0,1
2640,4101,8455,59,11,6,5,1,0,1
2641,4101,8654,41,0,0,0,0,0,0
2642,4102,9826,39,7,5,2,2,1,1
2643,4102,8466,61,4,1,3,0,0,0
2644,4105,10261,44,4,3,1,2,1,1
2645,4105,10260,56,2,1,1,0,0,0
2646,4106,8667,52,5,2,3,1,0,1
2647,4106,8472,48,5,1,4,0,0,0
2648,4109,10252,34,6,2,4,2,1,1
2649,4109,8472,66,7,2,5,0,0,0
2650,4110,8667,64,11,4,7,3,1,2
2651,4110,8197,36,1,1,0,2,1,1
2652,4114,10172,57,8,4,4,3,1,2
2653,4114,9826,43,4,1,3,0,0,0
2654,4115,8455,62,5,1,4,1,0,1
2655,4115,8466,38,1,1,0,0,0,0
2656,4117,8586,48,7,3,4,1,1,0
2657,4117,10260,52,7,6,1,1,1,0
2658,4118,9825,43,14,4,10,3,3,0
2659,4118,8654,57,7,4,3,1,0,1
2660,4119,10252,37,4,3,1,3,1,2
2661,4119,10261,63,4,2,2,0,0,0
2662,4121,9826,51,7,3,4,3,3,0
2663,4121,8654,49,7,6,1,0,0,0
2664,4122,9825,64,4,2,2,4,4,0
2665,4122,8668,36,2,1,1,0,0,0
2666,4123,8667,41,5,4,1,1,0,1
2667,4123,10194,59,4,0,4,0,0,0
2668,4124,8650,53,6,3,3,2,2,0
2669,4124,8456,47,1,1,0,0,0,0
2670,4125,8466,57,3,2,1,2,2,0
2671,4125,8659,43,3,0,3,1,0,1
2672,4126,8472,44,4,2,2,5,2,3
2673,4126,10260,56,4,0,4,5,2,3
2674,4129,10252,67,7,5,2,3,1,2
2675,4129,9826,33,2,0,2,3,1,2
2676,4130,8668,53,5,2,3,1,1,0
2677,4130,8667,47,9,5,4,0,0,0
2678,4131,8197,45,5,1,4,3,2,1
2679,4131,8650,55,7,1,6,0,0,0
2680,4132,8456,61,18,8,10,3,1,2
2681,4132,8472,39,2,1,1,0,0,0
2682,4135,9825,59,7,5,2,1,1,0
2683,4135,8466,41,5,3,2,3,1,2
2684,4136,10194,35,4,1,3,1,0,1
2685,4136,10260,65,2,0,2,0,0,0
2686,4137,8586,44,4,2,2,3,2,1
2687,4137,8455,56,7,2,5,2,2,0
2688,4138,8659,51,4,2,2,3,1,2
2689,4138,8654,49,3,2,1,1,0,1
2690,4139,9825,53,4,3,1,3,2,1
2691,4139,10194,47,2,1,1,0,0,0
2692,4140,8191,43,5,1,4,2,1,1
2693,4140,10172,57,8,2,6,1,0,1
2694,4141,10261,38,6,4,2,1,1,0
2695,4141,8455,62,4,1,3,1,0,1
2696,4142,8586,54,4,1,3,1,1,0
2697,4142,9826,46,12,2,10,2,2,0
2698,4143,8668,37,7,4,3,4,3,1
2699,4143,8456,63,7,4,3,4,1,3
2700,4144,10252,65,5,1,4,1,0,1
2701,4144,8197,35,5,0,5,0,0,0
2702,4145,10260,64,1,1,0,4,3,1
2703,4145,8466,36,1,0,1,1,0,1
2704,4146,8650,54,7,2,5,2,1,1
2705,4146,8472,46,2,0,2,1,1,0
2706,4147,10003,61,11,6,5,2,1,1
2707,4147,8654,39,7,1,6,1,0,1
2708,4148,8667,42,5,3,2,1,1,0
2709,4148,8659,58,3,2,1,0,0,0
2710,4149,10252,53,5,2,3,3,2,1
2711,4149,8650,47,7,2,5,1,1,0
2712,4151,8668,64,9,5,4,3,1,2
2713,4151,8659,36,2,1,1,1,0,1
2714,4153,9825,33,2,1,1,1,1,0
2715,4153,8456,67,6,0,6,0,0,0
2716,4155,10260,62,9,4,5,2,1,1
2717,4155,10172,38,7,4,3,0,0,0
2718,4156,10003,45,3,2,1,2,1,1
2719,4156,8455,55,7,3,4,4,2,2
2720,4157,8472,31,4,1,3,1,0,1
2721,4157,8586,69,14,5,9,0,0,0
2722,4158,8667,42,5,2,3,4,0,4
2723,4158,8654,58,6,3,3,1,0,1
2724,4159,10252,52,4,2,2,1,1,0
2725,4159,9825,48,3,1,2,1,0,1
2726,4160,8456,61,4,2,2,1,1,0
2727,4160,8455,39,1,1,0,0,0,0
2728,4161,9826,57,7,5,2,1,1,0
2729,4161,8668,43,5,1,4,0,0,0
2730,4162,8667,55,9,3,6,2,1,1
2731,4162,10261,45,3,2,1,0,0,0
2732,4163,8650,65,10,6,4,1,1,0
2733,4163,8654,35,4,3,1,0,0,0
2734,4164,10260,68,7,3,4,1,1,0
2735,4164,8197,32,0,0,0,1,1,0
2736,4165,8466,59,10,2,8,3,1,2
2737,4165,10003,41,2,0,2,1,0,1
2738,4166,10194,47,2,1,1,2,0,2
2739,4166,10172,53,5,1,4,1,0,1
2740,4167,8472,48,4,2,2,3,2,1
2741,4167,8191,52,4,1,3,0,0,0
2742,4168,8586,59,6,4,2,2,1,1
2743,4168,8659,41,7,4,3,3,1,2
2744,4169,8455,52,5,3,2,2,1,1
2745,4169,10252,48,1,0,1,0,0,0
2746,4170,8191,55,7,2,5,2,1,1
2747,4170,8659,45,4,2,2,2,1,1
2748,4172,9826,34,6,2,4,1,1,0
2749,4172,8197,66,12,6,6,1,1,0
2750,4173,8667,23,3,2,1,3,3,0
2751,4173,8456,77,10,4,6,1,0,1
2752,4174,10261,46,3,3,0,3,2,1
2753,4174,10194,54,4,1,3,0,0,0
2754,4177,8586,49,10,4,6,3,1,2
2755,4177,9825,51,4,0,4,1,0,1
2756,4178,8654,32,8,4,4,1,0,1
2757,4178,10260,68,10,3,7,1,0,1
2758,4179,8197,37,5,1,4,2,1,1
2759,4179,9825,63,10,8,2,1,1,0
2760,4181,10260,57,4,1,3,1,1,0
2761,4181,8191,43,3,2,1,0,0,0
2762,4182,8466,72,11,2,9,1,1,0
2763,4182,8654,28,4,3,1,0,0,0
2764,4184,8650,52,8,6,2,1,1,0
2765,4184,8586,48,8,4,4,1,1,0
2766,4188,10172,41,7,4,3,2,1,1
2767,4188,8472,59,8,1,7,1,0,1
2768,4189,10194,48,6,4,2,1,0,1
2769,4189,10252,52,2,1,1,0,0,0
2770,4191,9826,60,9,2,7,2,2,0
2771,4191,9825,40,7,3,4,0,0,0
2772,4192,8197,40,7,5,2,6,2,4
2773,4192,8668,60,5,2,3,1,1,0
2774,4193,8667,65,4,2,2,1,1,0
2775,4193,10172,35,3,2,1,4,1,3
2776,4194,10261,43,2,1,1,2,1,1
2777,4194,8456,57,4,1,3,0,0,0
2778,4195,8466,62,13,7,6,1,1,0
2779,4195,8650,38,2,0,2,2,0,2
2780,4196,8659,39,2,2,0,6,5,1
2781,4196,8472,61,6,2,4,1,1,0
2782,4197,10003,31,5,2,3,4,2,2
2783,4197,10260,69,7,2,5,2,1,1
2784,4199,8668,49,5,1,4,2,0,2
2785,4199,9825,51,7,4,3,0,0,0
2786,4200,8191,48,7,4,3,3,1,2
2787,4200,10003,52,3,1,2,0,0,0
2788,4201,8455,64,5,4,1,4,4,0
2789,4201,8197,36,2,2,0,1,0,1
2790,4202,8650,53,3,3,0,1,1,0
2791,4202,8456,47,0,0,0,0,0,0
2792,4203,8472,27,2,2,0,1,1,0
2793,4203,10260,73,11,4,7,3,1,2
2794,4205,10172,41,11,7,4,2,2,0
2795,4205,8586,59,6,3,3,0,0,0
2796,4207,8659,35,3,3,0,2,1,1
2797,4207,8466,65,3,1,2,0,0,0
2798,4208,9826,31,4,4,0,6,5,1
2799,4208,8654,69,5,0,5,1,0,1
2800,4209,10252,60,7,3,4,2,1,1
2801,4209,8659,40,1,1,0,2,0,2
2802,4210,8667,38,7,3,4,1,0,1
2803,4210,8472,62,3,0,3,0,0,0
2804,4212,8466,58,7,3,4,3,2,1
2805,4212,9826,42,7,2,5,2,0,2
2806,4214,8650,65,11,6,5,1,1,0
2807,4214,8191,35,4,2,2,0,0,0
2808,4215,8456,67,13,8,5,4,3,1
2809,4215,8197,33,4,2,2,0,0,0
2810,4216,10260,70,5,2,3,4,2,2
2811,4216,10261,30,2,0,2,0,0,0
2812,4217,10194,44,4,2,2,3,1,2
2813,4217,8668,56,7,3,4,1,1,0
2814,4218,8586,62,10,8,2,2,2,0
2815,4218,10003,38,4,0,4,1,1,0
2816,4219,9825,62,8,6,2,2,1,1
2817,4219,8654,38,2,1,1,3,1,2
2818,4220,8456,70,12,4,8,1,0,1
2819,4220,8191,30,2,1,1,1,0,1
2820,4221,8455,64,9,1,8,1,0,1
2821,4221,8466,36,6,4,2,1,0,1
2822,4222,10172,65,4,0,4,3,1,2
2823,4222,9826,35,2,0,2,0,0,0
2824,4223,10261,45,8,5,3,2,0,2
2825,4223,8668,55,9,4,5,0,0,0
2826,4225,10260,45,2,1,1,5,3,2
2827,4225,8586,55,2,0,2,1,1,0
2828,4226,10252,63,5,3,2,1,0,1
2829,4226,8472,37,4,0,4,1,0,1
2830,4227,8650,68,6,2,4,2,2,0
2831,4227,10003,32,8,5,3,2,1,1
2832,4228,8659,37,9,3,6,2,0,2
2833,4228,10194,63,4,1,3,1,0,1
2834,4229,10252,34,2,1,1,1,1,0
2835,4229,8667,66,2,0,2,0,0,0
2836,4230,8191,32,4,3,1,4,2,2
2837,4230,10260,68,4,1,3,0,0,0
2838,4231,8668,64,10,4,6,2,1,1
2839,4231,8455,36,5,2,3,0,0,0
2840,4234,9826,35,5,1,4,2,0,2
2841,4234,10261,65,4,2,2,0,0,0
2842,4235,10172,32,5,3,2,2,1,1
2843,4235,8472,68,8,2,6,2,1,1
2844,4236,10003,46,6,2,4,1,1,0
2845,4236,8659,54,7,1,6,0,0,0
2846,4237,8650,33,6,2,4,1,1,0
2847,4237,8586,67,3,1,2,1,0,1
2848,4238,8654,39,2,2,0,2,1,1
2849,4238,8466,61,9,2,7,1,0,1
2850,4239,10003,57,8,4,4,3,1,2
2851,4239,10252,43,7,3,4,0,0,0
2852,4240,8667,34,9,6,3,5,3,2
2853,4240,8455,66,4,0,4,2,1,1
2854,4241,10260,55,3,2,1,3,0,3
2855,4241,8650,45,2,1,1,2,0,2
2856,4242,8456,78,20,12,8,1,1,0
2857,4242,8659,22,0,0,0,2,1,1
2858,4244,8668,41,3,3,0,2,1,1
2859,4244,10172,59,4,2,2,2,0,2
2860,4245,8191,42,4,4,0,2,1,1
2861,4245,8466,58,8,3,5,0,0,0
2862,4246,9826,39,3,1,2,1,1,0
2863,4246,10194,61,6,1,5,0,0,0
2864,4247,8197,39,3,2,1,2,2,0
2865,4247,8586,61,2,1,1,2,0,2
2866,4248,8472,47,4,2,2,2,1,1
2867,4248,8654,53,8,2,6,1,0,1
2868,4249,9825,36,6,2,4,2,1,1
2869,4249,8650,64,4,1,3,2,0,2
2870,4250,8191,40,9,4,5,4,3,1
2871,4250,8586,60,5,3,2,2,0,2
2872,4251,8455,61,11,5,6,1,1,0
2873,4251,10194,39,2,0,2,0,0,0
2874,4252,8456,75,10,5,5,3,1,2
2875,4252,9826,25,1,1,0,2,0,2
2876,4253,8466,56,5,3,2,1,0,1
2877,4253,8668,44,5,5,0,2,0,2
2878,4254,8654,44,8,5,3,1,1,0
2879,4254,8197,56,6,2,4,5,3,2
2880,4255,10260,82,8,7,1,1,0,1
2881,4255,10252,18,2,2,0,0,0,0
2882,4256,8472,43,10,6,4,2,1,1
2883,4256,10261,57,4,1,3,0,0,0
2884,4260,8650,63,9,5,4,3,1,2
2885,4260,10261,37,4,2,2,0,0,0
2886,4261,8456,42,4,3,1,2,1,1
2887,4261,10260,58,6,1,5,2,1,1
2888,4262,10172,38,10,3,7,5,2,3
2889,4262,8455,62,3,2,1,3,1,2
2890,4264,9826,46,8,5,3,3,0,3
2891,4264,8472,54,3,1,2,1,0,1
2892,4265,10003,51,3,2,1,2,2,0
2893,4265,8668,49,8,4,4,0,0,0
2894,4266,10252,42,3,1,2,3,0,3
2895,4266,8586,58,5,3,2,0,0,0
2896,4271,8455,25,4,2,2,3,2,1
2897,4271,10260,75,5,0,5,1,0,1
2898,4272,9826,69,6,3,3,2,1,1
2899,4272,8659,31,2,0,2,3,0,3
2900,4274,8650,71,12,5,7,1,1,0
2901,4274,8667,29,5,4,1,0,0,0
2902,4276,8456,67,11,4,7,2,0,2
2903,4276,8654,33,7,4,3,0,0,0
2904,4277,10261,39,7,3,4,1,0,1
2905,4277,8586,61,7,2,5,0,0,0
2906,4279,8455,49,4,3,1,1,1,0
2907,4279,9825,51,4,2,2,1,1,0
2908,4281,9826,48,4,3,1,1,0,1
2909,4281,8667,52,7,4,3,0,0,0
2910,4282,10260,67,12,6,6,1,0,1
2911,4282,8668,33,5,3,2,0,0,0
2912,4284,10003,52,3,2,1,4,3,1
2913,4284,10261,48,1,0,1,0,0,0
2914,4285,10172,54,9,2,7,2,2,0
2915,4285,8654,46,3,2,1,3,2,1
2916,4286,8466,32,4,2,2,3,3,0
2917,4286,8586,68,3,1,2,2,2,0
2918,4287,10194,52,14,7,7,1,1,0
2919,4287,8472,48,6,0,6,2,0,2
2920,4288,8650,83,13,3,10,3,2,1
2921,4288,8659,17,4,0,4,1,1,0
2922,4291,9825,69,13,5,8,2,1,1
2923,4291,8667,31,2,1,1,3,1,2
2924,4292,8197,52,7,2,5,3,2,1
2925,4292,10261,48,5,2,3,3,0,3
2926,4293,8650,60,10,4,6,1,1,0
2927,4293,10172,40,3,1,2,5,3,2
2928,4294,8659,18,3,2,1,1,1,0
2929,4294,10260,82,15,5,10,1,1,0
2930,4295,8472,43,6,5,1,1,1,0
2931,4295,8466,57,3,1,2,1,1,0
2932,4298,8191,41,4,2,2,2,1,1
2933,4298,8654,59,14,3,11,0,0,0
2934,4300,10252,54,6,5,1,4,2,2
2935,4300,8654,46,3,1,2,0,0,0
2936,4301,8650,60,5,3,2,1,0,1
2937,4301,8455,40,4,3,1,0,0,0
2938,4302,10260,59,7,4,3,2,2,0
2939,4302,9826,41,5,1,4,0,0,0
2940,4304,8667,64,13,2,11,3,2,1
2941,4304,8191,36,2,1,1,0,0,0
2942,4305,8466,69,5,3,2,1,1,0
2943,4305,8197,31,3,2,1,1,1,0
2944,4306,8456,55,9,3,6,2,2,0
2945,4306,10172,45,4,1,3,0,0,0
2946,4309,8191,49,6,5,1,2,1,1
2947,4309,10194,51,5,2,3,1,1,0
2948,4310,8650,68,8,4,4,1,1,0
2949,4310,9826,32,5,1,4,0,0,0
2950,4311,10260,54,7,4,3,2,1,1
2951,4311,9825,46,4,0,4,1,0,1
2952,4312,10172,46,3,1,2,2,1,1
2953,4312,10261,54,17,7,10,3,2,1
2954,4313,8466,32,9,7,2,1,1,0
2955,4313,10252,68,4,1,3,1,0,1
2956,4315,10003,41,7,2,5,1,1,0
2957,4315,8456,59,11,3,8,0,0,0
2958,4316,8667,55,4,1,3,2,2,0
2959,4316,8586,45,2,0,2,1,0,1
2960,4317,8659,41,3,2,1,3,1,2
2961,4317,8455,59,7,4,3,2,1,1
2962,4319,9825,61,11,9,2,1,1,0
2963,4319,8659,39,7,1,6,1,0,1
2964,4320,8191,36,4,3,1,2,2,0
2965,4320,10252,64,7,4,3,0,0,0
2966,4321,8455,65,12,6,6,2,1,1
2967,4321,8472,35,9,3,6,1,0,1
2968,4324,8667,46,8,2,6,3,2,1
2969,4324,10260,54,4,2,2,0,0,0
2970,4326,8466,49,8,3,5,2,0,2
2971,4326,8456,51,7,5,2,1,0,1
2972,4328,10194,46,5,4,1,4,1,3
2973,4328,8650,54,8,1,7,1,1,0
2974,4329,9825,44,4,2,2,1,0,1
2975,4329,8456,56,8,3,5,0,0,0
2976,4331,9826,47,3,2,1,5,3,2
2977,4331,8191,53,7,3,4,1,0,1
2978,4332,8654,64,11,6,5,5,1,4
2979,4332,8667,36,6,2,4,0,0,0
2980,4333,10252,28,2,2,0,2,2,0
2981,4333,8650,72,6,1,5,0,0,0
2982,4334,10260,71,8,2,6,3,2,1
2983,4334,10172,29,4,1,3,0,0,0
2984,4335,8466,48,3,1,2,2,1,1
2985,4335,10261,52,4,2,2,0,0,0
2986,4337,8586,55,10,8,2,1,0,1
2987,4337,8472,45,3,1,2,0,0,0
2988,4339,10252,21,4,3,1,2,1,1
2989,4339,9825,79,4,3,1,1,1,0
2990,4340,8191,45,5,3,2,1,1,0
2991,4340,8472,55,7,4,3,0,0,0
2992,4341,9826,23,4,3,1,1,1,0
2993,4341,8668,77,6,2,4,1,1,0
2994,4343,8456,60,6,2,4,3,1,2
2995,4343,8455,40,3,1,2,0,0,0
2996,4349,9825,72,15,8,7,1,1,0
2997,4349,8586,28,6,5,1,1,1,0
2998,4350,8455,64,8,4,4,1,0,1
2999,4350,10252,36,2,1,1,0,0,0
3000,4351,8197,58,4,1,3,2,0,2
3001,4351,9826,42,7,5,2,1,0,1
3002,4352,8456,55,7,3,4,1,0,1
3003,4352,8667,45,4,1,3,0,0,0
3004,4353,8650,45,14,11,3,2,1,1
3005,4353,8668,55,6,3,3,0,0,0
3006,4354,10260,53,3,2,1,1,1,0
3007,4354,8654,47,1,0,1,3,0,3
3008,4355,8466,57,7,3,4,3,1,2
3009,4355,10172,43,0,0,0,3,2,1
3010,4356,10261,52,4,3,1,3,2,1
3011,4356,10194,48,6,1,5,3,2,1
3012,4357,8472,60,5,4,1,1,1,0
3013,4357,10003,40,1,0,1,3,1,2
3014,4358,8191,43,7,3,4,3,2,1
3015,4358,8659,57,10,7,3,3,1,2
3016,4360,8455,42,3,2,1,2,0,2
3017,4360,9825,58,3,0,3,2,0,2
3018,4361,8667,59,7,3,4,1,0,1
3019,4361,9826,41,5,1,4,0,0,0
3020,4366,10003,70,4,2,2,2,2,0
3021,4366,10261,30,3,0,3,1,0,1
3022,4367,8586,41,5,4,1,3,1,2
3023,4367,8466,59,5,3,2,0,0,0
3024,4368,8654,46,5,2,3,4,0,4
3025,4368,10172,54,5,1,4,2,0,2
3026,4371,9826,33,3,2,1,1,0,1
3027,4371,8455,67,5,3,2,0,0,0
3028,4372,8668,55,10,6,4,3,2,1
3029,4372,10252,45,6,2,4,0,0,0
3030,4373,8586,39,12,6,6,1,1,0
3031,4373,8456,61,11,4,7,0,0,0
3032,4375,10172,41,9,4,5,3,3,0
3033,4375,8650,59,6,1,5,0,0,0
3034,4377,10003,54,7,3,4,3,1,2
3035,4377,10194,46,6,5,1,0,0,0
3036,4378,8659,33,2,1,1,1,0,1
3037,4378,10260,67,11,4,7,0,0,0
3038,4382,10252,71,10,7,3,2,0,2
3039,4382,10172,29,3,1,2,1,0,1
3040,4383,8466,57,5,5,0,2,1,1
3041,4383,10194,43,2,2,0,2,1,1
3042,4387,9826,31,7,5,2,2,0,2
3043,4387,8659,69,7,2,5,0,0,0
3044,4388,8456,71,9,4,5,3,2,1
3045,4388,8654,29,4,2,2,0,0,0
3046,4392,9817,32,6,3,3,1,1,0
3047,4392,8668,68,4,3,1,0,0,0
3048,4393,8472,55,5,3,2,2,0,2
3049,4393,8197,45,8,5,3,0,0,0
3050,4394,8586,49,6,3,3,3,2,1
3051,4394,10260,51,6,5,1,0,0,0
3052,4396,9826,37,6,4,2,1,0,1
3053,4396,9850,63,7,2,5,1,0,1
3054,4400,10252,48,4,2,2,3,1,2
3055,4400,10003,52,3,0,3,0,0,0
3056,4401,8586,54,7,2,5,2,1,1
3057,4401,8678,46,4,2,2,0,0,0
3058,4402,8197,45,5,4,1,2,2,0
3059,4402,9826,55,5,2,3,0,0,0
3060,4404,8456,38,3,1,2,1,0,1
3061,4404,10260,62,1,0,1,1,0,1
3062,4406,9817,36,7,3,4,2,0,2
3063,4406,10194,64,2,2,0,2,0,2
3064,4407,10261,55,13,8,5,3,1,2
3065,4407,8472,45,4,2,2,1,0,1
3066,4408,8455,47,5,3,2,2,2,0
3067,4408,8654,53,6,3,3,0,0,0
3068,4410,9826,51,9,6,3,1,1,0
3069,4410,10260,49,3,1,2,1,0,1
3070,4411,8668,63,4,4,0,1,1,0
3071,4411,8472,37,11,4,7,2,0,2
3072,4412,8456,74,8,5,3,6,2,4
3073,4412,9850,26,4,2,2,0,0,0
3074,4413,10261,54,10,2,8,3,1,2
3075,4413,10194,46,2,0,2,1,0,1
3076,4414,8466,30,3,3,0,5,3,2
3077,4414,8678,70,6,1,5,1,0,1
3078,4415,9825,46,3,2,1,1,1,0
3079,4415,10003,54,7,3,4,0,0,0
3080,4416,10252,43,6,2,4,2,0,2
3081,4416,8586,57,8,1,7,1,0,1
3082,4418,8197,51,5,5,0,2,0,2
3083,4418,8659,49,7,1,6,2,0,2
3084,4421,8678,71,12,8,4,1,1,0
3085,4421,10261,29,0,0,0,2,1,1
3086,4424,10260,64,5,3,2,1,0,1
3087,4424,8659,36,1,1,0,0,0,0
3088,4425,9850,37,4,1,3,4,2,2
3089,4425,10003,63,1,1,0,0,0,0
3090,4428,8668,45,7,6,1,3,2,1
3091,4428,8654,55,6,1,5,2,1,1
3092,4429,9850,28,3,2,1,1,1,0
3093,4429,8455,72,11,6,5,1,1,0
3094,4430,9826,70,10,3,7,1,1,0
3095,4430,8472,30,5,1,4,2,0,2
3096,4431,8668,53,9,3,6,3,3,0
3097,4431,10252,47,8,1,7,2,0,2
3098,4432,8456,56,5,1,4,1,1,0
3099,4432,8650,44,9,2,7,0,0,0
3100,4435,10003,45,7,4,3,3,2,1
3101,4435,8678,55,6,3,3,1,0,1
3102,4437,10260,52,6,1,5,2,2,0
3103,4437,9817,48,7,0,7,1,0,1
3104,4438,9825,81,6,1,5,2,1,1
3105,4438,8659,19,1,1,0,2,0,2
3106,4439,10252,64,6,6,0,1,1,0
3107,4439,9817,36,9,5,4,0,0,0
3108,4440,8678,68,12,3,9,3,2,1
3109,4440,8668,32,5,2,3,0,0,0
3110,4441,10261,48,3,2,1,1,0,1
3111,4441,9826,52,7,2,5,0,0,0
3112,4442,10260,68,6,4,2,1,0,1
3113,4442,8197,32,3,1,2,0,0,0
3114,4445,9825,60,3,1,2,1,0,1
3115,4445,9850,40,2,1,1,2,0,2
3116,4447,8586,53,7,5,2,5,0,5
3117,4447,8455,47,1,0,1,0,0,0
3118,4448,8654,62,8,3,5,2,1,1
3119,4448,8659,38,5,0,5,2,0,2
3120,4449,8472,24,5,1,4,1,0,1
3121,4449,9825,76,8,1,7,1,0,1
3122,4450,8455,66,11,6,5,1,0,1
3123,4450,8678,34,7,5,2,0,0,0
3124,4452,8654,35,5,2,3,1,1,0
3125,4452,10260,65,7,3,4,0,0,0
3126,4455,8456,47,4,2,2,1,1,0
3127,4455,10194,53,2,0,2,2,0,2
3128,4457,9817,45,8,2,6,1,0,1
3129,4457,9850,55,2,0,2,1,0,1
3130,4458,8659,31,6,2,4,1,1,0
3131,4458,8586,69,6,1,5,1,1,0
3132,4459,10252,51,7,2,5,1,1,0
3133,4459,9825,49,4,2,2,1,0,1
3134,4460,8678,46,4,3,1,3,2,1
3135,4460,10260,54,6,3,3,3,3,0
3136,4461,8466,60,7,4,3,4,2,2
3137,4461,9826,40,10,3,7,3,0,3
3138,4462,8197,29,4,3,1,2,2,0
3139,4462,8455,71,8,1,7,0,0,0
3140,4463,8650,74,15,6,9,2,1,1
3141,4463,8659,26,2,2,0,0,0,0
3142,4465,8668,61,4,1,3,3,1,2
3143,4465,9850,39,1,0,1,2,1,1
3144,4466,9817,48,8,4,4,1,1,0
3145,4466,8472,52,2,0,2,0,0,0
3146,4468,8654,48,21,8,13,1,1,0
3147,4468,10194,52,4,0,4,1,0,1
3148,4469,8456,66,10,3,7,1,1,0
3149,4469,9825,34,3,0,3,1,0,1
3150,4471,8668,68,8,3,5,2,2,0
3151,4471,8197,32,1,0,1,1,0,1
3152,4473,10261,43,4,2,2,3,2,1
3153,4473,10252,57,6,2,4,0,0,0
3154,4474,8466,54,10,4,6,3,2,1
3155,4474,8586,46,6,2,4,2,0,2
3156,4475,10194,65,11,2,9,2,1,1
3157,4475,9826,35,4,0,4,2,1,1
3158,4477,8650,68,8,2,6,1,1,0
3159,4477,9817,32,3,2,1,0,0,0
3160,4478,8678,65,7,3,4,2,2,0
3161,4478,8659,35,3,0,3,0,0,0
3162,4480,9826,44,4,1,3,1,1,0
3163,4480,8678,56,8,3,5,0,0,0
3164,4481,8455,58,8,3,5,1,1,0
3165,4481,9817,42,8,3,5,1,0,1
3166,4482,8650,57,13,12,1,3,3,0
3167,4482,8197,43,3,1,2,4,0,4
3168,4483,8472,22,4,2,2,1,0,1
3169,4483,8456,78,8,4,4,0,0,0
3170,4485,8466,32,5,1,4,3,2,1
3171,4485,9825,68,5,3,2,0,0,0
3172,4486,10260,63,8,4,4,2,1,1
3173,4486,10194,37,4,3,1,1,0,1
3174,4488,9850,33,4,3,1,4,2,2
3175,4488,8586,67,9,4,5,0,0,0
3176,4492,8456,59,12,6,6,4,2,2
3177,4492,8197,41,5,2,3,0,0,0
3178,4493,8455,34,3,1,2,4,3,1
3179,4493,10260,66,6,3,3,0,0,0
3180,4494,10252,57,4,2,2,1,1,0
3181,4494,9850,43,3,1,2,0,0,0
3182,4495,8650,52,8,5,3,1,0,1
3183,4495,8472,48,3,1,2,1,0,1
3184,4496,9817,30,5,2,3,1,0,1
3185,4496,8586,70,3,0,3,0,0,0
3186,4499,10260,52,3,1,2,4,2,2
3187,4499,10252,48,2,0,2,2,0,2
3188,4501,8650,51,4,2,2,2,1,1
3189,4501,8678,49,5,0,5,2,0,2
3190,4507,9817,68,10,4,6,2,1,1
3191,4507,8659,32,1,1,0,2,2,0
3192,4510,9826,39,5,2,3,2,1,1
3193,4510,8455,61,5,2,3,1,0,1
3194,4511,8586,54,11,7,4,1,0,1
3195,4511,8668,46,8,1,7,0,0,0
3196,4512,8678,37,4,1,3,4,2,2
3197,4512,8197,63,6,1,5,2,2,0
3198,4513,10260,56,10,6,4,1,1,0
3199,4513,10003,44,5,2,3,2,1,1
3200,4514,8466,60,5,5,0,3,2,1
3201,4514,9850,40,3,0,3,1,0,1
3202,4518,8654,31,6,1,5,2,0,2
3203,4518,8650,69,12,6,6,0,0,0
3204,4520,8654,56,3,2,1,1,1,0
3205,4520,8678,44,7,3,4,0,0,0
3206,4521,10003,43,6,2,4,3,0,3
3207,4521,8472,57,2,1,1,0,0,0
3208,4522,8650,65,11,4,7,1,1,0
3209,4522,9825,35,4,2,2,1,1,0
3210,4523,8659,39,5,2,3,3,2,1
3211,4523,8455,61,6,3,3,4,2,2
3212,4524,8668,41,4,2,2,1,1,0
3213,4524,8456,59,12,2,10,1,0,1
3214,4525,10260,46,3,1,2,1,0,1
3215,4525,10261,54,6,1,5,1,0,1
3216,4527,10194,73,5,3,2,2,1,1
3217,4527,9850,27,1,1,0,2,0,2
3218,4528,8586,58,12,6,6,1,1,0
3219,4528,8197,42,5,1,4,0,0,0
3220,4529,8197,42,6,4,2,3,1,2
3221,4529,10252,58,8,3,5,0,0,0
3222,4530,8678,39,6,1,5,3,1,2
3223,4530,9850,61,7,3,4,0,0,0
3224,4531,8668,43,5,3,2,4,1,3
3225,4531,8455,57,10,2,8,0,0,0
3226,4532,8650,56,10,2,8,1,1,0
3227,4532,10260,44,1,1,0,2,0,2
3228,4535,8466,52,5,4,1,5,3,2
3229,4535,8659,48,2,1,1,2,1,1
3230,4536,10194,44,8,2,6,4,2,2
3231,4536,9825,56,6,2,4,1,1,0
3232,4537,9817,53,5,3,2,4,2,2
3233,4537,10003,47,3,2,1,0,0,0
3234,4541,8668,70,8,3,5,3,2,1
3235,4541,10003,30,3,0,3,2,0,2
3236,4542,8197,43,4,3,1,4,2,2
3237,4542,10194,57,4,2,2,0,0,0
3238,4543,10260,56,3,2,1,3,2,1
3239,4543,8466,44,1,0,1,3,2,1
3240,4546,10261,53,2,2,0,2,1,1
3241,4546,9817,47,4,3,1,0,0,0
3242,4547,8659,41,1,1,0,1,0,1
3243,4547,10252,59,8,4,4,0,0,0
3244,4548,8456,54,12,1,11,2,2,0
3245,4548,8654,46,2,1,1,2,0,2
3246,4550,8197,83,7,6,1,2,1,1
3247,4550,8650,17,9,5,4,1,1,0
3248,4551,8586,57,6,6,0,1,1,0
3249,4551,9850,43,3,1,2,1,1,0
3250,4552,8472,57,6,2,4,4,2,2
3251,4552,8456,43,2,1,1,2,1,1
3252,4554,10252,29,2,1,1,1,0,1
3253,4554,8654,71,3,1,2,1,0,1
3254,4556,10260,40,6,6,0,3,2,1
3255,4556,10194,60,3,1,2,1,0,1
3256,4557,8659,44,7,2,5,2,1,1
3257,4557,10003,56,8,3,5,3,1,2
3258,4558,8668,46,6,2,4,3,2,1
3259,4558,10261,54,4,0,4,0,0,0
3260,4559,9850,61,8,2,6,2,2,0
3261,4559,10252,39,1,0,1,1,0,1
3262,4560,9825,41,6,3,3,1,1,0
3263,4560,8678,59,11,5,6,2,0,2
3264,4561,10260,43,12,7,5,4,2,2
3265,4561,8455,57,10,3,7,1,0,1
3266,4562,8650,66,6,3,3,2,1,1
3267,4562,8472,34,1,0,1,0,0,0
3268,4563,8197,42,5,3,2,2,1,1
3269,4563,8456,58,8,3,5,2,1,1
3270,4564,10261,61,11,6,5,1,0,1
3271,4564,8659,39,1,1,0,0,0,0
3272,4567,10003,55,8,2,6,2,2,0
3273,4567,9826,45,2,0,2,3,1,2
3274,4569,8197,21,3,2,1,1,1,0
3275,4569,9825,79,10,1,9,2,1,1
3276,4570,8650,62,3,2,1,5,2,3
3277,4570,10252,38,3,1,2,0,0,0
3278,4571,10194,35,3,3,0,3,1,2
3279,4571,8678,65,5,2,3,1,0,1
3280,4572,10261,40,5,4,1,1,0,1
3281,4572,8455,60,8,5,3,1,0,1
3282,4574,8668,77,17,9,8,3,2,1
3283,4574,8659,23,1,0,1,0,0,0
3284,4575,8456,52,6,1,5,4,1,3
3285,4575,8586,48,1,1,0,0,0,0
3286,4576,8654,56,5,1,4,5,2,3
3287,4576,9850,44,3,0,3,1,0,1
3288,4577,8472,38,9,2,7,4,1,3
3289,4577,10260,62,8,3,5,1,0,1
3290,4578,8466,44,10,6,4,1,1,0
3291,4578,10003,56,6,2,4,2,0,2
3292,4580,8650,69,21,11,10,1,1,0
3293,4580,8668,31,1,1,0,1,1,0
3294,4581,9825,68,6,3,3,2,1,1
3295,4581,10260,32,3,1,2,2,0,2
3296,4582,10261,40,2,1,1,1,1,0
3297,4582,8456,60,5,0,5,1,1,0
3298,4583,8455,68,5,2,3,2,1,1
3299,4583,8466,32,4,1,3,2,2,0
3300,4587,8659,47,3,2,1,1,1,0
3301,4587,9826,53,5,2,3,1,0,1
3302,4588,8472,56,6,1,5,2,0,2
3303,4588,8654,44,2,1,1,1,0,1
3304,4590,10252,52,7,5,2,2,0,2
3305,4590,8668,48,4,2,2,0,0,0
3306,4593,8455,54,5,4,1,1,0,1
3307,4593,9850,46,3,0,3,0,0,0
3308,4594,9826,45,7,3,4,1,1,0
3309,4594,8472,55,8,5,3,0,0,0
3310,4595,8586,69,3,1,2,1,0,1
3311,4595,8654,31,7,5,2,2,0,2
3312,4596,8650,48,5,2,3,1,0,1
3313,4596,8456,52,2,1,1,0,0,0
3314,4597,9817,40,5,4,1,1,0,1
3315,4597,10260,60,7,1,6,0,0,0
3316,4598,10261,54,4,3,1,1,1,0
3317,4598,10194,46,2,1,1,0,0,0
3318,4600,9826,41,8,3,5,1,0,1
3319,4600,8650,59,8,2,6,1,0,1
3320,4602,8456,69,7,5,2,1,0,1
3321,4602,10252,31,2,1,1,1,0,1
3322,4603,8678,49,10,3,7,2,2,0
3323,4603,10261,51,7,2,5,1,1,0
3324,4604,8466,72,9,4,5,2,2,0
3325,4604,8472,28,3,0,3,1,0,1
3326,4605,9850,46,6,2,4,2,1,1
3327,4605,10003,54,5,0,5,3,1,2
3328,4609,8650,31,8,5,3,1,0,1
3329,4609,9825,69,10,2,8,0,0,0
3330,4611,8456,55,10,7,3,2,1,1
3331,4611,8668,45,4,1,3,5,2,3
3332,4612,8586,57,8,4,4,3,1,2
3333,4612,8197,43,5,3,2,0,0,0
3334,4613,10260,76,16,9,7,2,1,1
3335,4613,10261,24,3,3,0,2,0,2
3336,4614,9850,44,10,3,7,2,1,1
3337,4614,10194,56,2,0,2,2,0,2
3338,4615,8472,40,6,3,3,2,1,1
3339,4615,10003,60,12,3,9,1,0,1
3340,4617,8455,49,3,2,1,1,1,0
3341,4617,8659,51,6,0,6,4,1,3
3342,4618,8678,56,4,3,1,1,0,1
3343,4618,8654,44,5,1,4,0,0,0
3344,4619,9825,70,7,2,5,2,1,1
3345,4619,8659,30,2,0,2,3,0,3
3346,4620,8586,69,8,6,2,2,1,1
3347,4620,10252,31,6,2,4,2,1,1
3348,4621,8678,46,5,3,2,3,3,0
3349,4621,10003,54,3,0,3,0,0,0
3350,4622,10261,58,4,2,2,2,1,1
3351,4622,8197,42,3,0,3,1,1,0
3352,4623,8650,58,17,9,8,1,1,0
3353,4623,8455,42,9,4,5,3,1,2
3354,4624,10260,65,12,7,5,2,0,2
3355,4624,9826,35,4,1,3,0,0,0
3356,4625,8456,71,11,6,5,1,1,0
3357,4625,9850,29,0,0,0,1,1,0
3358,4626,10194,60,5,2,3,1,1,0
3359,4626,8466,40,5,3,2,6,1,5
3360,4627,8472,33,8,5,3,2,2,0
3361,4627,8668,67,9,0,9,2,1,1
3362,4628,8654,61,7,3,4,1,1,0
3363,4628,9817,39,3,3,0,3,2,1
3364,4629,8455,59,6,2,4,2,1,1
3365,4629,8654,41,5,1,4,0,0,0
3366,4630,9826,64,8,4,4,3,0,3
3367,4630,8197,36,4,2,2,0,0,0
3368,4631,9825,35,4,2,2,1,0,1
3369,4631,8668,65,5,3,2,0,0,0
3370,4632,8456,56,6,3,3,1,1,0
3371,4632,10260,44,4,1,3,1,0,1
3372,4633,8472,57,5,3,2,1,0,1
3373,4633,10261,43,9,1,8,0,0,0
3374,4634,8650,49,12,8,4,2,1,1
3375,4634,8466,51,4,2,2,2,1,1
3376,4635,10252,44,7,4,3,3,2,1
3377,4635,10003,56,3,2,1,2,2,0
3378,4636,8586,53,6,3,3,4,2,2
3379,4636,8678,47,0,0,0,2,1,1
3380,4637,9817,55,3,1,2,2,0,2
3381,4637,10194,45,5,2,3,0,0,0
3382,4639,9825,60,10,7,3,1,0,1
3383,4639,9817,40,3,1,2,0,0,0
3384,4640,10252,42,9,6,3,1,1,0
3385,4640,8455,58,4,1,3,3,2,1
3386,4641,8456,55,4,2,2,2,1,1
3387,4641,8678,45,5,2,3,2,0,2
3388,4642,8197,40,6,1,5,1,0,1
3389,4642,8466,60,4,2,2,0,0,0
3390,4643,8650,38,10,6,4,2,1,1
3391,4643,8586,62,7,3,4,0,0,0
3392,4644,8668,53,7,2,5,1,0,1
3393,4644,10260,47,5,3,2,0,0,0
3394,4645,9850,42,3,3,0,5,2,3
3395,4645,10261,58,6,0,6,1,0,1
3396,4646,10003,57,5,2,3,1,0,1
3397,4646,10194,43,4,2,2,0,0,0
3398,4647,8659,35,1,1,0,3,1,2
3399,4647,8472,65,9,4,5,1,1,0
3400,4648,9826,28,4,1,3,2,0,2
3401,4648,8654,72,8,5,3,0,0,0
3402,4649,8678,57,4,3,1,2,0,2
3403,4649,10252,43,0,0,0,1,0,1
3404,4650,9850,58,6,2,4,1,1,0
3405,4650,9826,42,5,2,3,0,0,0
3406,4651,10194,45,2,1,1,1,1,0
3407,4651,8650,55,5,2,3,2,0,2
3408,4652,8456,66,5,1,4,3,1,2
3409,4652,8659,34,3,1,2,2,0,2
3410,4653,8466,48,7,4,3,2,1,1
3411,4653,10261,52,3,1,2,0,0,0
3412,4654,8197,46,8,3,5,1,0,1
3413,4654,8472,54,5,2,3,3,0,3
3414,4655,8455,64,5,2,3,3,3,0
3415,4655,10003,36,8,4,4,0,0,0
3416,4656,10260,53,2,1,1,2,2,0
3417,4656,8586,47,7,1,6,1,0,1
3418,4657,9817,42,6,3,3,1,0,1
3419,4657,8668,58,7,2,5,0,0,0
3420,4658,8654,29,11,6,5,1,1,0
3421,4658,9825,71,4,3,1,1,0,1
3422,4659,9825,58,9,2,7,2,1,1
3423,4659,9826,42,2,1,1,0,0,0
3424,4662,8668,43,4,1,3,1,0,1
3425,4662,8466,57,5,2,3,0,0,0
3426,4663,8654,62,4,2,2,2,1,1
3427,4663,8197,38,0,0,0,0,0,0
3428,4664,10260,65,4,2,2,1,0,1
3429,4664,10252,35,2,1,1,3,0,3
3430,4665,10261,25,4,3,1,3,1,2
3431,4665,10003,75,4,0,4,2,0,2
3432,4666,9850,69,10,6,4,2,1,1
3433,4666,8472,31,0,0,0,0,0,0
3434,4667,8586,51,5,3,2,1,0,1
3435,4667,10194,49,3,2,1,0,0,0
3436,4668,9817,35,5,2,3,2,0,2
3437,4668,8659,65,6,4,2,0,0,0
3438,4669,10252,43,9,4,5,2,0,2
3439,4669,8466,57,6,2,4,0,0,0
3440,4670,8455,56,4,3,1,2,2,0
3441,4670,8678,44,5,3,2,0,0,0
3442,4671,9826,62,10,4,6,2,1,1
3443,4671,8668,38,7,5,2,1,1,0
3444,4672,10003,59,5,2,3,1,1,0
3445,4672,8197,41,8,3,5,1,1,0
3446,4673,8650,68,7,1,6,3,1,2
3447,4673,10261,32,1,0,1,0,0,0
3448,4674,10194,54,3,1,2,5,2,3
3449,4674,8456,46,4,1,3,1,1,0
3450,4675,9817,44,8,2,6,2,2,0
3451,4675,9850,56,9,5,4,0,0,0
3452,4676,9825,67,14,9,5,1,1,0
3453,4676,8472,33,5,2,3,1,1,0
3454,4677,8586,61,7,6,1,2,2,0
3455,4677,8659,39,6,3,3,0,0,0
3456,4679,9850,30,6,3,3,2,1,1
3457,4679,9825,70,7,3,4,3,1,2
3458,4680,8586,54,6,3,3,2,1,1
3459,4680,8455,46,5,1,4,3,0,3
3460,4681,8668,49,4,1,3,3,1,2
3461,4681,8678,51,6,2,4,1,0,1
3462,4682,10260,64,17,9,8,1,1,0
3463,4682,8197,36,4,0,4,2,1,1
3464,4684,8466,41,4,1,3,2,1,1
3465,4684,8456,59,4,2,2,3,1,2
3466,4685,8472,45,6,3,3,4,1,3
3467,4685,10194,55,4,2,2,1,0,1
3468,4686,10003,42,9,6,3,1,0,1
3469,4686,8650,58,5,3,2,0,0,0
3470,4687,9817,66,8,4,4,2,1,1
3471,4687,10252,34,1,0,1,0,0,0
3472,4688,8659,41,7,5,2,2,1,1
3473,4688,8654,59,1,1,0,0,0,0
3474,4689,10261,56,7,3,4,1,1,0
3475,4689,10252,44,0,0,0,0,0,0
3476,4690,8678,55,6,2,4,3,3,0
3477,4690,8659,45,4,2,2,1,0,1
3478,4691,9826,52,6,4,2,4,1,3
3479,4691,10194,48,3,2,1,0,0,0
3480,4692,8197,56,15,4,11,3,2,1
3481,4692,8668,44,4,1,3,3,2,1
3482,4693,8650,60,9,4,5,2,2,0
3483,4693,9817,40,3,1,2,1,0,1
3484,4694,8456,62,2,1,1,3,1,2
3485,4694,9825,38,1,0,1,2,0,2
3486,4695,9850,27,6,4,2,3,1,2
3487,4695,10260,73,8,7,1,0,0,0
3488,4696,8472,25,7,3,4,1,1,0
3489,4696,8455,75,7,2,5,2,1,1
3490,4697,8586,68,9,4,5,2,1,1
3491,4697,8466,32,3,1,2,1,0,1
3492,4698,8654,45,12,5,7,1,1,0
3493,4698,10003,55,6,2,4,1,1,0
3494,4699,9825,62,7,4,3,4,1,3
3495,4699,10252,38,4,1,3,0,0,0
3496,4700,8455,55,11,9,2,2,2,0
3497,4700,8197,45,10,3,7,4,2,2
3498,4701,8668,46,9,6,3,2,0,2
3499,4701,9850,54,4,3,1,1,0,1
3500,4702,10260,71,5,1,4,2,1,1
3501,4702,8678,29,5,2,3,2,0,2
3502,4703,8586,134,8,4,4,1,1,0
3503,4703,10261,-34,11,8,3,2,0,2
3504,4704,9826,54,5,4,1,4,3,1
3505,4704,8466,46,4,3,1,1,1,0
3506,4705,8654,47,10,2,8,1,0,1
3507,4705,10194,53,3,0,3,0,0,0
3508,4706,8456,58,5,4,1,2,0,2
3509,4706,10003,42,1,1,0,1,0,1
3510,4707,9817,57,6,5,1,1,0,1
3511,4707,8472,43,2,1,1,0,0,0
3512,4708,8650,58,3,3,0,1,1,0
3513,4708,8659,42,5,1,4,5,2,3
3514,4709,10252,61,10,4,6,2,0,2
3515,4709,8472,39,2,0,2,0,0,0
3516,4710,8678,55,1,1,0,1,1,0
3517,4710,8197,45,1,0,1,0,0,0
3518,4711,8455,63,17,7,10,4,1,3
3519,4711,9826,37,4,2,2,0,0,0
3520,4713,8456,55,8,4,4,1,0,1
3521,4713,9817,45,4,1,3,0,0,0
3522,4714,9825,74,16,6,10,1,1,0
3523,4714,10261,26,0,0,0,1,0,1
3524,4716,10194,36,7,3,4,1,1,0
3525,4716,8659,64,8,5,3,0,0,0
3526,4717,10260,66,5,3,2,1,0,1
3527,4717,10003,34,3,2,1,1,0,1
3528,4718,8586,55,12,7,5,1,1,0
3529,4718,8668,45,4,2,2,0,0,0
3530,4720,9826,40,4,3,1,1,1,0
3531,4720,8456,60,11,6,5,0,0,0
3532,4725,8472,43,7,5,2,2,0,2
3533,4725,8586,57,8,4,4,0,0,0
3534,4727,8466,70,9,3,6,3,1,2
3535,4727,8659,30,2,0,2,1,1,0
3536,4729,8659,33,7,3,4,2,1,1
3537,4729,10252,67,9,4,5,1,0,1
3538,4731,9825,30,4,2,2,1,1,0
3539,4731,8455,70,16,7,9,3,0,3
3540,4732,8650,65,14,6,8,3,1,2
3541,4732,9850,35,3,0,3,3,0,3
3542,4733,8456,78,14,5,9,1,1,0
3543,4733,8654,22,2,1,1,0,0,0
3544,4734,10261,59,8,4,4,2,2,0
3545,4734,9817,41,5,4,1,0,0,0
3546,4735,8466,45,7,3,4,1,0,1
3547,4735,10260,55,1,0,1,1,0,1
3548,4737,8668,54,9,4,5,2,1,1
3549,4737,10003,46,8,3,5,2,0,2
3550,4738,8586,54,11,4,7,2,2,0
3551,4738,9826,46,8,4,4,0,0,0
3552,4739,9825,57,15,6,9,1,0,1
3553,4739,8197,43,8,3,5,0,0,0
3554,4741,10260,67,8,5,3,1,1,0
3555,4741,8472,33,7,3,4,2,2,0
3556,4742,10261,22,6,6,0,3,1,2
3557,4742,8455,78,5,2,3,0,0,0
3558,4743,10003,62,8,3,5,2,0,2
3559,4743,8466,38,7,2,5,0,0,0
3560,4744,10194,34,4,2,2,3,1,2
3561,4744,8678,66,8,3,5,1,0,1
3562,4745,8586,37,7,5,2,2,0,2
3563,4745,8456,63,15,8,7,2,0,2
3564,4746,9817,53,7,4,3,3,2,1
3565,4746,9826,47,8,5,3,3,0,3
3566,4747,8659,43,3,1,2,1,1,0
3567,4747,8668,57,5,2,3,2,1,1
3568,4748,9850,53,7,2,5,1,0,1
3569,4748,8654,47,8,4,4,0,0,0
3570,4749,9825,29,4,1,3,2,1,1
3571,4749,10260,71,5,1,4,5,2,3
3572,4751,9817,45,5,2,3,1,1,0
3573,4751,8678,55,8,2,6,0,0,0
3574,4752,8455,60,6,4,2,5,3,2
3575,4752,8466,40,7,2,5,2,1,1
3576,4753,9826,56,15,10,5,3,1,2
3577,4753,8659,44,4,2,2,2,0,2
3578,4754,8650,49,5,3,2,3,1,2
3579,4754,8668,51,10,3,7,0,0,0
3580,4755,8456,68,11,6,5,3,2,1
3581,4755,10261,32,4,4,0,2,0,2
3582,4757,8472,36,4,3,1,1,1,0
3583,4757,8654,64,9,1,8,0,0,0
3584,4758,8586,49,14,8,6,1,0,1
3585,4758,10003,51,6,3,3,0,0,0
3586,4765,10003,60,4,2,2,2,0,2
3587,4765,10194,40,2,1,1,0,0,0
3588,4767,9825,70,11,7,4,1,1,0
3589,4767,9817,30,4,1,3,2,1,1
3590,4768,8472,39,4,2,2,2,1,1
3591,4768,8659,61,4,1,3,1,1,0
3592,5952,8639,66,4,1,3,3,2,1
3593,5952,4087,34,1,0,1,1,0,1
3594,6067,9941,54,3,3,0,2,1,1
3595,6067,9853,46,8,1,7,3,2,1
3596,6076,10249,49,7,2,5,3,2,1
3597,6076,9847,51,3,1,2,1,0,1
3598,7049,9837,37,2,1,1,1,1,0
3599,7049,9847,63,3,1,2,0,0,0
3600,7050,7794,47,10,5,5,1,1,0
3601,7050,8592,53,6,4,2,0,0,0
3602,7054,9748,58,11,7,4,1,1,0
3603,7054,9851,42,3,0,3,0,0,0
3604,7057,9830,51,5,4,1,2,1,1
3605,7057,8588,49,2,2,0,2,2,0
3606,7060,9847,74,5,4,1,3,1,2
3607,7060,8588,26,5,3,2,1,0,1
3608,7061,8639,57,13,5,8,1,1,0
3609,7061,9747,43,2,1,1,2,0,2
3610,7062,9853,48,6,4,2,5,2,3
3611,7062,8689,52,2,0,2,3,0,3
3612,7065,4087,52,3,2,1,1,1,0
3613,7065,9829,48,4,0,4,2,0,2
3614,7067,9831,64,9,1,8,1,1,0
3615,7067,7794,36,2,1,1,1,0,1
3616,7068,9748,57,11,7,4,2,0,2
3617,7068,10249,43,2,1,1,0,0,0
3618,7069,8592,63,6,1,5,3,2,1
3619,7069,9748,37,6,1,5,0,0,0
3620,7070,7794,54,7,3,4,4,2,2
3621,7070,9829,46,6,3,3,1,1,0
3622,7076,8639,46,2,1,1,2,2,0
3623,7076,9851,54,4,2,2,0,0,0
3624,7079,9827,47,3,1,2,1,1,0
3625,7079,9941,53,2,1,1,1,1,0
3626,7080,9747,35,5,4,1,1,1,0
3627,7080,7794,65,3,0,3,2,1,1
3628,7082,8689,43,10,8,2,4,2,2
3629,7082,9847,57,6,2,4,0,0,0
3630,7084,7819,54,3,2,1,5,2,3
3631,7084,8550,46,3,2,1,0,0,0
3632,7086,10249,55,5,5,0,2,1,1
3633,7086,4087,45,2,0,2,3,1,2
3634,7088,9748,62,6,3,3,2,1,1
3635,7088,9831,38,3,1,2,1,1,0
3636,7089,10249,60,1,1,0,2,1,1
3637,7089,7794,40,4,4,0,1,1,0
3638,7092,8588,61,7,5,2,2,2,0
3639,7092,9827,39,1,0,1,1,1,0
3640,7095,8689,47,5,2,3,1,1,0
3641,7095,9851,53,4,2,2,2,1,1
3642,7096,9829,39,3,1,2,1,0,1
3643,7096,9853,61,5,2,3,0,0,0
3644,7098,8592,55,8,4,4,1,1,0
3645,7098,9847,45,11,3,8,0,0,0
3646,7099,7794,44,5,3,2,2,1,1
3647,7099,9748,56,3,0,3,1,1,0
3648,7101,4087,36,2,2,0,3,2,1
3649,7101,8639,64,3,1,2,2,0,2
3650,7102,8689,59,16,5,11,2,1,1
3651,7102,8588,41,5,4,1,1,0,1
3652,7103,9827,44,4,3,1,3,2,1
3653,7103,8592,56,11,5,6,2,0,2
3654,7105,9829,62,13,5,8,4,2,2
3655,7105,7819,38,4,3,1,0,0,0
3656,7106,9941,66,2,1,1,1,0,1
3657,7106,10249,34,5,3,2,2,0,2
3658,7107,9853,58,4,2,2,1,1,0
3659,7107,9830,42,8,5,3,4,1,3
3660,7109,8639,49,3,2,1,1,1,0
3661,7109,9827,51,4,1,3,0,0,0
3662,7111,9747,47,6,1,5,1,0,1
3663,7111,4087,53,1,0,1,0,0,0
3664,7112,8588,59,4,3,1,2,1,1
3665,7112,8550,41,1,0,1,1,0,1
3666,7113,9830,42,5,2,3,1,0,1
3667,7113,8592,58,3,2,1,0,0,0
3668,7115,9837,57,6,2,4,1,0,1
3669,7115,7794,43,2,2,0,0,0,0
3670,7116,9851,47,1,1,0,3,1,2
3671,7116,9829,53,4,0,4,1,1,0
3672,7119,7794,49,4,4,0,2,1,1
3673,7119,4087,51,2,1,1,1,0,1
3674,7120,7819,45,1,1,0,2,1,1
3675,7120,9747,55,6,1,5,0,0,0
3676,7121,8639,38,8,3,5,2,2,0
3677,7121,9847,62,7,3,4,1,0,1
3678,7122,8592,58,10,2,8,4,2,2
3679,7122,8689,42,5,1,4,0,0,0
3680,7126,9853,43,5,2,3,1,1,0
3681,7126,10249,57,4,1,3,0,0,0
3682,7129,8689,41,7,3,4,2,1,1
3683,7129,9827,59,13,6,7,1,0,1
3684,7131,9748,72,10,6,4,2,0,2
3685,7131,4087,28,0,0,0,1,0,1
3686,7133,8592,63,7,1,6,1,1,0
3687,7133,8550,37,7,5,2,1,0,1
3688,7134,9847,67,7,7,0,2,0,2
3689,7134,9830,33,1,0,1,1,0,1
3690,7135,9837,60,7,4,3,1,0,1
3691,7135,9747,40,2,1,1,1,0,1
3692,7136,10249,37,7,2,5,1,0,1
3693,7136,9851,63,6,3,3,1,0,1
3694,7137,7794,37,4,2,2,2,0,2
3695,7137,9853,63,3,2,1,2,0,2
3696,7138,9829,46,6,4,2,1,0,1
3697,7138,9941,54,5,1,4,2,0,2
3698,7139,9851,51,3,2,1,3,2,1
3699,7139,7794,49,6,5,1,0,0,0
3700,7140,9847,78,5,2,3,2,0,2
3701,7140,9747,22,2,1,1,0,0,0
3702,7142,8689,53,7,2,5,1,1,0
3703,7142,8550,47,2,1,1,0,0,0
3704,7143,7819,27,3,3,0,1,0,1
3705,7143,9748,73,10,4,6,1,0,1
3706,7144,8588,45,4,3,1,1,0,1
3707,7144,10249,55,4,1,3,0,0,0
3708,7145,9827,49,4,2,2,1,1,0
3709,7145,9830,51,1,0,1,0,0,0
3710,7146,9831,59,4,1,3,1,1,0
3711,7146,9853,41,2,0,2,2,0,2
3712,7147,9837,59,7,5,2,1,1,0
3713,7147,4087,41,5,5,0,2,1,1
3714,7151,8588,47,3,2,1,1,1,0
3715,7151,9831,53,2,1,1,0,0,0
3716,7155,9847,73,7,2,5,2,2,0
3717,7155,10249,27,1,0,1,1,1,0
3718,7158,9747,43,3,1,2,1,1,0
3719,7158,9941,57,3,0,3,1,0,1
3720,7162,8689,60,7,2,5,4,1,3
3721,7162,9831,40,4,2,2,1,0,1
3722,7163,10249,40,3,1,2,2,1,1
3723,7163,8592,60,10,5,5,0,0,0
3724,7164,8550,45,5,1,4,3,1,2
3725,7164,9830,55,2,1,1,1,0,1
3726,7167,9853,53,10,5,5,1,1,0
3727,7167,9837,47,3,2,1,0,0,0
3728,7169,7794,32,1,1,0,2,1,1
3729,7169,9847,68,3,1,2,0,0,0
3730,7170,9851,51,5,3,2,2,1,1
3731,7170,4087,49,4,3,1,2,0,2
3732,7174,9827,49,5,3,2,1,0,1
3733,7174,9829,51,6,3,3,0,0,0
3734,7178,9853,40,8,5,3,1,0,1
3735,7178,9837,60,12,8,4,0,0,0
3736,7179,9827,45,3,1,2,2,0,2
3737,7179,9831,55,0,0,0,1,0,1
3738,7180,7819,39,7,5,2,1,0,1
3739,7180,9837,61,6,1,5,0,0,0
3740,7182,8639,55,5,1,4,2,1,1
3741,7182,8689,45,9,4,5,1,0,1
3742,7183,9747,41,6,3,3,1,1,0
3743,7183,8592,59,9,3,6,3,2,1
3744,7185,9830,47,5,1,4,2,0,2
3745,7185,9829,53,5,1,4,1,0,1
3746,7186,4087,36,2,1,1,4,1,3
3747,7186,9847,64,4,3,1,1,0,1
3748,7188,9941,60,6,4,2,3,1,2
3749,7188,7794,40,2,0,2,0,0,0
3750,7189,7794,43,6,2,4,2,1,1
3751,7189,9827,57,6,0,6,1,0,1
3752,7190,9941,55,5,3,2,1,1,0
3753,7190,4087,45,4,2,2,2,1,1
3754,7194,9830,57,9,4,5,2,1,1
3755,7194,10249,43,4,2,2,0,0,0
3756,7196,9837,62,4,2,2,1,1,0
3757,7196,8588,38,12,3,9,1,0,1
3758,7198,9853,52,4,1,3,1,1,0
3759,7198,9847,48,4,1,3,1,1,0
3760,7199,9827,64,4,2,2,4,3,1
3761,7199,9747,36,4,3,1,3,1,2
3762,7200,7819,30,6,2,4,3,1,2
3763,7200,9853,70,2,0,2,3,2,1
3764,7201,8588,56,8,2,6,3,0,3
3765,7201,7794,44,0,0,0,0,0,0
3766,7204,8550,52,4,3,1,1,0,1
3767,7204,9831,48,1,0,1,0,0,0
3768,7207,9851,45,4,1,3,1,0,1
3769,7207,9847,55,3,1,2,0,0,0
3770,7208,9837,55,3,1,2,1,0,1
3771,7208,9941,45,5,3,2,1,0,1
3772,7209,7794,63,9,6,3,2,1,1
3773,7209,8550,37,5,1,4,0,0,0
3774,7213,9748,42,4,1,3,1,1,0
3775,7213,9847,58,8,1,7,0,0,0
3776,7214,10249,52,6,5,1,1,0,1
3777,7214,8639,48,4,1,3,0,0,0
3778,7216,8689,47,4,3,1,2,1,1
3779,7216,9837,53,5,2,3,0,0,0
3780,7218,9853,47,4,3,1,2,1,1
3781,7218,8588,53,5,4,1,2,0,2
3782,7219,9853,51,5,3,2,3,2,1
3783,7219,9827,49,6,2,4,0,0,0
3784,7220,4087,33,3,3,0,1,1,0
3785,7220,8588,67,7,3,4,1,0,1
3786,7222,8689,34,9,7,2,2,1,1
3787,7222,9748,66,7,3,4,3,0,3
3788,7223,9837,32,6,2,4,1,1,0
3789,7223,8592,68,5,3,2,1,0,1
3790,7224,9747,42,3,2,1,3,1,2
3791,7224,8550,58,4,0,4,0,0,0
3792,7225,10249,42,2,2,0,1,1,0
3793,7225,9829,58,7,3,4,1,1,0
3794,7229,7794,40,4,1,3,1,0,1
3795,7229,8639,60,6,3,3,0,0,0
3796,7232,9747,64,4,2,2,5,2,3
3797,7232,10249,36,9,5,4,1,1,0
3798,7233,9748,70,7,3,4,1,1,0
3799,7233,9830,30,1,1,0,1,0,1
3800,7235,9941,44,3,1,2,1,0,1
3801,7235,9847,56,2,0,2,1,0,1
3802,7236,8550,44,9,2,7,2,1,1
3803,7236,9837,56,6,5,1,1,0,1
3804,7238,9853,47,9,3,6,2,0,2
3805,7238,8592,53,4,1,3,0,0,0
3806,7243,8592,56,8,3,5,1,1,0
3807,7243,7819,44,8,4,4,0,0,0
3808,7246,9831,55,11,6,5,1,0,1
3809,7246,10249,45,5,2,3,0,0,0
3810,7247,9830,56,2,1,1,1,0,1
3811,7247,9747,44,1,0,1,1,0,1
3812,7249,9748,66,3,2,1,1,1,0
3813,7249,10249,34,6,0,6,0,0,0
3814,7256,8550,56,7,1,6,2,2,0
3815,7256,9851,44,4,2,2,0,0,0
3816,7258,9941,42,3,2,1,1,1,0
3817,7258,8592,58,4,1,3,3,0,3
3818,7259,9827,57,5,3,2,1,0,1
3819,7259,9847,43,3,1,2,0,0,0
3820,7261,9851,46,5,4,1,3,2,1
3821,7261,8639,54,4,1,3,1,0,1
3822,7263,8592,58,7,3,4,1,1,0
3823,7263,9748,42,6,2,4,2,0,2
3824,7264,8550,54,5,1,4,1,1,0
3825,7264,9853,46,1,0,1,2,1,1
3826,7269,7794,41,2,1,1,1,1,0
3827,7269,9941,59,5,2,3,2,2,0
3828,7271,9747,54,3,1,2,1,0,1
3829,7271,8592,46,5,5,0,1,0,1
3830,7272,8639,66,6,3,3,1,0,1
3831,7272,8689,34,1,0,1,0,0,0
3832,7274,8550,43,4,1,3,2,0,2
3833,7274,10249,57,4,1,3,0,0,0
3834,7279,7794,54,7,4,3,4,1,3
3835,7279,9747,46,5,4,1,0,0,0
3836,7280,7819,45,9,5,4,1,0,1
3837,7280,8550,55,4,0,4,1,0,1
3838,7286,9851,60,9,5,4,2,2,0
3839,7286,9830,40,3,1,2,0,0,0
3840,7288,9941,35,5,3,2,1,1,0
3841,7288,9827,65,8,5,3,1,0,1
3842,7290,9748,74,4,2,2,4,1,3
3843,7290,9747,26,1,0,1,0,0,0
3844,7294,8550,56,9,6,3,1,0,1
3845,7294,9941,44,2,1,1,0,0,0
3846,7302,8689,55,5,1,4,3,1,2
3847,7302,8588,45,3,2,1,0,0,0
3848,7304,9847,69,5,0,5,1,0,1
3849,7304,8550,31,2,0,2,0,0,0
3850,7305,9837,58,5,0,5,2,1,1
3851,7305,9831,42,5,0,5,3,3,0
3852,7307,9830,68,4,2,2,2,2,0
3853,7307,9853,32,2,0,2,1,0,1
3854,7312,9941,39,3,1,2,4,3,1
3855,7312,8689,61,5,3,2,1,0,1
3856,7313,9748,42,7,6,1,1,0,1
3857,7313,9853,58,7,2,5,0,0,0
3858,7314,8550,44,7,4,3,1,1,0
3859,7314,8588,56,2,0,2,1,0,1
3860,7319,9827,63,6,1,5,3,3,0
3861,7319,8550,37,1,0,1,2,0,2
3862,7323,8592,65,3,1,2,3,2,1
3863,7323,8689,35,2,1,1,4,1,3
3864,7326,9831,44,6,3,3,1,0,1
3865,7326,9851,56,3,0,3,1,0,1
3866,7328,9941,38,2,2,0,1,1,0
3867,7328,9830,62,2,1,1,0,0,0
3868,7330,9837,51,3,1,2,3,0,3
3869,7330,9747,49,3,2,1,0,0,0
3870,7333,4087,53,3,2,1,2,0,2
3871,7333,9748,47,4,2,2,0,0,0
3872,7335,9829,53,2,1,1,2,2,0
3873,7335,9941,47,4,3,1,1,0,1
3874,7337,9847,51,7,6,1,1,0,1
3875,7337,9830,49,4,3,1,2,0,2
3876,7338,9831,48,7,3,4,1,1,0
3877,7338,7819,52,8,1,7,1,0,1
3878,7339,9830,44,3,1,2,1,0,1
3879,7339,9827,56,3,3,0,1,0,1
3880,7344,8550,63,12,5,7,4,3,1
3881,7344,8689,37,9,6,3,2,1,1
3882,7347,9853,48,6,4,2,4,4,0
3883,7347,9831,52,5,0,5,1,0,1
3884,7348,8639,54,7,5,2,2,1,1
3885,7348,9941,46,8,4,4,1,1,0
3886,7350,4087,42,5,1,4,1,0,1
3887,7350,9853,58,3,1,2,0,0,0
3888,7351,9747,33,4,1,3,2,1,1
3889,7351,9941,67,10,3,7,1,1,0
3890,7355,10249,49,3,2,1,2,1,1
3891,7355,9847,51,6,3,3,0,0,0
3892,7357,9831,46,8,3,5,1,1,0
3893,7357,8588,54,3,1,2,1,0,1
3894,7358,9851,66,5,2,3,2,2,0
3895,7358,9837,34,0,0,0,2,1,1
3896,7361,8588,33,2,1,1,9,3,6
3897,7361,9830,67,9,5,4,1,0,1
3898,7363,8592,66,5,3,2,2,0,2
3899,7363,7794,34,3,0,3,0,0,0
3900,7365,9847,67,5,4,1,2,0,2
3901,7365,9837,33,4,2,2,0,0,0
3902,7367,9853,51,6,3,3,2,1,1
3903,7367,9747,49,4,2,2,1,0,1
3904,7368,9831,49,3,1,2,3,1,2
3905,7368,9941,51,4,0,4,1,0,1
3906,7373,8592,55,8,3,5,5,3,2
3907,7373,9831,45,6,1,5,1,1,0
3908,7374,9748,45,6,4,2,3,0,3
3909,7374,8550,55,3,1,2,0,0,0
3910,7378,9847,69,8,5,3,1,0,1
3911,7378,9853,31,5,2,3,1,0,1
3912,7384,8689,63,10,2,8,3,1,2
3913,7384,10249,37,5,2,3,0,0,0
3914,7388,7819,38,1,1,0,1,1,0
3915,7388,9853,62,5,1,4,0,0,0
3916,7389,4087,45,3,1,2,2,1,1
3917,7389,9827,55,0,0,0,2,1,1
3918,7390,8588,47,6,3,3,1,1,0
3919,7390,9853,53,4,3,1,3,1,2
3920,7392,9837,33,4,3,1,2,1,1
3921,7392,8689,67,1,1,0,0,0,0
3922,7394,8550,52,12,6,6,4,2,2
3923,7394,7794,48,3,1,2,1,1,0
3924,7398,9748,39,5,1,4,3,2,1
3925,7398,9847,61,4,1,3,1,0,1
3926,7400,9847,64,8,4,4,1,1,0
3927,7400,7819,36,4,1,3,0,0,0
3928,7401,4087,60,5,4,1,1,0,1
3929,7401,8588,40,5,1,4,0,0,0
3930,7403,9748,53,9,6,3,4,1,3
3931,7403,8689,47,7,2,5,1,0,1
3932,7405,8639,48,3,3,0,3,2,1
3933,7405,9831,52,3,3,0,0,0,0
3934,7407,9851,60,9,5,4,2,1,1
3935,7407,9941,40,2,1,1,1,0,1
3936,7409,9851,52,5,3,2,4,0,4
3937,7409,9827,48,7,1,6,0,0,0
3938,7410,7819,51,5,4,1,2,0,2
3939,7410,8588,49,3,2,1,1,0,1
3940,7415,9829,62,2,2,0,3,0,3
3941,7415,9831,38,3,2,1,1,0,1
3942,7416,9747,51,6,5,1,1,0,1
3943,7416,10249,49,5,4,1,1,0,1
3944,7417,9830,42,6,2,4,2,1,1
3945,7417,9748,58,7,3,4,0,0,0
3946,7419,7794,64,3,2,1,1,1,0
3947,7419,8689,36,6,3,3,1,0,1
3948,7420,7819,36,5,2,3,1,0,1
3949,7420,8592,64,12,7,5,0,0,0
3950,7421,8550,51,5,3,2,3,0,3
3951,7421,4087,49,0,0,0,0,0,0
3952,7423,9748,43,5,4,1,2,0,2
3953,7423,8639,57,4,1,3,0,0,0
3954,7426,9851,40,7,2,5,1,1,0
3955,7426,8588,60,4,1,3,1,0,1
3956,7427,9941,41,1,1,0,2,1,1
3957,7427,9853,59,6,1,5,3,2,1
3958,7428,9829,48,6,2,4,3,2,1
3959,7428,9847,52,5,3,2,2,2,0
3960,7431,9847,45,3,1,2,2,1,1
3961,7431,8639,55,9,4,5,0,0,0
3962,7433,7819,29,4,4,0,1,1,0
3963,7433,8592,71,10,4,6,1,0,1
3964,7436,9831,38,2,0,2,1,1,0
3965,7436,9829,62,5,0,5,0,0,0
3966,7437,9941,48,2,2,0,1,0,1
3967,7437,9853,52,5,2,3,0,0,0
3968,7438,10242,53,4,1,3,1,0,1
3969,7438,6391,47,1,1,0,0,0,0
3970,7440,9827,54,9,2,7,2,2,0
3971,7440,10249,46,2,0,2,1,0,1
3972,7442,8592,61,13,7,6,4,0,4
3973,7442,8689,39,2,0,2,0,0,0
3974,7443,9829,30,6,2,4,3,1,2
3975,7443,9748,70,9,2,7,2,0,2
3976,7446,9851,42,5,3,2,3,2,1
3977,7446,9831,58,3,1,2,0,0,0
3978,7447,9853,61,7,1,6,2,2,0
3979,7447,6391,39,0,0,0,1,0,1
3980,7455,9941,33,3,1,2,4,1,3
3981,7455,9748,67,7,5,2,0,0,0
3982,7458,9829,35,5,2,3,1,0,1
3983,7458,9837,65,7,2,5,0,0,0
3984,7460,6391,28,2,2,0,1,0,1
3985,7460,9827,72,2,1,1,0,0,0
3986,7461,8689,60,7,6,1,2,1,1
3987,7461,9747,40,4,1,3,4,1,3
3988,7463,9830,46,5,3,2,2,2,0
3989,7463,8592,54,6,1,5,0,0,0
3990,7464,9831,57,6,2,4,1,1,0
3991,7464,8639,43,3,0,3,0,0,0
3992,7465,9847,61,4,4,0,4,2,2
3993,7465,9851,39,2,1,1,1,1,0
3994,7466,9837,43,8,6,2,1,1,0
3995,7466,9853,57,8,5,3,2,0,2
3996,7468,10242,27,4,2,2,4,2,2
3997,7468,9748,73,14,7,7,1,0,1
3998,7469,8121,46,7,3,4,2,1,1
3999,7469,9851,54,2,1,1,1,0,1
4000,7470,9827,35,1,1,0,3,2,1
4001,7470,9829,65,5,2,3,0,0,0
4002,7471,9747,56,7,2,5,4,2,2
4003,7471,7819,44,7,0,7,0,0,0
4004,7473,8689,43,11,7,4,1,1,0
4005,7473,10242,57,8,2,6,0,0,0
4006,7474,9748,52,8,5,3,3,0,3
4007,7474,9853,48,3,1,2,0,0,0
4008,7476,10249,52,3,1,2,4,1,3
4009,7476,9830,48,2,0,2,1,0,1
4010,7479,7794,51,5,3,2,2,2,0
4011,7479,6391,49,6,1,5,3,0,3
4012,7487,8592,48,6,4,2,2,1,1
4013,7487,9853,52,6,4,2,1,1,0
4014,7488,8639,57,7,1,6,1,1,0
4015,7488,10242,43,4,1,3,0,0,0
4016,7491,6391,41,6,4,2,1,1,0
4017,7491,8689,59,2,1,1,0,0,0
4018,7492,10249,42,7,3,4,1,1,0
4019,7492,9748,58,4,3,1,3,0,3
4020,7493,9829,49,5,2,3,2,2,0
4021,7493,8592,51,7,3,4,2,1,1
4022,7497,9853,53,9,4,5,1,1,0
4023,7497,9747,47,6,2,4,3,2,1
4024,7499,9847,82,6,3,3,1,1,0
4025,7499,8121,18,3,2,1,1,0,1
4026,7500,7794,53,4,1,3,1,0,1
4027,7500,9827,47,2,1,1,2,0,2
4028,7502,8639,48,7,4,3,1,1,0
4029,7502,9853,52,2,1,1,1,0,1
4030,7503,8689,55,4,3,1,1,1,0
4031,7503,9831,45,9,3,6,0,0,0
4032,7504,7819,43,4,3,1,2,1,1
4033,7504,9829,57,5,1,4,0,0,0
4034,7505,10249,58,7,3,4,1,1,0
4035,7505,6391,42,1,1,0,4,1,3
4036,7507,9851,56,6,1,5,4,1,3
4037,7507,8592,44,6,2,4,0,0,0
4038,7510,9827,54,7,2,5,1,0,1
4039,7510,9747,46,2,0,2,1,0,1
4040,7513,9748,59,6,1,5,3,3,0
4041,7513,8121,41,6,2,4,1,0,1
4042,7514,8592,66,11,3,8,2,1,1
4043,7514,10249,34,0,0,0,0,0,0
4044,7515,9847,62,6,1,5,2,1,1
4045,7515,9831,38,2,2,0,0,0,0
4046,7516,9837,60,6,3,3,1,0,1
4047,7516,10242,40,6,2,4,0,0,0
4048,7518,9941,57,4,2,2,2,2,0
4049,7518,8689,43,2,1,1,0,0,0
4050,7519,9827,51,1,1,0,2,1,1
4051,7519,8121,49,4,2,2,3,3,0
4052,7520,8639,42,8,2,6,1,0,1
4053,7520,8689,58,4,2,2,0,0,0
4054,7521,8592,54,5,2,3,2,1,1
4055,7521,6391,46,3,2,1,1,1,0
4056,7522,9853,48,3,2,1,2,0,2
4057,7522,9829,52,4,1,3,0,0,0
4058,7525,9847,71,3,1,2,2,1,1
4059,7525,9748,29,3,1,2,4,2,2
4060,7526,9831,60,2,1,1,2,2,0
4061,7526,9837,40,6,2,4,1,0,1
4062,7530,9827,39,5,3,2,4,2,2
4063,7530,8592,61,4,2,2,1,0,1
4064,7532,6391,41,8,4,4,2,1,1
4065,7532,9748,59,4,3,1,1,1,0
4066,7533,9747,54,8,3,5,2,0,2
4067,7533,9851,46,3,2,1,0,0,0
4068,7538,10242,32,6,2,4,3,1,2
4069,7538,9829,68,8,2,6,1,1,0
4070,7546,9851,49,3,1,2,1,0,1
4071,7546,10249,51,2,1,1,2,0,2
4072,7547,9827,52,8,1,7,1,1,0
4073,7547,9853,48,3,0,3,1,0,1
4074,7553,9827,45,6,3,3,1,1,0
4075,7553,10249,55,5,0,5,1,1,0
4076,7554,8592,72,4,2,2,1,1,0
4077,7554,9747,28,1,0,1,1,0,1
4078,7556,9847,80,5,2,3,2,1,1
4079,7556,7794,20,0,0,0,1,1,0
4080,7557,9837,48,2,0,2,1,1,0
4081,7557,9941,52,0,0,0,3,1,2
4082,7559,9853,32,3,1,2,1,1,0
4083,7559,9748,68,13,6,7,1,0,1
4084,7560,9830,54,6,2,4,2,1,1
4085,7560,9747,46,4,1,3,1,1,0
4086,7565,8121,36,5,2,3,1,1,0
4087,7565,9831,64,7,1,6,1,0,1
4088,7573,7819,35,3,1,2,1,1,0
4089,7573,10249,65,7,3,4,0,0,0
4090,7574,9831,51,2,1,1,4,1,3
4091,7574,8689,49,5,2,3,0,0,0
4092,7575,8592,33,3,2,1,1,1,0
4093,7575,9748,67,14,2,12,0,0,0
4094,7578,9851,55,3,2,1,1,1,0
4095,7578,6391,45,2,0,2,0,0,0
4096,7580,9853,38,8,4,4,1,0,1
4097,7580,9847,62,6,4,2,0,0,0
4098,7582,9851,56,4,2,2,1,1,0
4099,7582,9827,44,5,3,2,0,0,0
4100,7585,8592,59,12,6,6,1,1,0
4101,7585,8639,41,5,3,2,0,0,0
4102,7587,7819,16,4,1,3,4,0,4
4103,7587,9831,84,9,3,6,0,0,0
4104,7589,7794,57,8,1,7,2,2,0
4105,7589,9829,43,4,1,3,0,0,0
4106,7590,10242,56,7,4,3,3,2,1
4107,7590,9747,44,4,3,1,1,1,0
4108,7593,10249,45,6,2,4,2,2,0
4109,7593,8592,55,1,0,1,2,2,0
4110,7595,9748,52,9,5,4,4,2,2
4111,7595,9827,48,4,2,2,2,2,0
4112,7598,9851,55,2,1,1,3,3,0
4113,7598,9853,45,6,2,4,0,0,0
4114,7603,6391,70,4,1,3,4,2,2
4115,7603,9747,30,0,0,0,0,0,0
4116,7608,9830,44,10,4,6,1,1,0
4117,7608,9941,56,4,3,1,0,0,0
4118,7609,6391,51,7,1,6,3,0,3
4119,7609,10242,49,0,0,0,3,0,3
4120,7612,9830,43,2,1,1,2,2,0
4121,7612,8689,57,1,1,0,4,1,3
4122,7615,7819,48,8,4,4,2,0,2
4123,7615,9748,52,4,1,3,0,0,0
4124,7617,7794,45,5,3,2,3,3,0
4125,7617,9837,55,6,3,3,0,0,0
4126,7618,9851,63,5,1,4,1,1,0
4127,7618,8121,37,1,1,0,1,0,1
4128,7619,10249,56,4,2,2,1,1,0
4129,7619,8121,44,2,0,2,0,0,0
4130,7621,9827,42,6,4,2,3,2,1
4131,7621,9831,58,6,2,4,3,0,3
4132,7622,9747,47,8,4,4,2,0,2
4133,7622,8689,53,8,5,3,0,0,0
4134,7628,6391,44,6,3,3,2,2,0
4135,7628,9941,56,5,2,3,2,0,2
4136,7631,8689,47,10,5,5,4,3,1
4137,7631,10242,53,7,2,5,0,0,0
4138,7632,9830,58,6,5,1,1,1,0
4139,7632,9829,42,2,1,1,2,0,2
4140,7634,10249,52,4,3,1,1,1,0
4141,7634,8639,48,3,0,3,1,1,0
4142,7635,9831,64,7,4,3,2,1,1
4143,7635,7794,36,5,3,2,1,1,0
4144,7636,9748,46,7,4,3,2,0,2
4145,7636,9847,54,3,2,1,0,0,0
4146,7638,9851,52,10,6,4,3,1,2
4147,7638,9941,48,4,1,3,2,0,2
4148,7640,6391,57,2,1,1,1,1,0
4149,7640,9827,43,5,3,2,0,0,0
4150,7643,8592,55,10,7,3,2,1,1
4151,7643,9941,45,10,3,7,0,0,0
4152,7644,9748,53,6,1,5,1,1,0
4153,7644,9747,47,4,1,3,0,0,0
4154,7646,7794,56,6,3,3,2,1,1
4155,7646,8689,44,2,0,2,3,2,1
4156,7648,9851,39,4,2,2,3,1,2
4157,7648,9830,61,5,0,5,2,1,1
4158,7649,9747,60,4,3,1,3,3,0
4159,7649,7794,40,5,3,2,1,0,1
4160,7651,9827,47,7,3,4,1,1,0
4161,7651,8639,53,6,1,5,2,0,2
4162,7652,9853,64,7,5,2,2,1,1
4163,7652,8689,36,6,4,2,4,0,4
4164,7653,9851,39,1,0,1,3,1,2
4165,7653,9748,61,4,0,4,2,1,1
4166,7655,9847,56,5,2,3,2,0,2
4167,7655,10249,44,3,1,2,1,0,1
4168,7658,9941,39,3,2,1,2,1,1
4169,7658,9829,61,4,2,2,0,0,0
4170,7659,9837,56,4,2,2,1,1,0
4171,7659,9829,44,8,2,6,2,1,1
4172,7661,10242,42,8,4,4,2,1,1
4173,7661,9847,58,7,3,4,2,1,1
4174,7663,8121,48,4,2,2,1,0,1
4175,7663,9830,52,10,7,3,0,0,0
4176,7665,10249,47,7,4,3,3,2,1
4177,7665,9831,53,2,2,0,2,0,2
4178,7666,8639,60,4,2,2,4,1,3
4179,7666,7794,40,1,0,1,2,1,1
4180,7667,9748,54,9,5,4,2,1,1
4181,7667,9851,46,4,1,3,3,0,3
4182,7669,8689,60,2,1,1,3,0,3
4183,7669,8121,40,8,5,3,0,0,0
4184,7670,10249,56,2,2,0,1,1,0
4185,7670,9853,44,4,1,3,2,1,1
4186,7671,9827,45,4,1,3,2,2,0
4187,7671,7794,55,4,1,3,0,0,0
4188,7673,6391,47,5,2,3,1,1,0
4189,7673,9831,53,4,4,0,2,1,1
4190,7678,9837,75,7,2,5,1,0,1
4191,7678,9747,25,1,0,1,1,0,1
4192,7680,10249,55,4,3,1,3,1,2
4193,7680,9747,45,3,0,3,3,1,2
4194,7682,8689,37,3,1,2,2,1,1
4195,7682,9748,63,6,4,2,0,0,0
4196,7684,6391,56,11,9,2,7,3,4
4197,7684,9853,44,3,2,1,0,0,0
4198,7685,9847,52,4,1,3,2,1,1
4199,7685,9831,48,4,1,3,0,0,0
4200,7687,9837,57,5,1,4,2,0,2
4201,7687,9851,43,3,2,1,0,0,0
4202,7689,8121,51,3,1,2,1,0,1
4203,7689,6391,49,1,0,1,1,0,1
4204,7690,10242,41,4,2,2,3,1,2
4205,7690,9853,59,9,4,5,1,0,1
4206,7692,9829,56,4,2,2,3,3,0
4207,7692,8639,44,2,0,2,0,0,0
4208,7694,9831,42,6,3,3,1,0,1
4209,7694,9851,58,4,0,4,0,0,0
4210,7695,8592,65,5,3,2,3,1,2
4211,7695,9827,35,4,1,3,0,0,0
4212,7696,8689,44,8,3,5,3,1,2
4213,7696,7819,56,5,3,2,1,0,1
4214,7698,9941,52,3,3,0,2,1,1
4215,7698,7794,48,1,0,1,0,0,0
4216,7699,9829,43,4,3,1,3,1,2
4217,7699,8592,57,3,0,3,1,0,1
4218,7701,9827,72,6,3,3,2,1,1
4219,7701,8121,28,1,1,0,1,1,0
4220,7702,9941,41,4,2,2,2,0,2
4221,7702,8689,59,4,3,1,1,0,1
4222,7703,10249,42,5,2,3,1,0,1
4223,7703,9830,58,3,1,2,0,0,0
4224,7705,9831,45,3,0,3,3,0,3
4225,7705,9748,55,3,0,3,0,0,0
4226,7707,9853,53,5,4,1,1,1,0
4227,7707,7794,47,7,4,3,0,0,0
4228,7708,9747,42,6,4,2,3,0,3
4229,7708,9851,58,7,1,6,0,0,0
4230,7709,9853,45,6,2,4,2,1,1
4231,7709,8689,55,3,0,3,1,0,1
4232,7710,9747,57,7,4,3,1,1,0
4233,7710,7819,43,7,2,5,4,4,0
4234,7712,7794,53,6,3,3,2,0,2
4235,7712,6391,47,2,1,1,1,0,1
4236,7713,8121,25,5,4,1,2,1,1
4237,7713,8639,75,4,4,0,0,0,0
4238,7714,10242,58,9,6,3,2,1,1
4239,7714,10249,42,6,3,3,1,0,1
4240,7715,9837,34,5,1,4,4,1,3
4241,7715,9831,66,4,2,2,0,0,0
4242,7717,9829,39,7,3,4,1,1,0
4243,7717,9851,61,5,2,3,3,1,2
4244,7719,8121,52,3,1,2,7,3,4
4245,7719,8592,48,3,0,3,1,1,0
4246,7723,8639,41,7,4,3,5,1,4
4247,7723,8689,59,4,1,3,0,0,0
4248,7724,9830,47,8,3,5,4,1,3
4249,7724,9831,53,2,1,1,0,0,0
4250,7725,6391,33,2,0,2,2,2,0
4251,7725,9748,67,0,0,0,1,1,0
4252,7726,9847,58,10,3,7,1,1,0
4253,7726,9851,42,5,1,4,1,0,1
4254,7728,9837,53,5,2,3,4,1,3
4255,7728,10249,47,4,1,3,1,1,0
4256,7729,9827,53,5,3,2,3,2,1
4257,7729,8689,47,4,3,1,0,0,0
4258,7730,9830,62,7,3,4,1,0,1
4259,7730,7819,38,3,2,1,1,0,1
4260,7731,9847,69,3,0,3,1,0,1
4261,7731,6391,31,3,0,3,1,0,1
4262,7732,8639,69,10,3,7,2,1,1
4263,7732,9747,31,4,3,1,0,0,0
4264,7735,9837,46,7,3,4,3,1,2
4265,7735,8592,54,11,8,3,0,0,0
4266,7738,9941,51,8,3,5,2,2,0
4267,7738,10242,49,2,0,2,1,0,1
4268,7739,9941,53,6,3,3,3,2,1
4269,7739,8121,47,0,0,0,0,0,0
4270,7740,9829,35,6,3,3,2,1,1
4271,7740,10249,65,4,0,4,2,1,1
4272,7741,8639,45,5,2,3,1,0,1
4273,7741,9853,55,7,3,4,0,0,0
4274,7742,9747,36,4,1,3,2,2,0
4275,7742,9831,64,3,1,2,2,1,1
4276,7743,8592,53,7,2,5,1,0,1
4277,7743,10242,47,5,2,3,0,0,0
4278,7747,9837,42,3,2,1,2,1,1
4279,7747,9748,58,3,1,2,2,0,2
4280,7748,7794,40,2,2,0,3,2,1
4281,7748,9851,60,11,6,5,1,0,1
4282,7750,9830,46,5,2,3,3,2,1
4283,7750,9827,54,7,3,4,0,0,0
4284,7751,7819,34,9,6,3,2,1,1
4285,7751,9748,66,2,1,1,1,0,1
4286,7753,8639,51,7,4,3,2,2,0
4287,7753,6391,49,6,2,4,0,0,0
4288,7754,9847,62,9,3,6,1,1,0
4289,7754,9829,38,2,1,1,0,0,0
4290,7755,8689,54,4,3,1,3,2,1
4291,7755,9837,46,7,6,1,0,0,0
4292,7756,9941,48,3,2,1,1,0,1
4293,7756,9851,52,1,0,1,0,0,0
4294,7757,9853,65,10,4,6,1,1,0
4295,7757,7794,35,1,0,1,0,0,0
4296,7758,10249,57,6,4,2,1,0,1
4297,7758,10242,43,6,3,3,0,0,0
4298,7759,9829,49,9,3,6,1,1,0
4299,7759,6391,51,9,4,5,1,0,1
4300,7760,8121,45,3,2,1,4,2,2
4301,7760,8689,55,5,1,4,2,1,1
4302,7761,9748,56,8,3,5,4,2,2
4303,7761,8639,44,4,3,1,3,1,2
4304,7766,9847,71,11,6,5,1,1,0
4305,7766,9827,29,3,0,3,2,2,0
4306,7770,9831,40,4,1,3,4,2,2
4307,7770,7794,60,3,1,2,1,0,1
4308,7774,9748,58,5,2,3,3,1,2
4309,7774,8592,42,6,3,3,2,0,2
4310,7777,8639,48,8,6,2,1,0,1
4311,7777,9851,52,3,2,1,0,0,0
4312,7779,8121,42,4,1,3,4,1,3
4313,7779,9837,58,2,1,1,0,0,0
4314,7780,9851,58,7,3,4,2,2,0
4315,7780,6391,42,3,1,2,2,0,2
4316,7781,9830,35,2,1,1,2,1,1
4317,7781,8639,65,10,8,2,2,2,0
4318,7783,9748,57,6,5,1,1,0,1
4319,7783,7794,43,3,2,1,1,0,1
4320,7784,9829,58,5,2,3,2,0,2
4321,7784,10249,42,6,3,3,0,0,0
4322,7786,9847,71,7,2,5,1,1,0
4323,7786,9747,29,7,5,2,2,0,2
4324,7787,9941,45,2,1,1,1,1,0
4325,7787,8592,55,3,1,2,1,0,1
4326,7790,9827,43,3,2,1,1,1,0
4327,7790,9748,57,5,2,3,0,0,0
4328,7791,7819,49,9,6,3,3,1,2
4329,7791,6391,51,4,2,2,2,0,2
4330,7796,8639,62,6,2,4,1,0,1
4331,7796,9837,38,4,2,2,0,0,0
4332,7800,7819,37,8,6,2,5,3,2
4333,7800,9853,63,5,3,2,1,1,0
4334,7804,9837,57,5,2,3,1,1,0
4335,7804,9748,43,7,4,3,0,0,0
4336,7806,8592,47,7,5,2,5,4,1
4337,7806,9847,53,8,7,1,0,0,0
4338,7807,9747,45,10,4,6,2,2,0
4339,7807,10242,55,6,3,3,0,0,0
4340,7808,9830,41,6,3,3,2,1,1
4341,7808,9831,59,6,3,3,0,0,0
4342,7819,8697,53,6,4,2,8,2,6
4343,7819,8178,47,4,2,2,1,0,1
4344,7831,8697,61,7,5,2,4,1,3
4345,7831,8177,39,1,0,1,2,0,2
4346,7836,9789,56,4,1,3,3,1,2
4347,7836,9790,44,2,2,0,1,0,1
4348,7848,8697,53,5,1,4,1,0,1
4349,7848,8722,47,2,2,0,1,0,1
4350,7855,9790,37,9,4,5,5,2,3
4351,7855,8697,63,6,3,3,0,0,0
4352,7863,8178,61,9,6,3,1,1,0
4353,7863,9823,39,4,2,2,2,0,2
4354,7867,8177,48,8,6,2,3,2,1
4355,7867,8722,52,7,4,3,0,0,0
4356,7872,8226,43,4,3,1,1,1,0
4357,7872,9823,57,2,0,2,2,0,2
4358,7873,10189,60,5,2,3,3,1,2
4359,7873,8177,40,2,0,2,2,0,2
4360,7890,9790,36,6,3,3,1,1,0
4361,7890,9823,64,10,2,8,3,1,2
4362,7891,8178,59,9,2,7,1,1,0
4363,7891,9789,41,4,2,2,2,1,1
4364,7893,8697,71,8,3,5,3,2,1
4365,7893,9912,29,1,0,1,1,0,1
4366,7899,9823,60,14,8,6,1,0,1
4367,7899,9789,40,3,1,2,0,0,0
4368,7909,9789,42,9,4,5,5,3,2
4369,7909,9823,58,3,2,1,0,0,0
4370,7915,9904,63,7,4,3,1,0,1
4371,7915,8398,37,5,2,3,1,0,1
4372,7927,9790,37,4,1,3,1,1,0
4373,7927,8178,63,4,1,3,1,1,0
4374,7945,9911,28,5,2,3,3,2,1
4375,7945,8178,72,11,7,4,0,0,0
4376,7947,10189,52,4,4,0,5,2,3
4377,7947,8722,48,3,1,2,1,0,1
4378,7954,10269,45,7,4,3,4,2,2
4379,7954,8697,55,1,1,0,1,1,0
4380,7969,9911,36,2,2,0,3,2,1
4381,7969,9788,64,10,2,8,0,0,0
4382,7971,8226,62,8,4,4,2,1,1
4383,7971,9790,38,4,0,4,0,0,0
4384,7983,10269,55,11,3,8,3,3,0
4385,7983,9790,45,4,1,3,2,1,1
4386,8006,8226,58,12,5,7,1,1,0
4387,8006,8177,42,3,1,2,1,0,1
4388,8010,10189,42,6,4,2,1,1,0
4389,8010,9911,58,3,1,2,1,0,1
4390,8019,8226,54,5,2,3,1,1,0
4391,8019,8721,46,7,5,2,2,1,1
4392,8023,9904,51,4,4,0,2,2,0
4393,8023,9911,49,7,1,6,1,1,0
4394,8025,8178,71,5,3,2,3,0,3
4395,8025,9912,29,3,1,2,0,0,0
4396,8051,8226,32,5,3,2,3,1,2
4397,8051,9823,68,8,4,4,2,1,1
4398,8054,8721,43,6,1,5,5,2,3
4399,8054,8697,57,8,2,6,1,0,1
4400,8074,9790,67,6,1,5,1,0,1
4401,8074,8721,33,0,0,0,0,0,0
4402,8080,9789,39,4,2,2,3,2,1
4403,8080,10269,61,7,3,4,1,0,1
4404,8084,8722,42,7,4,3,1,1,0
4405,8084,10189,58,1,0,1,4,0,4
4406,8098,9789,31,3,2,1,1,0,1
4407,8098,8697,69,11,3,8,0,0,0
4408,8106,9823,66,5,2,3,1,1,0
4409,8106,8721,34,5,3,2,1,0,1
4410,8107,8178,56,4,2,2,2,0,2
4411,8107,8722,44,7,3,4,0,0,0
4412,8114,9790,57,5,1,4,1,1,0
4413,8114,8226,43,7,5,2,0,0,0
4414,8125,8178,70,5,1,4,1,0,1
4415,8125,9789,30,0,0,0,1,0,1
4416,8126,8177,39,7,4,3,3,3,0
4417,8126,8721,61,5,1,4,0,0,0
4418,8127,10189,55,8,4,4,1,0,1
4419,8127,9790,45,3,2,1,0,0,0
4420,8134,8177,49,5,4,1,4,2,2
4421,8134,9789,51,10,3,7,1,0,1
4422,8136,10189,42,6,1,5,3,1,2
4423,8136,8178,58,3,2,1,0,0,0
4424,8143,8178,55,7,5,2,1,0,1
4425,8143,9810,45,3,3,0,0,0,0
4426,8144,8697,55,7,3,4,2,1,1
4427,8144,9789,45,6,2,4,0,0,0
4428,8151,8178,45,3,2,1,2,1,1
4429,8151,9823,55,4,2,2,1,0,1
4430,8164,9911,45,5,1,4,2,0,2
4431,8164,8722,55,2,2,0,0,0,0
4432,8169,9823,65,9,3,6,8,5,3
4433,8169,9788,35,9,8,1,0,0,0
4434,8173,8177,43,8,2,6,3,3,0
4435,8173,10189,57,6,2,4,1,1,0
4436,8179,8178,67,4,2,2,1,1,0
4437,8179,8177,33,2,2,0,0,0,0
4438,8192,10189,40,9,3,6,2,2,0
4439,8192,9905,60,2,2,0,2,1,1
4440,8196,8226,45,8,4,4,6,3,3
4441,8196,9823,55,9,3,6,0,0,0
4442,8205,9789,51,6,4,2,4,1,3
4443,8205,9790,49,4,1,3,4,0,4
4444,8206,9823,47,6,4,2,1,0,1
4445,8206,8697,53,11,6,5,0,0,0
4446,8208,8721,57,7,2,5,2,2,0
4447,8208,8722,43,4,4,0,4,1,3
4448,8224,8178,61,9,6,3,1,1,0
4449,8224,8358,39,3,2,1,1,0,1
4450,8225,9790,74,12,6,6,3,1,2
4451,8225,8721,26,2,2,0,1,0,1
4452,8226,9789,49,3,2,1,5,3,2
4453,8226,10269,51,2,1,1,0,0,0
4454,8232,9789,56,7,4,3,1,1,0
4455,8232,9810,44,2,2,0,1,0,1
4456,8233,8177,39,1,1,0,2,2,0
4457,8233,8697,61,9,4,5,4,0,4
4458,8245,8722,49,2,2,0,1,1,0
4459,8245,10189,51,2,0,2,1,1,0
4460,8246,8358,45,3,3,0,1,1,0
4461,8246,9810,55,5,3,2,4,3,1
4462,8252,8178,47,5,4,1,2,0,2
4463,8252,8697,53,4,4,0,1,0,1
4464,8259,9823,51,8,5,3,3,0,3
4465,8259,9790,49,3,2,1,0,0,0
4466,8260,8178,60,4,1,3,1,1,0
4467,8260,8722,40,1,1,0,4,2,2
4468,8275,8165,32,4,1,3,4,1,3
4469,8275,8178,68,8,1,7,1,0,1
4470,8278,8178,59,7,4,3,1,0,1
4471,8278,9790,41,3,1,2,2,0,2
4472,8286,9790,54,8,2,6,2,2,0
4473,8286,10189,46,8,4,4,2,0,2
4474,8287,8178,65,6,3,3,1,1,0
4475,8287,9789,35,3,0,3,2,0,2
4476,8295,9823,60,3,1,2,3,2,1
4477,8295,10269,40,7,1,6,2,1,1
4478,8296,8178,68,3,2,1,2,0,2
4479,8296,10189,32,1,0,1,0,0,0
4480,8299,9810,60,5,2,3,3,3,0
4481,8299,9911,40,0,0,0,0,0,0
4482,8322,8178,45,4,3,1,2,1,1
4483,8322,9823,55,2,0,2,0,0,0
4484,8327,10189,63,3,2,1,2,1,1
4485,8327,9904,37,2,1,1,2,0,2
4486,8329,9788,41,5,2,3,2,1,1
4487,8329,9810,59,2,0,2,0,0,0
4488,8331,9823,68,10,5,5,2,1,1
4489,8331,9904,32,1,0,1,2,0,2
4490,8339,8722,44,6,3,3,1,1,0
4491,8339,9911,56,4,2,2,0,0,0
4492,8354,8697,41,2,2,0,1,1,0
4493,8354,10189,59,4,0,4,0,0,0
4494,8358,8697,49,17,10,7,3,2,1
4495,8358,9790,51,5,2,3,1,1,0
4496,8359,9823,79,7,6,1,1,1,0
4497,8359,8177,21,7,3,4,1,0,1
4498,8363,9911,70,9,4,5,4,2,2
4499,8363,9904,30,3,0,3,0,0,0
4500,8364,10189,59,6,2,4,3,1,2
4501,8364,9905,41,8,5,3,1,1,0
4502,8367,9823,52,5,2,3,2,1,1
4503,8367,8721,48,6,1,5,0,0,0
4504,8369,8722,45,5,2,3,3,1,2
4505,8369,9790,55,5,3,2,0,0,0
4506,8375,9788,43,6,1,5,3,1,2
4507,8375,9905,57,2,0,2,0,0,0
4508,8376,10269,45,3,1,2,4,1,3
4509,8376,9790,55,11,2,9,0,0,0
4510,8381,8722,68,6,1,5,4,2,2
4511,8381,10189,32,0,0,0,0,0,0
4512,8386,8178,48,4,2,2,1,1,0
4513,8386,8697,52,1,1,0,3,0,3
4514,8389,8721,52,5,3,2,2,1,1
4515,8389,10189,48,5,0,5,2,1,1
4516,8394,9823,51,5,3,2,3,0,3
4517,8394,9790,49,6,3,3,1,0,1
4518,8398,8358,48,8,7,1,1,0,1
4519,8398,9788,52,3,0,3,0,0,0
4520,8401,8165,62,5,2,3,1,0,1
4521,8401,9911,38,3,2,1,1,0,1
4522,8407,10189,34,5,3,2,2,2,0
4523,8407,9810,66,4,1,3,2,0,2
4524,8412,9790,69,3,2,1,1,1,0
4525,8412,8178,31,3,1,2,5,1,4
4526,8421,9823,71,7,3,4,1,1,0
4527,8421,8721,29,5,1,4,0,0,0
4528,8422,8226,46,4,3,1,1,1,0
4529,8422,8697,54,5,1,4,3,0,3
4530,8427,9790,53,7,4,3,4,2,2
4531,8427,10189,47,5,3,2,3,1,2
4532,8433,10269,47,9,5,4,1,1,0
4533,8433,8721,53,8,5,3,0,0,0
4534,8434,9789,49,5,4,1,4,1,3
4535,8434,9905,51,4,1,3,1,1,0
4536,8435,9904,42,2,1,1,1,0,1
4537,8435,8226,58,6,4,2,0,0,0
4538,8440,8178,66,10,8,2,3,1,2
4539,8440,8350,34,6,3,3,0,0,0
4540,8441,10269,37,6,3,3,3,1,2
4541,8441,8697,63,3,1,2,2,1,1
4542,8446,9789,47,9,3,6,1,1,0
4543,8446,9904,53,2,0,2,2,0,2
4544,8448,8165,48,4,2,2,1,1,0
4545,8448,9823,52,5,2,3,0,0,0
4546,8458,8178,41,8,4,4,1,1,0
4547,8458,9823,59,3,1,2,0,0,0
4548,8465,8152,49,10,3,7,2,1,1
4549,8465,8721,51,1,0,1,0,0,0
4550,8466,9823,72,9,3,6,2,1,1
4551,8466,9810,28,3,1,2,2,1,1
4552,8467,8697,39,5,5,0,4,2,2
4553,8467,8152,61,9,2,7,1,0,1
4554,8472,8722,38,10,6,4,4,3,1
4555,8472,8721,62,3,2,1,4,1,3
4556,8478,8721,58,4,3,1,1,1,0
4557,8478,8697,42,11,2,9,0,0,0
4558,8482,9789,57,9,5,4,3,2,1
4559,8482,8165,43,2,2,0,0,0,0
4560,8484,9823,62,11,4,7,1,1,0
4561,8484,8152,38,3,0,3,1,0,1
4562,8487,9905,56,4,3,1,2,2,0
4563,8487,10189,44,4,2,2,2,1,1
4564,8490,8358,62,8,7,1,1,1,0
4565,8490,9788,38,5,3,2,2,1,1
4566,8495,8358,29,3,2,1,2,1,1
4567,8495,8178,71,6,3,3,1,0,1
4568,8502,10189,41,2,2,0,1,0,1
4569,8502,9790,59,3,2,1,0,0,0
4570,8506,8721,32,3,2,1,2,1,1
4571,8506,9823,68,8,4,4,1,0,1
4572,8513,9810,53,3,3,0,1,0,1
4573,8513,9790,47,3,1,2,0,0,0
4574,8515,8152,38,7,5,2,1,1,0
4575,8515,8226,62,4,1,3,0,0,0
4576,8516,9788,34,8,2,6,2,1,1
4577,8516,8178,66,3,1,2,1,1,0
4578,8517,8722,56,4,1,3,1,1,0
4579,8517,8697,44,2,0,2,1,0,1
4580,8520,10189,69,6,2,4,1,0,1
4581,8520,9904,31,2,1,1,1,0,1
4582,8531,9904,51,4,2,2,3,1,2
4583,8531,8178,49,7,5,2,0,0,0
4584,8532,8358,34,3,3,0,1,1,0
4585,8532,10269,66,6,3,3,1,0,1
4586,8533,9789,36,6,3,3,5,1,4
4587,8533,8721,64,4,2,2,1,0,1
4588,8534,9810,57,4,3,1,3,2,1
4589,8534,9788,43,5,0,5,2,0,2
4590,8536,9905,44,10,3,7,1,1,0
4591,8536,8350,56,11,4,7,1,0,1
4592,8538,9789,59,11,6,5,1,0,1
4593,8538,10189,41,2,0,2,0,0,0
4594,8539,9790,65,15,8,7,2,2,0
4595,8539,8152,35,3,1,2,0,0,0
4596,8544,8358,47,6,3,3,4,2,2
4597,8544,9810,53,2,2,0,0,0,0
4598,8549,8697,59,6,3,3,2,2,0
4599,8549,9904,41,2,0,2,0,0,0
4600,8553,8722,55,6,2,4,2,2,0
4601,8553,9905,45,2,1,1,2,1,1
4602,8556,10269,44,4,3,1,2,2,0
4603,8556,8178,56,4,3,1,1,1,0
4604,8561,9788,34,6,4,2,2,1,1
4605,8561,10189,66,0,0,0,0,0,0
4606,8567,8697,56,8,5,3,9,3,6
4607,8567,8178,44,8,4,4,1,0,1
4608,8580,8697,47,6,2,4,2,1,1
4609,8580,8358,53,1,0,1,4,0,4
4610,8587,8178,52,9,6,3,1,0,1
4611,8587,9905,48,1,1,0,0,0,0
4612,8589,9904,54,5,5,0,3,3,0
4613,8589,8722,46,4,2,2,2,1,1
4614,8593,9905,46,2,1,1,1,1,0
4615,8593,9789,54,3,1,2,1,0,1
4616,8598,8358,32,4,2,2,2,1,1
4617,8598,9823,68,7,0,7,2,0,2
4618,8604,9810,31,4,2,2,4,3,1
4619,8604,8721,69,9,4,5,2,1,1
4620,8606,9790,55,4,2,2,6,2,4
4621,8606,8226,45,8,6,2,0,0,0
4622,8620,9789,55,10,4,6,4,2,2
4623,8620,8721,45,1,0,1,1,1,0
4624,8622,8350,38,8,6,2,1,0,1
4625,8622,9905,62,5,2,3,1,0,1
4626,8623,8226,45,9,5,4,2,2,0
4627,8623,10189,55,4,1,3,6,3,3
4628,8625,8152,60,5,1,4,3,2,1
4629,8625,8722,40,9,5,4,1,0,1
4630,8629,10189,49,7,2,5,2,1,1
4631,8629,8697,51,8,3,5,2,0,2
4632,8633,9905,68,5,3,2,1,1,0
4633,8633,9788,32,5,3,2,3,1,2
4634,8640,8722,67,5,2,3,4,1,3
4635,8640,8721,33,6,3,3,2,0,2
4636,8642,9789,67,10,5,5,3,0,3
4637,8642,9788,33,1,0,1,0,0,0
4638,8644,8165,59,4,2,2,2,1,1
4639,8644,9905,41,2,2,0,0,0,0
4640,8646,9823,54,7,3,4,2,1,1
4641,8646,10189,46,1,0,1,0,0,0
4642,8648,9789,41,5,3,2,3,1,2
4643,8648,8165,59,3,0,3,0,0,0
4644,8656,8697,39,4,3,1,2,1,1
4645,8656,9789,61,4,1,3,2,1,1
4646,8663,9823,53,5,3,2,4,2,2
4647,8663,8152,47,5,2,3,1,0,1
4648,8667,9789,69,8,4,4,2,1,1
4649,8667,9810,31,3,2,1,0,0,0
4650,8673,9823,76,14,5,9,1,1,0
4651,8673,8722,24,5,1,4,0,0,0
4652,8674,9789,47,11,8,3,1,1,0
4653,8674,10189,53,1,0,1,1,0,1
4654,8681,9790,62,2,1,1,3,1,2
4655,8681,8152,38,2,2,0,2,1,1
4656,8683,8350,44,3,1,2,1,0,1
4657,8683,9789,56,8,4,4,3,0,3
4658,8686,8226,22,4,4,0,1,1,0
4659,8686,9823,78,3,2,1,1,0,1
4660,8691,9823,68,7,1,6,4,2,2
4661,8691,9905,32,3,2,1,0,0,0
4662,8703,9790,60,4,1,3,3,1,2
4663,8703,8350,40,2,0,2,1,1,0
4664,8714,8226,68,11,4,7,2,0,2
4665,8714,9788,32,3,3,0,0,0,0
4666,8716,8350,49,6,2,4,2,1,1
4667,8716,9810,51,4,1,3,2,0,2
4668,8719,8226,34,5,2,3,1,1,0
4669,8719,9789,66,3,0,3,0,0,0
4670,8727,9789,59,3,2,1,4,2,2
4671,8727,9790,41,1,0,1,0,0,0
4672,8735,9823,60,10,5,5,1,0,1
4673,8735,9788,40,4,4,0,0,0,0
4674,8736,9789,61,6,3,3,1,0,1
4675,8736,8722,39,2,0,2,1,0,1
4676,8743,8406,30,5,5,0,2,1,1
4677,8743,8697,70,9,4,5,0,0,0
4678,8750,10269,49,10,3,7,5,2,3
4679,8750,9789,51,6,1,5,0,0,0
4680,8751,8406,56,6,2,4,2,1,1
4681,8751,8722,44,0,0,0,1,1,0
4682,8754,9789,53,9,3,6,1,1,0
4683,8754,8721,47,3,1,2,1,0,1
4684,8770,8721,42,6,4,2,2,1,1
4685,8770,9904,58,5,3,2,0,0,0
4686,8778,9788,53,8,2,6,3,2,1
4687,8778,8722,47,5,3,2,1,0,1
4688,8781,8178,45,7,5,2,3,1,2
4689,8781,8226,55,3,2,1,3,1,2
4690,8787,10269,56,9,3,6,2,2,0
4691,8787,8722,44,5,2,3,0,0,0
4692,8789,9788,54,3,2,1,3,1,2
4693,8789,9789,46,5,3,2,1,0,1
4694,8790,8350,40,4,4,0,2,2,0
4695,8790,9789,60,10,4,6,0,0,0
4696,8795,9823,74,7,3,4,2,1,1
4697,8795,10269,26,1,0,1,1,1,0
4698,8798,8177,63,9,7,2,2,2,0
4699,8798,10189,37,3,1,2,2,0,2
4700,8800,9823,62,6,6,0,2,0,2
4701,8800,8722,38,1,0,1,0,0,0
4702,8808,9905,58,4,2,2,2,2,0
4703,8808,8178,42,2,0,2,2,0,2
4704,8810,9789,49,6,2,4,2,1,1
4705,8810,9790,51,1,0,1,1,0,1
4706,8815,8721,56,10,5,5,1,1,0
4707,8815,8722,44,4,4,0,1,1,0
4708,8816,9823,73,10,7,3,2,1,1
4709,8816,9788,27,2,0,2,1,1,0
4710,8823,8722,39,4,1,3,1,1,0
4711,8823,10189,61,5,2,3,2,0,2
4712,8826,8178,57,6,3,3,2,1,1
4713,8826,8697,43,6,2,4,0,0,0
4714,8831,8350,61,9,4,5,2,1,1
4715,8831,8406,39,5,3,2,0,0,0
4716,8840,8350,40,4,2,2,3,0,3
4717,8840,8722,60,6,2,4,0,0,0
4718,8844,9789,51,5,2,3,1,1,0
4719,8844,8178,49,1,0,1,1,0,1
4720,8849,9790,63,9,5,4,1,1,0
4721,8849,8722,37,7,2,5,1,0,1
4722,8851,9788,44,2,1,1,2,1,1
4723,8851,10189,56,2,0,2,0,0,0
4724,8852,8406,53,6,4,2,2,1,1
4725,8852,8165,47,5,0,5,1,1,0
4726,8861,9789,51,8,6,2,2,0,2
4727,8861,8177,49,3,1,2,0,0,0
4728,8862,9904,54,1,1,0,1,1,0
4729,8862,9789,46,7,2,5,2,2,0
4730,8863,9823,46,11,8,3,1,1,0
4731,8863,10189,54,4,3,1,3,0,3
4732,8864,8697,67,10,4,6,1,1,0
4733,8864,8165,33,4,1,3,2,0,2
4734,8867,8178,47,8,3,5,2,2,0
4735,8867,8722,53,7,2,5,1,1,0
4736,8871,9789,53,7,3,4,2,0,2
4737,8871,9905,47,2,0,2,0,0,0
4738,8872,9823,57,8,5,3,1,1,0
4739,8872,8178,43,6,3,3,3,2,1
4740,8880,9823,58,8,4,4,1,1,0
4741,8880,8226,42,1,0,1,2,1,1
4742,8881,9790,56,11,7,4,2,2,0
4743,8881,10189,44,6,5,1,2,1,1
4744,8888,8406,35,2,1,1,4,2,2
4745,8888,9789,65,4,1,3,1,1,0
4746,8889,9789,52,5,3,2,2,1,1
4747,8889,8697,48,2,1,1,4,2,2
4748,8895,10269,32,7,4,3,2,1,1
4749,8895,8226,68,7,2,5,2,1,1
4750,8897,9823,71,8,4,4,2,1,1
4751,8897,8177,29,3,2,1,0,0,0
4752,8907,9789,44,14,9,5,2,0,2
4753,8907,10269,56,1,1,0,0,0,0
4754,8911,8165,54,5,4,1,1,1,0
4755,8911,9823,46,3,0,3,0,0,0
4756,8914,8721,48,4,3,1,1,1,0
4757,8914,8177,52,6,2,4,0,0,0
4758,8918,8178,47,9,3,6,3,2,1
4759,8918,9790,53,6,0,6,3,1,2
4760,8923,8721,43,5,2,3,2,1,1
4761,8923,9789,57,2,1,1,1,1,0
4762,8924,9788,68,5,3,2,2,1,1
4763,8924,8177,32,5,1,4,1,0,1
4764,8926,9823,63,11,6,5,1,1,0
4765,8926,9790,37,2,1,1,1,0,1
4766,8928,9904,38,6,1,5,4,3,1
4767,8928,8177,62,4,0,4,0,0,0
4768,8929,9905,43,7,5,2,1,0,1
4769,8929,10189,57,7,2,5,0,0,0
4770,8931,8722,56,8,5,3,1,1,0
4771,8931,8350,44,7,4,3,1,1,0
4772,8932,8721,49,2,1,1,2,2,0
4773,8932,9788,51,9,5,4,1,0,1
4774,8953,9823,68,4,2,2,1,1,0
4775,8953,8697,32,4,1,3,4,1,3
4776,8955,9905,57,10,6,4,6,4,2
4777,8955,8721,43,4,2,2,0,0,0
4778,8979,8178,41,12,8,4,2,1,1
4779,8979,9789,59,5,2,3,0,0,0
4780,8990,9790,52,4,2,2,2,2,0
4781,8990,8697,48,8,4,4,1,0,1
4782,8996,8178,56,6,3,3,2,1,1
4783,8996,8406,44,7,1,6,1,0,1
4784,8997,8178,66,8,5,3,3,3,0
4785,8997,8722,34,2,0,2,3,0,3
4786,9000,9789,53,7,7,0,1,0,1
4787,9000,9904,47,8,3,5,0,0,0
4788,9003,8350,40,8,4,4,1,0,1
4789,9003,9905,60,4,1,3,0,0,0
4790,9010,9790,45,6,2,4,3,1,2
4791,9010,10269,55,6,4,2,0,0,0
4792,9018,8697,56,6,4,2,2,1,1
4793,9018,9904,44,5,1,4,0,0,0
4794,9021,8350,56,8,2,6,3,0,3
4795,9021,10269,44,3,0,3,0,0,0
4796,9023,8177,36,2,1,1,5,4,1
4797,9023,8722,64,2,1,1,0,0,0
4798,9026,9789,23,5,4,1,1,1,0
4799,9026,8697,77,10,3,7,2,1,1
4800,9028,8358,55,7,5,2,2,2,0
4801,9028,9790,45,5,2,3,2,2,0
4802,9030,8722,36,3,2,1,1,0,1
4803,9030,9904,64,7,3,4,0,0,0
4804,9650,8177,46,6,4,2,3,1,2
4805,9650,8697,54,2,0,2,2,0,2
4806,9651,9810,36,5,2,3,5,3,2
4807,9651,8358,64,9,2,7,0,0,0
4808,9655,8406,41,11,6,5,3,3,0
4809,9655,10189,59,9,2,7,1,0,1
4810,9656,8226,61,7,5,2,1,1,0
4811,9656,9788,39,6,2,4,0,0,0
4812,9658,9904,55,8,3,5,1,0,1
4813,9658,9810,45,5,1,4,0,0,0
4814,9659,10269,55,4,3,1,1,1,0
4815,9659,8721,45,4,0,4,2,0,2
4816,9662,8460,44,5,3,2,1,0,1
4817,9662,8177,56,3,2,1,1,0,1
4818,9665,9790,56,7,3,4,3,2,1
4819,9665,8721,44,7,4,3,2,1,1
4820,9666,8406,56,4,3,1,2,1,1
4821,9666,8460,44,6,5,1,1,1,0
4822,9668,9904,48,4,3,1,2,0,2
4823,9668,8177,52,2,2,0,1,0,1
4824,9670,9823,61,11,4,7,3,1,2
4825,9670,9810,39,3,2,1,1,0,1
4826,9672,9823,57,6,2,4,3,2,1
4827,9672,8226,43,6,3,3,1,1,0
4828,9674,9788,61,4,2,2,3,2,1
4829,9674,9810,39,11,4,7,1,1,0
4830,9675,8358,38,6,2,4,1,1,0
4831,9675,9905,62,2,1,1,0,0,0
4832,9676,9904,54,6,4,2,1,1,0
4833,9676,8178,46,6,1,5,3,0,3
4834,9677,10269,42,3,1,2,3,2,1
4835,9677,8406,58,10,3,7,1,0,1
4836,9678,9790,55,5,3,2,3,1,2
4837,9678,8697,45,8,4,4,3,2,1
4838,9680,8460,38,2,1,1,2,2,0
4839,9680,9789,62,4,1,3,1,0,1
4840,9682,8178,54,13,8,5,3,0,3
4841,9682,8722,46,0,0,0,1,0,1
4842,9683,9788,60,7,5,2,3,1,2
4843,9683,8721,40,13,5,8,1,0,1
4844,9684,8406,48,5,3,2,1,0,1
4845,9684,9790,52,3,0,3,1,0,1
4846,9685,8226,34,4,1,3,2,1,1
4847,9685,9904,66,2,1,1,1,1,0
4848,9686,9823,70,6,4,2,1,1,0
4849,9686,8177,30,1,0,1,5,2,3
4850,9689,8358,57,10,6,4,1,1,0
4851,9689,10269,43,8,2,6,1,0,1
4852,9690,8178,46,1,1,0,2,1,1
4853,9690,9823,54,6,2,4,1,0,1
4854,9691,9789,57,12,3,9,2,2,0
4855,9691,8226,43,4,2,2,0,0,0
4856,9692,8177,57,4,2,2,1,1,0
4857,9692,9788,43,9,4,5,0,0,0
4858,9697,8722,38,6,4,2,4,2,2
4859,9697,8406,62,3,1,2,1,1,0
4860,9705,8177,34,2,2,0,1,1,0
4861,9705,9789,66,7,1,6,0,0,0
4862,9707,9790,41,5,2,3,2,1,1
4863,9707,8358,59,5,1,4,3,1,2
4864,9708,9823,74,15,7,8,1,0,1
4865,9708,8358,26,1,0,1,0,0,0
4866,9709,8721,66,6,4,2,1,1,0
4867,9709,9789,34,8,1,7,3,2,1
4868,9710,8697,46,5,3,2,1,1,0
4869,9710,9788,54,4,0,4,2,1,1
4870,9713,9810,67,8,1,7,3,1,2
4871,9713,8177,33,1,0,1,0,0,0
4872,9714,10269,31,7,5,2,3,1,2
4873,9714,9790,69,4,0,4,0,0,0
4874,9716,10189,49,9,4,5,2,1,1
4875,9716,8460,51,6,1,5,3,0,3
4876,9718,8178,60,9,2,7,1,1,0
4877,9718,9810,40,5,4,1,3,1,2
4878,9720,9823,64,7,2,5,1,1,0
4879,9720,9905,36,5,2,3,1,0,1
4880,9721,9788,62,7,2,5,1,1,0
4881,9721,8406,38,10,3,7,0,0,0
4882,9723,8697,38,4,3,1,3,1,2
4883,9723,9789,62,8,3,5,0,0,0
4884,9727,8178,56,5,5,0,1,0,1
4885,9727,9789,44,3,2,1,1,0,1
4886,9733,9788,55,2,2,0,2,0,2
4887,9733,10269,45,4,3,1,1,0,1
4888,9735,10189,47,4,4,0,2,1,1
4889,9735,9823,53,2,1,1,0,0,0
4890,9736,8406,46,2,1,1,1,1,0
4891,9736,9789,54,9,2,7,1,0,1
4892,9737,9788,26,4,4,0,2,1,1
4893,9737,8358,74,9,8,1,2,1,1
4894,9738,8697,36,5,2,3,1,1,0
4895,9738,8226,64,5,3,2,1,0,1
4896,9739,9904,52,4,1,3,3,2,1
4897,9739,9905,48,9,2,7,0,0,0
4898,9741,8721,59,3,2,1,1,1,0
4899,9741,9810,41,6,1,5,1,0,1
4900,9743,8460,57,7,5,2,4,2,2
4901,9743,9790,43,3,1,2,2,0,2
4902,9744,9823,60,4,3,1,1,1,0
4903,9744,10189,40,3,0,3,0,0,0
4904,9745,8178,54,7,6,1,2,1,1
4905,9745,8177,46,1,1,0,0,0,0
4906,9747,9904,49,8,4,4,2,2,0
4907,9747,9905,51,4,0,4,0,0,0
4908,9748,9789,42,12,6,6,3,2,1
4909,9748,8406,58,3,0,3,2,1,1
4910,9749,8226,47,5,3,2,3,1,2
4911,9749,8697,53,4,3,1,1,0,1
4912,9750,9788,43,3,3,0,2,1,1
4913,9750,8358,57,5,2,3,1,0,1
4914,9751,10269,42,9,4,5,1,1,0
4915,9751,8722,58,1,1,0,4,0,4
4916,9752,8460,58,3,3,0,1,1,0
4917,9752,9790,42,3,1,2,1,0,1
4918,9755,9905,61,3,1,2,1,0,1
4919,9755,8177,39,3,1,2,1,0,1
4920,9756,9810,53,4,2,2,1,1,0
4921,9756,8406,47,5,3,2,3,0,3
4922,9757,8697,39,3,2,1,2,0,2
4923,9757,8178,61,5,3,2,0,0,0
4924,9759,10269,33,1,1,0,1,1,0
4925,9759,9823,67,2,0,2,1,0,1
4926,9762,9823,70,12,6,6,1,1,0
4927,9762,9790,30,3,1,2,2,1,1
4928,9763,9789,49,8,5,3,2,1,1
4929,9763,9905,51,2,1,1,2,0,2
4930,9765,9788,82,15,6,9,2,1,1
4931,9765,8722,18,6,4,2,2,1,1
4932,9769,8697,41,6,4,2,1,1,0
4933,9769,8406,59,3,0,3,0,0,0
4934,9770,9810,53,3,2,1,3,2,1
4935,9770,10189,47,7,3,4,1,0,1
4936,9774,8178,43,10,5,5,2,1,1
4937,9774,8406,57,8,2,6,1,0,1
4938,9776,9789,47,6,4,2,5,1,4
4939,9776,10269,53,0,0,0,0,0,0
4940,9779,8460,25,4,2,2,2,0,2
4941,9779,9823,75,6,2,4,0,0,0
4942,9780,9823,62,11,6,5,2,1,1
4943,9780,8722,38,5,1,4,1,1,0
4944,9785,9904,54,6,4,2,5,2,3
4945,9785,10269,46,1,0,1,1,0,1
4946,9787,8721,56,3,3,0,4,2,2
4947,9787,8697,44,5,2,3,1,1,0
4948,9789,8226,54,6,3,3,3,2,1
4949,9789,10189,46,4,3,1,1,1,0
4950,9790,9905,48,7,2,5,3,1,2
4951,9790,9788,52,2,0,2,0,0,0
4952,9792,9823,74,3,1,2,2,1,1
4953,9792,9904,26,0,0,0,0,0,0
4954,9795,9790,36,2,1,1,3,1,2
4955,9795,9789,64,4,3,1,3,1,2
4956,9796,8722,44,2,1,1,2,0,2
4957,9796,9810,56,4,0,4,1,0,1
4958,9797,8178,58,3,1,2,1,0,1
4959,9797,8460,42,6,3,3,1,0,1
4960,9798,9789,67,5,2,3,3,2,1
4961,9798,8722,33,4,2,2,1,1,0
4962,9801,9788,52,11,6,5,2,1,1
4963,9801,9904,48,3,1,2,0,0,0
4964,9802,9905,35,8,4,4,1,1,0
4965,9802,8406,65,4,1,3,3,1,2
4966,9803,8226,63,8,2,6,1,1,0
4967,9803,9790,37,6,1,5,0,0,0
4968,9804,10189,57,5,2,3,2,0,2
4969,9804,8177,43,8,1,7,1,0,1
4970,9805,9823,63,4,4,0,1,1,0
4971,9805,8697,37,4,1,3,0,0,0
4972,9807,9823,63,11,6,5,3,1,2
4973,9807,9788,37,2,0,2,0,0,0
4974,9808,10189,55,6,2,4,5,1,4
4975,9808,8178,45,9,5,4,0,0,0
4976,9809,9905,40,8,2,6,1,0,1
4977,9809,8721,60,2,0,2,1,0,1
4978,9810,9789,49,5,2,3,2,1,1
4979,9810,9904,51,7,3,4,2,2,0
4980,9812,9810,57,6,3,3,2,0,2
4981,9812,10269,43,2,0,2,2,0,2
4982,9814,8697,39,4,2,2,2,1,1
4983,9814,8722,61,4,1,3,2,0,2
4984,9817,8178,49,8,2,6,1,1,0
4985,9817,9790,51,1,0,1,2,0,2
4986,9818,10269,39,5,3,2,2,1,1
4987,9818,8721,61,10,4,6,2,1,1
4988,9819,8406,45,9,3,6,1,0,1
4989,9819,10189,55,6,1,5,0,0,0
4990,9821,8177,44,4,1,3,1,0,1
4991,9821,8460,56,3,0,3,0,0,0
4992,9822,8697,47,5,2,3,3,1,2
4993,9822,9905,53,8,2,6,1,1,0
4994,9823,9904,56,10,4,6,1,0,1
4995,9823,9810,44,6,2,4,2,0,2
4996,9824,8722,60,7,1,6,3,0,3
4997,9824,8358,40,5,2,3,0,0,0
4998,9825,9823,59,9,6,3,3,2,1
4999,9825,9810,41,1,1,0,0,0,0
5000,9826,10189,61,11,1,10,1,1,0
5001,9826,8358,39,6,2,4,0,0,0
5002,9829,9904,62,4,2,2,1,1,0
5003,9829,8177,38,5,2,3,2,1,1
5004,9831,8721,59,9,4,5,3,3,0
5005,9831,9790,41,0,0,0,3,0,3
5006,9835,8178,51,13,9,4,2,2,0
5007,9835,9904,49,2,1,1,2,0,2
5008,9837,10269,48,8,4,4,2,0,2
5009,9837,8406,52,4,2,2,0,0,0
5010,9838,8226,30,3,3,0,2,2,0
5011,9838,9823,70,13,3,10,2,0,2
5012,9839,8177,48,5,2,3,1,1,0
5013,9839,8722,52,3,1,2,1,0,1
5014,9841,9788,52,6,3,3,5,2,3
5015,9841,9810,48,9,5,4,1,0,1
5016,9843,9823,62,5,3,2,5,2,3
5017,9843,10269,38,1,0,1,3,2,1
5018,9844,8358,44,2,1,1,2,2,0
5019,9844,9789,56,3,2,1,2,0,2
5020,9845,8178,52,12,8,4,1,1,0
5021,9845,8697,48,2,0,2,2,1,1
5022,9848,9904,48,3,1,2,1,0,1
5023,9848,9790,52,3,1,2,0,0,0
5024,9849,9905,42,2,2,0,1,1,0
5025,9849,8177,58,9,5,4,3,1,2
5026,9851,8460,45,5,4,1,1,1,0
5027,9851,8722,55,1,0,1,0,0,0
5028,9855,10189,64,6,4,2,1,1,0
5029,9855,9905,36,2,1,1,0,0,0
5030,9856,9904,47,5,3,2,2,2,0
5031,9856,8226,53,3,1,2,1,1,0
5032,9857,10269,29,3,2,1,3,2,1
5033,9857,8358,71,8,2,6,1,0,1
5034,9862,9823,56,7,3,4,2,1,1
5035,9862,8178,44,9,4,5,3,2,1
5036,9863,9904,38,8,2,6,1,0,1
5037,9863,8721,62,9,4,5,0,0,0
5038,9864,9905,61,3,2,1,3,2,1
5039,9864,9790,39,7,2,5,1,1,0
5040,9866,8226,53,4,3,1,1,1,0
5041,9866,9789,47,5,1,4,0,0,0
5042,9867,9788,69,6,3,3,3,2,1
5043,9867,8177,31,4,1,3,0,0,0
5044,9869,8460,43,5,4,1,6,4,2
5045,9869,8358,57,9,5,4,2,1,1
5046,9870,8406,30,3,2,1,3,1,2
5047,9870,9823,70,6,3,3,4,2,2
5048,9871,9789,43,7,3,4,2,2,0
5049,9871,8177,57,2,0,2,1,1,0
5050,9872,8178,63,6,4,2,4,1,3
5051,9872,9788,37,4,3,1,1,0,1
5052,9873,8697,49,4,3,1,3,1,2
5053,9873,9904,51,2,0,2,0,0,0
5054,9876,9790,58,9,3,6,2,0,2
5055,9876,8358,42,9,3,6,0,0,0
5056,9877,10189,56,2,2,0,1,1,0
5057,9877,8722,44,3,1,2,3,1,2
5058,9881,9789,52,9,5,4,4,4,0
5059,9881,8721,48,7,3,4,2,0,2
5060,9885,8697,40,10,5,5,1,1,0
5061,9885,9788,60,5,4,1,3,2,1
5062,9887,10269,42,11,5,6,2,1,1
5063,9887,9790,58,3,2,1,0,0,0
5064,9890,9788,34,5,3,2,1,0,1
5065,9890,8406,66,3,0,3,2,0,2
5066,9892,9904,33,8,3,5,1,1,0
5067,9892,8358,67,4,2,2,2,1,1
5068,9893,8178,63,10,5,5,1,1,0
5069,9893,9810,37,2,1,1,1,0,1
5070,9894,9790,44,6,3,3,3,1,2
5071,9894,10189,56,6,2,4,1,1,0
5072,9895,8722,36,4,4,0,3,1,2
5073,9895,8721,64,3,1,2,0,0,0
5074,9896,10269,42,5,3,2,5,2,3
5075,9896,8460,58,5,1,4,1,1,0
5076,9897,9810,51,6,2,4,3,1,2
5077,9897,10189,49,2,2,0,0,0,0
5078,9898,8178,33,5,3,2,3,2,1
5079,9898,8721,67,7,3,4,0,0,0
5080,9900,8406,48,5,3,2,3,1,2
5081,9900,8697,52,5,2,3,0,0,0
5082,9901,8358,49,9,4,5,3,2,1
5083,9901,8177,51,4,2,2,3,1,2
5084,9902,10269,62,4,2,2,2,1,1
5085,9902,8226,38,4,0,4,1,0,1
5086,9904,9788,58,4,2,2,4,2,2
5087,9904,8722,42,7,3,4,2,1,1
5088,9905,8460,40,8,3,5,1,1,0
5089,9905,9904,60,8,3,5,1,0,1
5090,9908,8406,59,5,1,4,2,2,0
5091,9908,8178,41,3,0,3,0,0,0
5092,9909,9788,44,14,3,11,5,1,4
5093,9909,9790,56,5,2,3,1,1,0
5094,9910,8226,66,6,2,4,1,1,0
5095,9910,8358,34,2,1,1,0,0,0
5096,9916,8697,42,5,1,4,1,1,0
5097,9916,8721,58,9,4,5,1,0,1
5098,9919,8358,62,5,3,2,3,2,1
5099,9919,8178,38,7,1,6,1,0,1
5100,9921,9790,66,9,4,5,2,0,2
5101,9921,9810,34,3,1,2,0,0,0
5102,9922,9823,75,12,6,6,1,0,1
5103,9922,8722,25,4,2,2,0,0,0
5104,9924,9823,68,8,3,5,2,1,1
5105,9924,9904,32,3,1,2,0,0,0
5106,9927,8406,49,2,2,0,2,0,2
5107,9927,8721,51,5,1,4,0,0,0
5108,9928,9788,63,11,3,8,1,0,1
5109,9928,9905,37,3,2,1,1,0,1
5110,9929,8226,47,12,7,5,1,0,1
5111,9929,10189,53,4,4,0,0,0,0
5112,9930,10269,72,4,2,2,2,2,0
5113,9930,8177,28,7,7,0,1,0,1
5114,9933,9823,72,7,3,4,1,0,1
5115,9933,8697,28,0,0,0,0,0,0
5116,9934,8177,52,9,4,5,1,1,0
5117,9934,10189,48,2,0,2,0,0,0
5118,9935,9905,41,6,5,1,3,2,1
5119,9935,8406,59,8,2,6,2,0,2
5120,9937,8358,48,9,5,4,1,1,0
5121,9937,8721,52,9,4,5,0,0,0
5122,9938,10269,54,4,2,2,3,1,2
5123,9938,8178,46,4,1,3,1,0,1
5124,9942,9789,53,5,2,3,1,0,1
5125,9942,9904,47,2,0,2,0,0,0
5126,9943,8178,49,13,7,6,2,1,1
5127,9943,10189,51,3,2,1,2,2,0
5128,9944,9905,45,8,4,4,2,1,1
5129,9944,8721,55,7,3,4,3,0,3
5130,9945,9823,64,13,5,8,1,0,1
5131,9945,9788,36,6,1,5,0,0,0
5132,9946,8406,36,7,2,5,2,1,1
5133,9946,8358,64,6,4,2,1,1,0
5134,9948,9790,58,4,1,3,1,0,1
5135,9948,8177,42,4,3,1,0,0,0
5136,9952,9788,40,2,1,1,2,0,2
5137,9952,9789,60,5,4,1,1,0,1
5138,9953,8178,53,12,6,6,2,1,1
5139,9953,8226,47,2,1,1,5,0,5
5140,9954,9810,36,7,1,6,4,3,1
5141,9954,8721,64,2,0,2,2,1,1
5142,9958,9905,62,7,5,2,3,2,1
5143,9958,8234,38,5,3,2,3,0,3
5144,9959,9904,58,4,3,1,3,2,1
5145,9959,8262,42,4,2,2,0,0,0
5146,9963,9788,52,8,4,4,2,1,1
5147,9963,10189,48,8,1,7,1,1,0
5148,9966,9905,59,8,3,5,1,0,1
5149,9966,8697,41,5,1,4,0,0,0
5150,9967,8234,57,6,2,4,1,0,1
5151,9967,8177,43,0,0,0,0,0,0
5152,9968,8721,66,7,3,4,2,1,1
5153,9968,8262,34,3,0,3,2,0,2
5154,9971,9790,63,7,2,5,1,1,0
5155,9971,9904,37,1,1,0,0,0,0
5156,9972,8262,47,6,2,4,2,2,0
5157,9972,10269,53,5,1,4,0,0,0
5158,9975,9823,68,2,1,1,1,1,0
5159,9975,9810,32,1,0,1,2,0,2
5160,9976,8226,44,7,4,3,2,1,1
5161,9976,8722,56,6,1,5,0,0,0
5162,9979,9789,59,6,1,5,3,2,1
5163,9979,10189,41,3,0,3,4,4,0
5164,9980,8722,51,8,3,5,1,0,1
5165,9980,8178,49,7,5,2,0,0,0
5166,9981,8234,43,4,1,3,1,1,0
5167,9981,9788,57,9,4,5,1,1,0
5168,9982,8697,39,7,2,5,1,1,0
5169,9982,8406,61,11,6,5,4,3,1
5170,9983,8177,42,4,4,0,2,1,1
5171,9983,9904,58,5,1,4,1,0,1
5172,9984,9810,47,12,6,6,1,0,1
5173,9984,8226,53,4,3,1,0,0,0
5174,9991,10269,64,9,5,4,4,2,2
5175,9991,8406,36,7,4,3,0,0,0
5176,9992,8178,51,8,5,3,1,1,0
5177,9992,9810,49,4,1,3,2,0,2
5178,9993,8722,54,3,0,3,1,0,1
5179,9993,9905,46,1,0,1,0,0,0
5180,9994,8226,51,1,1,0,2,1,1
5181,9994,8177,49,0,0,0,1,0,1
5182,9995,8234,54,5,2,3,1,0,1
5183,9995,8262,46,3,2,1,0,0,0
5184,9999,8721,58,9,5,4,2,0,2
5185,9999,8406,42,7,4,3,1,0,1
5186,10000,9790,44,7,3,4,2,1,1
5187,10000,8697,56,7,4,3,0,0,0
5188,10002,9788,65,10,7,3,2,1,1
5189,10002,8226,35,8,2,6,0,0,0
5190,10003,9810,44,6,3,3,2,1,1
5191,10003,9905,56,7,3,4,2,0,2
5192,10004,8722,65,6,3,3,2,1,1
5193,10004,8262,35,1,0,1,0,0,0
5194,10005,10189,51,12,7,5,1,1,0
5195,10005,9904,49,2,1,1,0,0,0
5196,10008,9790,52,8,4,4,3,2,1
5197,10008,9905,48,4,1,3,3,0,3
5198,10011,8406,42,9,6,3,2,0,2
5199,10011,8722,58,10,4,6,0,0,0
5200,10012,8177,55,5,4,1,2,1,1
5201,10012,8178,45,3,1,2,0,0,0
5202,10015,9789,76,10,6,4,3,1,2
5203,10015,9810,24,1,1,0,0,0,0
5204,10017,9790,36,3,3,0,3,2,1
5205,10017,8721,64,11,3,8,0,0,0
5206,10018,8406,42,10,6,4,2,1,1
5207,10018,10189,58,6,5,1,0,0,0
5208,10020,8226,44,5,2,3,1,1,0
5209,10020,9904,56,5,1,4,0,0,0
5210,10021,9905,51,5,3,2,4,1,3
5211,10021,10269,49,7,4,3,1,0,1
5212,10022,8262,40,3,1,2,4,2,2
5213,10022,8177,60,1,0,1,1,1,0
5214,10023,10189,43,8,3,5,2,1,1
5215,10023,8226,57,6,2,4,1,1,0
5216,10024,8262,51,7,2,5,4,2,2
5217,10024,9788,49,6,3,3,2,1,1
5218,10025,8406,46,6,2,4,1,0,1
5219,10025,9790,54,7,3,4,3,0,3
5220,10026,10269,21,3,2,1,2,0,2
5221,10026,8721,79,10,4,6,0,0,0
5222,10027,9810,47,6,2,4,3,2,1
5223,10027,8697,53,6,3,3,2,1,1
5224,10030,8177,51,2,1,1,6,3,3
5225,10030,9905,49,1,0,1,1,0,1
5226,10034,9790,30,4,1,3,1,1,0
5227,10034,9823,70,3,0,3,0,0,0
5228,10035,8721,53,12,4,8,3,2,1
5229,10035,9810,47,5,1,4,0,0,0
5230,10036,10269,45,8,4,4,4,1,3
5231,10036,8722,55,5,2,3,1,0,1
5232,10038,8406,48,7,5,2,1,0,1
5233,10038,8177,52,4,3,1,0,0,0
5234,10039,8226,38,1,1,0,2,1,1
5235,10039,8178,62,8,2,6,2,0,2
5236,10040,8234,40,4,4,0,2,0,2
5237,10040,9905,60,4,3,1,0,0,0
5238,10043,8178,53,5,3,2,3,1,2
5239,10043,9904,47,3,1,2,1,1,0
5240,10044,8721,59,6,5,1,2,1,1
5241,10044,8722,41,3,0,3,1,0,1
5242,10045,10269,51,12,3,9,1,0,1
5243,10045,9790,49,5,0,5,3,0,3
5244,10046,8406,51,4,3,1,1,0,1
5245,10046,9810,49,9,0,9,1,0,1
5246,10049,10189,64,6,0,6,2,1,1
5247,10049,8262,36,2,0,2,3,0,3
5248,10050,8262,30,3,3,0,1,1,0
5249,10050,10189,70,7,4,3,0,0,0
5250,10051,9788,65,7,4,3,4,3,1
5251,10051,9905,35,4,2,2,3,1,2
5252,10053,8406,46,5,1,4,3,1,2
5253,10053,9810,54,3,2,1,0,0,0
5254,10059,10189,37,2,2,0,3,1,2
5255,10059,8721,63,6,3,3,3,2,1
5256,10062,8722,47,8,2,6,2,1,1
5257,10062,9790,53,4,1,3,1,0,1
5258,10063,9810,64,8,6,2,3,1,2
5259,10063,10269,36,6,5,1,2,0,2
5260,10064,9905,46,3,2,1,2,1,1
5261,10064,9904,54,3,0,3,2,1,1
5262,10066,8226,62,4,2,2,1,0,1
5263,10066,8262,38,2,0,2,1,0,1
5264,10069,8721,35,4,4,0,2,0,2
5265,10069,8234,65,4,1,3,0,0,0
5266,10070,9788,59,5,1,4,3,2,1
5267,10070,9790,41,6,4,2,1,0,1
5268,10072,9823,80,10,5,5,1,1,0
5269,10072,8406,20,1,0,1,1,0,1
5270,10075,9905,44,5,1,4,2,2,0
5271,10075,10189,56,4,1,3,0,0,0
5272,10077,9823,77,20,11,9,1,1,0
5273,10077,8262,23,4,2,2,0,0,0
5274,10078,10269,56,11,6,5,2,1,1
5275,10078,10189,44,6,3,3,1,0,1
5276,10081,9810,47,2,1,1,4,1,3
5277,10081,9790,53,3,2,1,0,0,0
5278,10083,8177,44,5,2,3,5,4,1
5279,10083,8721,56,7,0,7,3,0,3
5280,10086,8226,29,5,2,3,5,2,3
5281,10086,9789,71,11,2,9,1,0,1
5282,10087,8721,38,8,5,3,3,1,2
5283,10087,9823,62,4,1,3,1,0,1
5284,10088,8234,47,6,4,2,4,3,1
5285,10088,9790,53,2,2,0,3,1,2
5286,10089,9904,35,8,4,4,3,2,1
5287,10089,10269,65,10,4,6,0,0,0
5288,10090,9788,48,5,4,1,3,2,1
5289,10090,8406,52,11,6,5,1,1,0
5290,10091,8262,39,2,1,1,4,3,1
5291,10091,8697,61,10,0,10,3,2,1
5292,10093,8177,45,7,5,2,2,1,1
5293,10093,8722,55,7,3,4,1,0,1
5294,10094,9905,34,5,4,1,3,1,2
5295,10094,8178,66,3,2,1,0,0,0
5296,10095,9823,77,9,4,5,2,0,2
5297,10095,9905,23,1,1,0,0,0,0
5298,10099,9904,42,4,2,2,2,1,1
5299,10099,8721,58,9,4,5,1,1,0
5300,10100,9810,52,6,3,3,3,3,0
5301,10100,8177,48,4,3,1,0,0,0
5302,10101,8226,54,6,1,5,1,0,1
5303,10101,8406,46,2,2,0,0,0,0
5304,10107,10269,31,10,8,2,4,2,2
5305,10107,8226,69,7,4,3,3,0,3
5306,10109,9904,54,6,4,2,1,1,0
5307,10109,8697,46,4,3,1,0,0,0
5308,10111,10189,45,5,4,1,2,0,2
5309,10111,8722,55,8,4,4,0,0,0
5310,10116,9788,53,6,3,3,1,1,0
5311,10116,9810,47,0,0,0,0,0,0
5312,10119,8721,66,11,5,6,2,0,2
5313,10119,8226,34,2,1,1,0,0,0
5314,10120,10269,53,5,4,1,2,0,2
5315,10120,8234,47,6,2,4,2,0,2
5316,10122,10189,32,3,3,0,1,1,0
5317,10122,9788,68,13,7,6,0,0,0
5318,10123,8262,27,4,2,2,6,3,3
5319,10123,8721,73,5,2,3,2,1,1
5320,10124,8226,38,6,4,2,5,3,2
5321,10124,9790,62,11,2,9,1,0,1
5322,10125,8178,44,9,4,5,1,1,0
5323,10125,10269,56,5,2,3,2,1,1
5324,10126,8406,29,4,3,1,3,2,1
5325,10126,9789,71,5,2,3,4,2,2
5326,10129,9823,77,3,1,2,3,1,2
5327,10129,8722,23,2,0,2,0,0,0
5328,10130,8234,49,3,1,2,2,1,1
5329,10130,8177,51,1,1,0,0,0,0
5330,10131,9823,73,11,4,7,2,2,0
5331,10131,9810,27,0,0,0,1,0,1
5332,10133,8721,54,8,3,5,1,1,0
5333,10133,8178,46,3,2,1,0,0,0
5334,10134,8177,51,2,1,1,4,2,2
5335,10134,9788,49,5,2,3,0,0,0
5336,10136,8226,57,7,1,6,2,1,1
5337,10136,8722,43,0,0,0,1,0,1
5338,10139,10269,65,2,1,1,1,0,1
5339,10139,8262,35,5,1,4,2,0,2
5340,10140,9789,49,6,2,4,1,1,0
5341,10140,10189,51,4,0,4,1,0,1
5342,10143,9823,72,5,2,3,2,1,1
5343,10143,10269,28,2,2,0,1,1,0
5344,10144,8697,55,10,6,4,1,0,1
5345,10144,8406,45,2,0,2,0,0,0
5346,10147,9904,40,3,1,2,2,2,0
5347,10147,8177,60,9,4,5,0,0,0
5348,10148,8234,53,9,5,4,2,1,1
5349,10148,9788,47,3,1,2,3,1,2
5350,10153,8234,29,7,5,2,4,1,3
5351,10153,8406,71,4,1,3,1,0,1
5352,10154,9788,58,5,2,3,4,3,1
5353,10154,8697,42,7,4,3,2,1,1
5354,10155,9790,53,8,4,4,1,1,0
5355,10155,8722,47,1,0,1,0,0,0
5356,10158,10189,42,8,3,5,3,1,2
5357,10158,9823,58,6,2,4,1,0,1
5358,10159,9790,22,2,2,0,2,1,1
5359,10159,9789,78,5,2,3,1,0,1
5360,10161,10269,60,4,2,2,4,2,2
5361,10161,8406,40,7,2,5,1,0,1
5362,10164,8177,37,4,1,3,1,1,0
5363,10164,8226,63,9,6,3,1,0,1
5364,10167,10189,53,7,3,4,2,0,2
5365,10167,8178,47,5,2,3,2,0,2
5366,10170,9790,42,6,4,2,1,0,1
5367,10170,8697,58,9,2,7,0,0,0
5368,10174,8177,27,5,4,1,1,0,1
5369,10174,9823,73,4,3,1,3,0,3
5370,10175,9904,76,2,0,2,1,0,1
5371,10175,8234,24,1,0,1,3,0,3
5372,10176,9823,60,4,3,1,3,3,0
5373,10176,9788,40,2,1,1,3,1,2
5374,10177,8721,35,3,2,1,1,1,0
5375,10177,9789,65,8,0,8,1,1,0
5376,10180,8697,44,7,1,6,4,2,2
5377,10180,10269,56,4,1,3,2,1,1
5378,10184,8262,33,4,1,3,1,1,0
5379,10184,9810,67,2,1,1,4,1,3
5380,10186,9788,56,6,3,3,2,0,2
5381,10186,8178,44,8,1,7,0,0,0
5382,10187,9790,44,1,1,0,1,1,0
5383,10187,8721,56,5,1,4,2,0,2
5384,10188,10269,53,4,2,2,2,0,2
5385,10188,9905,47,10,3,7,0,0,0
5386,10189,9810,17,2,1,1,3,2,1
5387,10189,9789,83,12,6,6,1,1,0
5388,10191,9904,43,8,5,3,3,1,2
5389,10191,8226,57,8,5,3,0,0,0
5390,10193,8234,48,6,5,1,2,2,0
5391,10193,9823,52,4,2,2,3,3,0
5392,10194,9823,59,8,4,4,2,2,0
5393,10194,9904,41,6,3,3,1,0,1
5394,10196,8234,57,4,2,2,2,2,0
5395,10196,8178,43,4,0,4,2,0,2
5396,10199,9810,30,2,2,0,2,1,1
5397,10199,8697,70,5,2,3,2,0,2
5398,10204,10189,56,10,6,4,2,1,1
5399,10204,9905,44,7,2,5,1,0,1
5400,10205,8262,24,1,1,0,4,1,3
5401,10205,8178,76,6,2,4,1,0,1
5402,10206,9790,41,2,1,1,2,1,1
5403,10206,9788,59,7,6,1,0,0,0
5404,10207,9810,40,8,4,4,2,1,1
5405,10207,8722,60,7,2,5,2,0,2
5406,10208,9789,74,6,3,3,1,1,0
5407,10208,9904,26,3,1,2,3,2,1
5408,10209,8177,52,5,2,3,1,1,0
5409,10209,10269,48,5,4,1,2,2,0
5410,10210,8697,40,6,2,4,1,1,0
5411,10210,8226,60,5,1,4,2,0,2
5412,10211,8721,73,8,2,6,1,0,1
5413,10211,8234,27,4,3,1,0,0,0
5414,10212,9789,51,11,4,7,2,1,1
5415,10212,8178,49,4,1,3,0,0,0
5416,10213,8721,55,3,1,2,1,1,0
5417,10213,8177,45,4,4,0,1,0,1
5418,10214,9810,51,5,1,4,1,0,1
5419,10214,9790,49,2,2,0,2,0,2
5420,10219,9905,49,5,2,3,4,3,1
5421,10219,8226,51,6,3,3,3,1,2
5422,10224,9788,47,9,4,5,1,0,1
5423,10224,8406,53,7,3,4,0,0,0
5424,10225,10269,46,11,3,8,2,1,1
5425,10225,9904,54,2,1,1,3,2,1
5426,10226,8177,43,9,4,5,1,1,0
5427,10226,8722,57,6,2,4,1,0,1
5428,10228,8234,45,5,3,2,1,0,1
5429,10228,9790,55,3,1,2,0,0,0
5430,10229,8262,35,3,1,2,1,0,1
5431,10229,8697,65,2,1,1,0,0,0
5432,10231,8721,73,12,6,6,2,1,1
5433,10231,9904,27,6,4,2,1,0,1
5434,10234,8406,67,17,10,7,3,2,1
5435,10234,8226,33,2,2,0,1,1,0
5436,10235,8697,38,3,1,2,1,1,0
5437,10235,8178,62,5,1,4,2,0,2
5438,10239,9789,42,5,2,3,2,2,0
5439,10239,9823,58,6,2,4,0,0,0
5440,10240,10189,65,10,6,4,3,3,0
5441,10240,8722,35,3,1,2,1,0,1
5442,10241,8406,38,1,1,0,2,1,1
5443,10241,8178,62,12,6,6,0,0,0
5444,10244,9790,52,6,3,3,3,1,2
5445,10244,8177,48,5,2,3,2,1,1
5446,10247,9905,55,8,4,4,1,1,0
5447,10247,8262,45,3,1,2,2,1,1
5448,10248,10189,57,9,1,8,1,0,1
5449,10248,8177,43,5,3,2,1,0,1
5450,10249,8721,43,7,5,2,2,1,1
5451,10249,8226,57,0,0,0,1,1,0
5452,10251,10269,45,5,5,0,1,1,0
5453,10251,8234,55,5,2,3,2,1,1
5454,10252,8406,70,10,3,7,5,3,2
5455,10252,8262,30,4,2,2,0,0,0
5456,10254,9810,54,2,2,0,1,1,0
5457,10254,9788,46,1,1,0,1,1,0
5458,10255,8722,64,10,4,6,1,1,0
5459,10255,9904,36,4,3,1,2,0,2
5460,10261,9885,47,7,5,2,2,2,0
5461,10261,8535,53,5,1,4,1,0,1
5462,10266,8600,35,4,3,1,1,1,0
5463,10266,8540,65,4,1,3,0,0,0
5464,10272,8564,64,7,3,4,2,0,2
5465,10272,9875,36,4,2,2,0,0,0
5466,10273,8543,58,9,4,5,1,1,0
5467,10273,8530,42,1,1,0,3,2,1
5468,10274,9885,48,9,3,6,1,0,1
5469,10274,8686,52,0,0,0,0,0,0
5470,10277,9857,39,2,1,1,3,1,2
5471,10277,8686,61,5,4,1,1,0,1
5472,10280,9888,25,3,1,2,1,0,1
5473,10280,8564,75,10,7,3,1,0,1
5474,10282,8600,43,4,2,2,1,0,1
5475,10282,8636,57,5,2,3,0,0,0
5476,10284,8524,53,3,1,2,1,1,0
5477,10284,8535,47,8,2,6,1,1,0
5478,10288,8686,43,4,2,2,1,1,0
5479,10288,8543,57,7,2,5,0,0,0
5480,10292,8564,58,8,1,7,2,1,1
5481,10292,8533,42,6,2,4,1,0,1
5482,10294,9885,41,4,0,4,4,2,2
5483,10294,10233,59,0,0,0,1,0,1
5484,10295,8529,40,6,2,4,2,1,1
5485,10295,8535,60,6,2,4,1,0,1
5486,10301,8543,56,12,6,6,1,1,0
5487,10301,10233,44,5,2,3,1,0,1
5488,10302,8636,46,10,7,3,3,1,2
5489,10302,9885,54,5,3,2,1,0,1
5490,10306,8564,55,7,4,3,1,1,0
5491,10306,9804,45,7,0,7,1,1,0
5492,10311,8564,59,8,2,6,2,1,1
5493,10311,8540,41,8,5,3,0,0,0
5494,10317,8686,64,11,4,7,3,2,1
5495,10317,8533,36,0,0,0,1,1,0
5496,10323,8636,55,2,2,0,3,3,0
5497,10323,8543,45,12,3,9,0,0,0
5498,10324,8564,51,12,9,3,2,1,1
5499,10324,8530,49,4,2,2,1,1,0
5500,10325,9885,62,4,3,1,1,1,0
5501,10325,9888,38,3,0,3,0,0,0
5502,10329,9857,62,7,7,0,3,3,0
5503,10329,9804,38,7,6,1,2,2,0
5504,10330,9885,51,4,3,1,2,1,1
5505,10330,8564,49,3,2,1,2,0,2
5506,10332,8543,64,10,6,4,3,2,1
5507,10332,8600,36,6,2,4,0,0,0
5508,10333,9888,42,7,4,3,1,1,0
5509,10333,9875,58,4,2,2,0,0,0
5510,10339,8551,49,4,2,2,1,1,0
5511,10339,8636,51,7,4,3,1,0,1
5512,10340,8543,49,5,3,2,2,1,1
5513,10340,8540,51,3,3,0,3,0,3
5514,10341,9875,59,5,3,2,2,1,1
5515,10341,9804,41,6,3,3,1,1,0
5516,10349,8686,51,13,5,8,1,0,1
5517,10349,8564,49,6,2,4,0,0,0
5518,10354,8551,48,6,3,3,1,1,0
5519,10354,9885,52,3,1,2,1,0,1
5520,10365,8600,64,3,1,2,3,2,1
5521,10365,8529,36,2,1,1,0,0,0
5522,10371,9875,39,6,2,4,2,1,1
5523,10371,8535,61,8,0,8,1,0,1
5524,10374,9885,55,11,7,4,5,1,4
5525,10374,8600,45,4,2,2,3,1,2
5526,10379,8543,65,6,2,4,2,1,1
5527,10379,8529,35,1,0,1,2,1,1
5528,10380,8533,68,3,1,2,3,1,2
5529,10380,8690,32,6,5,1,3,1,2
5530,10381,8535,58,7,3,4,3,1,2
5531,10381,9885,42,6,2,4,1,1,0
5532,10382,9857,37,10,3,7,2,1,1
5533,10382,8564,63,9,4,5,1,0,1
5534,10392,8600,39,8,3,5,2,0,2
5535,10392,9885,61,3,0,3,0,0,0
5536,10400,10233,64,5,4,1,2,2,0
5537,10400,8540,36,1,0,1,2,2,0
5538,10402,8564,64,2,1,1,3,2,1
5539,10402,8543,36,8,4,4,3,0,3
5540,10411,8564,71,10,3,7,2,0,2
5541,10411,8690,29,2,2,0,0,0,0
5542,10412,8535,64,9,3,6,3,0,3
5543,10412,8543,36,8,6,2,0,0,0
5544,10414,9885,44,9,1,8,1,1,0
5545,10414,8530,56,8,5,3,0,0,0
5546,10428,8686,54,5,2,3,2,2,0
5547,10428,8551,46,4,0,4,1,1,0
5548,10431,8636,49,7,4,3,1,1,0
5549,10431,9857,51,5,2,3,1,0,1
5550,10433,8540,65,9,4,5,5,2,3
5551,10433,9885,35,8,6,2,3,1,2
5552,10435,8564,58,3,2,1,1,1,0
5553,10435,8529,42,5,5,0,0,0,0
5554,10440,8564,68,7,2,5,1,1,0
5555,10440,9882,32,3,1,2,0,0,0
5556,10441,8543,45,4,2,2,2,0,2
5557,10441,9857,55,3,2,1,0,0,0
5558,10442,9885,44,5,5,0,2,0,2
5559,10442,9875,56,1,1,0,0,0,0
5560,10444,8686,40,12,7,5,7,5,2
5561,10444,8636,60,7,3,4,0,0,0
5562,10451,8535,48,6,4,2,3,1,2
5563,10451,8540,52,5,2,3,2,0,2
5564,10454,10233,57,7,4,3,1,0,1
5565,10454,8636,43,3,1,2,0,0,0
5566,10456,8564,46,6,5,1,1,0,1
5567,10456,8524,54,10,7,3,0,0,0
5568,10465,8533,44,8,2,6,2,2,0
5569,10465,8543,56,8,5,3,2,1,1
5570,10466,8636,55,6,2,4,2,0,2
5571,10466,8535,45,10,5,5,0,0,0
5572,10469,9875,52,5,3,2,1,1,0
5573,10469,8564,48,8,4,4,1,0,1
5574,10476,8686,45,9,3,6,1,1,0
5575,10476,9885,55,5,2,3,2,0,2
5576,10477,8600,60,15,7,8,2,0,2
5577,10477,9875,40,2,0,2,1,0,1
5578,10482,8564,49,4,2,2,2,2,0
5579,10482,8543,51,9,4,5,2,1,1
5580,10487,8686,48,4,3,1,1,1,0
5581,10487,9857,52,6,1,5,0,0,0
5582,10490,9885,66,4,1,3,2,0,2
5583,10490,8533,34,1,0,1,0,0,0
5584,10491,8535,58,7,2,5,3,1,2
5585,10491,8524,42,3,3,0,0,0,0
5586,10495,9888,35,4,2,2,2,0,2
5587,10495,8564,65,10,3,7,1,0,1
5588,10501,10233,52,7,2,5,2,1,1
5589,10501,9885,48,4,1,3,0,0,0
5590,10513,8564,70,4,4,0,2,2,0
5591,10513,9804,30,3,2,1,0,0,0
5592,10518,8524,46,5,2,3,3,1,2
5593,10518,8543,54,6,1,5,2,0,2
5594,10521,8540,42,4,3,1,2,0,2
5595,10521,8564,58,5,2,3,0,0,0
5596,10522,8535,53,5,2,3,2,2,0
5597,10522,8686,47,5,2,3,2,0,2
5598,10523,8636,35,5,2,3,1,1,0
5599,10523,9875,65,6,1,5,2,2,0
5600,10527,9888,16,4,1,3,3,2,1
5601,10527,9885,84,4,1,3,1,0,1
5602,10531,8543,37,6,4,2,3,0,3
5603,10531,8636,63,3,0,3,3,0,3
5604,10534,10233,51,3,2,1,1,0,1
5605,10534,9882,49,2,1,1,0,0,0
5606,10536,9857,62,8,3,5,2,2,0
5607,10536,8690,38,2,0,2,2,0,2
5608,10539,8600,49,7,2,5,1,1,0
5609,10539,8543,51,3,1,2,2,0,2
5610,10540,9885,38,7,2,5,1,1,0
5611,10540,8564,62,6,2,4,1,1,0
5612,10544,8686,57,10,4,6,1,1,0
5613,10544,8529,43,3,1,2,2,0,2
5614,10547,8535,46,7,4,3,2,1,1
5615,10547,9882,54,1,0,1,2,1,1
5616,10550,8686,54,4,2,2,3,2,1
5617,10550,8530,46,4,1,3,3,2,1
5618,10552,8551,54,6,2,4,1,0,1
5619,10552,8636,46,10,5,5,0,0,0
5620,10553,10233,63,7,5,2,1,0,1
5621,10553,8533,37,5,4,1,1,0,1
5622,10556,8600,41,11,5,6,4,2,2
5623,10556,8564,59,2,1,1,2,1,1
5624,10559,8686,40,5,4,1,2,0,2
5625,10559,8564,60,6,3,3,0,0,0
5626,10564,8529,53,10,6,4,1,0,1
5627,10564,8636,47,5,2,3,0,0,0
5628,10566,9888,40,10,6,4,1,0,1
5629,10566,8535,60,8,4,4,4,0,4
5630,10571,8535,46,5,2,3,1,1,0
5631,10571,8564,54,3,1,2,0,0,0
5632,10572,9857,44,8,6,2,1,0,1
5633,10572,8530,56,7,3,4,1,0,1
5634,10581,8530,43,4,3,1,1,0,1
5635,10581,9885,57,13,3,10,0,0,0
5636,10589,9885,57,3,2,1,2,1,1
5637,10589,9882,43,6,3,3,0,0,0
5638,10590,8686,34,5,2,3,4,2,2
5639,10590,8524,66,2,0,2,0,0,0
5640,10592,8564,56,11,7,4,4,2,2
5641,10592,8636,44,5,2,3,1,0,1
5642,10600,8564,63,7,3,4,2,1,1
5643,10600,8529,37,5,3,2,1,0,1
5644,10603,9857,37,7,5,2,1,1,0
5645,10603,8636,63,14,10,4,2,0,2
5646,10609,8686,53,13,7,6,1,1,0
5647,10609,8636,47,6,4,2,0,0,0
5648,10624,10233,46,6,2,4,2,0,2
5649,10624,8636,54,4,1,3,0,0,0
5650,10650,8540,43,4,3,1,6,4,2
5651,10650,8636,57,5,2,3,1,1,0
5652,10651,9885,60,8,5,3,4,1,3
5653,10651,9882,40,1,0,1,1,0,1
5654,10659,8530,45,4,3,1,1,1,0
5655,10659,8535,55,5,1,4,0,0,0
5656,10672,8551,52,6,4,2,1,0,1
5657,10672,10233,48,4,3,1,0,0,0
5658,10674,8543,75,14,7,7,2,0,2
5659,10674,8564,25,4,2,2,0,0,0
5660,10677,8636,55,9,6,3,3,1,2
5661,10677,9857,45,3,1,2,0,0,0
5662,10681,8529,48,7,4,3,3,1,2
5663,10681,8564,52,3,2,1,1,0,1
5664,10689,9885,75,6,1,5,1,1,0
5665,10689,8529,25,0,0,0,0,0,0
5666,10692,9882,64,5,3,2,2,1,1
5667,10692,10233,36,2,1,1,0,0,0
5668,10693,8636,66,8,4,4,1,0,1
5669,10693,8535,34,6,5,1,0,0,0
5670,10700,9885,51,7,4,3,2,0,2
5671,10700,8636,49,6,3,3,1,0,1
5672,10702,8564,75,8,5,3,1,0,1
5673,10702,9882,25,3,1,2,0,0,0
5674,10705,8686,52,6,2,4,1,0,1
5675,10705,8543,48,7,4,3,0,0,0
5676,10709,8529,51,2,2,0,2,1,1
5677,10709,9875,49,7,1,6,2,0,2
5678,10712,10233,46,3,1,2,2,1,1
5679,10712,8543,54,5,3,2,0,0,0
5680,10713,8540,30,4,3,1,3,1,2
5681,10713,8564,70,12,3,9,1,1,0
5682,10720,8636,54,5,4,1,4,3,1
5683,10720,8543,46,5,3,2,0,0,0
5684,10725,8686,52,8,3,5,1,1,0
5685,10725,10167,48,4,1,3,1,1,0
5686,10729,8529,52,7,3,4,1,0,1
5687,10729,8686,48,2,0,2,0,0,0
5688,10731,8636,54,8,6,2,2,0,2
5689,10731,8533,46,3,2,1,0,0,0
5690,10733,8564,52,5,2,3,3,0,3
5691,10733,10233,48,4,2,2,0,0,0
5692,10736,8551,58,7,1,6,5,3,2
5693,10736,8535,42,6,1,5,1,0,1
5694,10738,8535,58,9,6,3,3,1,2
5695,10738,9976,42,5,1,4,1,1,0
5696,10740,8636,51,4,1,3,4,1,3
5697,10740,8551,49,4,1,3,1,0,1
5698,10741,9885,36,5,1,4,1,1,0
5699,10741,8564,64,3,1,2,0,0,0
5700,10745,8533,67,5,3,2,1,1,0
5701,10745,8686,33,4,2,2,0,0,0
5702,10757,9857,37,2,2,0,2,1,1
5703,10757,8535,63,13,1,12,1,0,1
5704,10764,9875,63,6,6,0,4,2,2
5705,10764,8540,37,4,1,3,0,0,0
5706,10765,8551,9,5,1,4,3,2,1
5707,10765,8564,91,5,1,4,2,0,2
5708,10772,8636,24,8,6,2,2,2,0
5709,10772,8564,76,6,2,4,0,0,0
5710,10775,8686,48,4,0,4,1,0,1
5711,10775,9885,52,3,0,3,0,0,0
5712,10783,8564,68,9,3,6,1,0,1
5713,10783,8537,32,3,0,3,0,0,0
5714,10785,8686,63,5,3,2,3,2,1
5715,10785,8551,37,2,1,1,0,0,0
5716,10795,8535,49,8,4,4,1,1,0
5717,10795,8686,51,1,0,1,3,1,2
5718,10800,9882,37,4,2,2,5,3,2
5719,10800,8535,63,1,0,1,1,0,1
5720,10801,9885,61,8,4,4,1,1,0
5721,10801,10233,39,0,0,0,4,1,3
5722,10802,9875,58,6,6,0,1,0,1
5723,10802,8636,42,8,2,6,0,0,0
5724,10804,8686,44,3,2,1,4,2,2
5725,10804,8540,56,5,4,1,1,1,0
5726,10806,8600,47,9,4,5,4,3,1
5727,10806,8564,53,6,3,3,0,0,0
5728,10807,8530,49,4,2,2,5,2,3
5729,10807,8686,51,5,2,3,4,2,2
5730,10809,9885,42,6,5,1,5,2,3
5731,10809,9857,58,4,1,3,0,0,0
5732,10812,8564,45,3,2,1,2,1,1
5733,10812,9976,55,2,1,1,0,0,0
5734,10815,9882,75,5,4,1,2,1,1
5735,10815,8636,25,5,2,3,3,0,3
5736,10817,8524,40,6,2,4,2,0,2
5737,10817,8564,60,4,2,2,0,0,0
5738,10821,8543,60,5,2,3,1,1,0
5739,10821,8535,40,9,1,8,2,0,2
5740,10824,9875,57,5,3,2,1,1,0
5741,10824,8686,43,6,4,2,1,0,1
5742,10833,8686,41,6,2,4,1,1,0
5743,10833,8564,59,2,0,2,0,0,0
5744,10840,8564,62,8,2,6,1,1,0
5745,10840,8533,38,4,2,2,2,0,2
5746,10841,8535,43,4,3,1,1,0,1
5747,10841,9875,57,4,2,2,0,0,0
5748,10842,8636,51,7,3,4,2,2,0
5749,10842,8530,49,3,2,1,0,0,0
5750,10846,8551,43,7,6,1,5,3,2
5751,10846,9885,57,4,2,2,4,1,3
5752,10854,9875,36,7,4,3,3,2,1
5753,10854,8564,64,7,1,6,1,1,0
5754,10856,8600,59,5,1,4,2,1,1
5755,10856,8686,41,6,3,3,5,2,3
5756,10860,10233,56,6,2,4,2,0,2
5757,10860,9875,44,6,3,3,0,0,0
5758,10861,10167,39,2,2,0,3,1,2
5759,10861,8636,61,14,6,8,1,1,0
5760,10862,9885,35,7,3,4,3,1,2
5761,10862,8543,65,6,4,2,0,0,0
5762,10874,8686,53,8,6,2,2,1,1
5763,10874,9857,47,4,2,2,1,0,1
5764,10877,9885,44,5,2,3,1,1,0
5765,10877,8524,56,5,3,2,3,3,0
5766,10885,10167,59,3,2,1,2,1,1
5767,10885,8533,41,3,3,0,0,0,0
5768,10887,8636,65,7,6,1,3,2,1
5769,10887,9857,35,2,0,2,1,0,1
5770,10891,8529,46,5,0,5,2,1,1
5771,10891,8564,54,1,0,1,0,0,0
5772,10897,8686,47,2,1,1,3,1,2
5773,10897,8524,53,4,1,3,2,0,2
5774,10900,8530,37,4,3,1,1,1,0
5775,10900,8564,63,4,2,2,0,0,0
5776,10903,8636,65,4,4,0,1,1,0
5777,10903,8535,35,4,3,1,1,0,1
5778,10908,8535,61,5,3,2,2,0,2
5779,10908,8524,39,8,4,4,0,0,0
5780,10909,10233,51,9,4,5,3,1,2
5781,10909,10167,49,12,2,10,1,0,1
5782,10911,8533,39,5,4,1,1,0,1
5783,10911,8537,61,2,0,2,3,0,3
5784,10914,8540,62,11,3,8,1,1,0
5785,10914,8529,38,6,4,2,0,0,0
5786,10917,8636,51,9,5,4,1,1,0
5787,10917,8524,49,2,0,2,2,1,1
5788,10922,8543,33,3,2,1,1,1,0
5789,10922,10233,67,5,2,3,2,0,2
5790,10925,8686,56,12,5,7,2,1,1
5791,10925,9882,44,1,1,0,2,1,1
5792,10928,8535,36,4,2,2,2,1,1
5793,10928,8564,64,5,4,1,2,1,1
5794,10930,8636,53,10,8,2,1,1,0
5795,10930,8543,47,5,3,2,0,0,0
5796,10931,8530,31,4,2,2,1,1,0
5797,10931,9885,69,4,3,1,2,1,1
5798,10939,8686,55,11,3,8,4,2,2
5799,10939,8529,45,2,0,2,1,0,1
5800,10941,8636,75,7,2,5,2,1,1
5801,10941,8533,25,2,1,1,0,0,0
5802,10943,10233,44,9,3,6,1,1,0
5803,10943,8564,56,5,2,3,1,1,0
5804,10944,9885,57,3,2,1,5,3,2
5805,10944,10167,43,1,0,1,1,0,1
5806,10947,8529,58,7,3,4,2,1,1
5807,10947,9857,42,2,2,0,0,0,0
5808,10950,8636,68,6,3,3,2,1,1
5809,10950,8551,32,2,1,1,0,0,0
5810,10953,9882,41,6,6,0,3,2,1
5811,10953,9875,59,6,4,2,2,2,0
5812,10954,8524,45,12,5,7,2,2,0
5813,10954,8540,55,11,2,9,4,2,2
5814,10956,8600,36,8,3,5,3,1,2
5815,10956,8543,64,11,4,7,0,0,0
5816,10958,8636,52,7,4,3,2,0,2
5817,10958,8529,48,7,2,5,1,0,1
5818,10961,8537,45,9,7,2,2,1,1
5819,10961,9885,55,4,1,3,0,0,0
5820,10965,8535,49,3,1,2,7,3,4
5821,10965,8686,51,8,3,5,0,0,0
5822,10970,9882,36,3,3,0,3,2,1
5823,10970,8535,64,10,6,4,0,0,0
5824,10971,9885,60,5,3,2,1,1,0
5825,10971,10233,40,4,1,3,2,2,0
5826,10979,9885,47,6,5,1,1,1,0
5827,10979,9857,53,6,3,3,1,0,1
5828,10980,8543,56,15,8,7,2,1,1
5829,10980,8540,44,1,0,1,0,0,0
5830,10991,8543,39,11,5,6,2,2,0
5831,10991,8535,61,11,5,6,1,0,1
5832,10992,8636,58,10,5,5,4,1,3
5833,10992,8600,42,5,1,4,0,0,0
5834,10994,8686,44,7,5,2,4,2,2
5835,10994,9875,56,2,1,1,1,1,0
5836,10999,8636,43,2,1,1,2,1,1
5837,10999,10233,57,5,0,5,1,1,0
5838,11000,9885,51,8,2,6,5,2,3
5839,11000,8535,49,8,3,5,2,1,1
5840,11003,8686,42,12,6,6,1,0,1
5841,11003,8564,58,6,2,4,1,0,1
5842,11012,8636,52,3,2,1,2,2,0
5843,11012,8530,48,5,1,4,0,0,0
5844,11014,8537,35,2,2,0,3,1,2
5845,11014,8686,65,9,5,4,1,1,0
5846,11017,8636,68,18,6,12,1,1,0
5847,11017,9857,32,5,3,2,2,0,2
5848,11031,8543,59,4,1,3,2,1,1
5849,11031,8686,41,6,3,3,2,0,2
5850,11032,9880,54,4,3,1,2,2,0
5851,11032,9885,46,10,5,5,2,0,2
5852,11034,8533,51,6,4,2,2,1,1
5853,11034,8535,49,12,8,4,0,0,0
5854,11037,8540,43,9,6,3,2,2,0
5855,11037,8564,57,3,3,0,0,0,0
5856,11038,9888,37,3,1,2,1,1,0
5857,11038,8636,63,4,2,2,1,0,1
5858,11039,10167,62,7,3,4,3,0,3
5859,11039,9882,38,2,0,2,0,0,0
5860,11049,9885,40,7,1,6,2,1,1
5861,11049,8686,60,6,4,2,0,0,0
5862,11050,8564,33,1,1,0,1,1,0
5863,11050,8636,67,3,0,3,2,1,1
5864,11061,8533,36,5,2,3,3,2,1
5865,11061,8636,64,8,3,5,1,0,1
5866,11065,9875,36,9,6,3,1,1,0
5867,11065,9857,64,4,1,3,1,0,1
5868,11068,8533,45,4,1,3,1,0,1
5869,11068,9857,55,8,2,6,0,0,0
5870,11070,8564,57,15,7,8,2,2,0
5871,11070,9882,43,3,0,3,0,0,0
5872,11072,8686,58,10,7,3,2,1,1
5873,11072,8540,42,6,3,3,2,2,0
5874,11074,8530,31,5,3,2,1,0,1
5875,11074,8543,69,10,4,6,1,0,1
5876,11075,8535,34,5,3,2,1,1,0
5877,11075,9885,66,11,7,4,2,0,2
5878,11077,9885,52,4,1,3,2,1,1
5879,11077,8530,48,3,0,3,2,0,2
5880,11079,8564,66,7,5,2,1,1,0
5881,11079,9858,34,2,1,1,1,0,1
5882,11080,10167,48,5,5,0,3,2,1
5883,11080,8600,52,6,2,4,0,0,0
5884,11089,9882,60,7,3,4,1,1,0
5885,11089,9858,40,3,2,1,2,1,1
5886,11093,8636,58,6,4,2,1,1,0
5887,11093,9880,42,1,0,1,0,0,0
5888,11095,8540,56,9,4,5,1,0,1
5889,11095,10167,44,4,1,3,1,0,1
5890,11096,8686,55,9,2,7,3,3,0
5891,11096,9976,45,3,1,2,1,0,1
5892,11098,8529,56,1,1,0,3,2,1
5893,11098,9880,44,3,0,3,1,0,1
5894,11099,9976,39,3,1,2,3,1,2
5895,11099,8540,61,8,2,6,1,0,1
5896,11101,8543,54,10,7,3,3,2,1
5897,11101,8600,46,3,0,3,2,1,1
5898,11103,8533,64,6,2,4,2,1,1
5899,11103,9885,36,3,1,2,1,0,1
5900,11107,8543,45,8,7,1,3,1,2
5901,11107,10233,55,10,4,6,3,1,2
5902,11113,8564,43,6,1,5,1,1,0
5903,11113,8529,57,5,3,2,0,0,0
5904,11114,9857,48,5,2,3,1,1,0
5905,11114,8535,52,4,2,2,1,0,1
5906,11121,9885,54,6,3,3,2,0,2
5907,11121,9875,46,4,3,1,0,0,0
5908,11123,9888,40,7,3,4,2,1,1
5909,11123,8543,60,7,1,6,2,0,2
5910,11124,8564,71,9,3,6,2,1,1
5911,11124,8600,29,0,0,0,1,0,1
5912,11125,8533,53,7,4,3,1,1,0
5913,11125,8540,47,8,5,3,0,0,0
5914,11127,9875,55,6,2,4,2,1,1
5915,11127,9976,45,6,1,5,1,1,0
5916,11130,9885,58,10,4,6,1,0,1
5917,11130,9882,42,4,3,1,0,0,0
5918,11131,8636,63,6,5,1,2,0,2
5919,11131,8600,37,7,5,2,0,0,0
5920,11137,9885,51,5,3,2,2,1,1
5921,11137,9976,49,3,2,1,1,0,1
5922,11153,8530,46,8,3,5,1,1,0
5923,11153,10167,54,1,1,0,1,0,1
5924,11160,10233,41,6,6,0,1,0,1
5925,11160,10167,59,6,2,4,0,0,0
5926,11161,8636,60,12,9,3,2,1,1
5927,11161,8540,40,5,0,5,1,1,0
5928,11164,8535,55,5,3,2,2,1,1
5929,11164,8543,45,10,5,5,0,0,0
5930,11172,9976,47,5,1,4,1,1,0
5931,11172,8636,53,6,2,4,2,1,1
5932,11174,8535,44,7,4,3,3,2,1
5933,11174,10233,56,5,4,1,1,0,1
5934,11175,9885,65,9,3,6,1,0,1
5935,11175,8540,35,1,0,1,2,0,2
5936,11179,10167,55,3,1,2,1,1,0
5937,11179,8535,45,3,2,1,2,1,1
5938,11180,8686,51,7,6,1,5,2,3
5939,11180,8636,49,15,7,8,1,0,1
5940,11181,9857,51,5,2,3,2,1,1
5941,11181,8530,49,4,2,2,3,1,2
5942,11188,9885,33,3,3,0,2,1,1
5943,11188,8636,67,5,0,5,0,0,0
5944,11201,8535,58,5,1,4,1,0,1
5945,11201,9882,42,2,1,1,0,0,0
5946,11210,9882,39,9,7,2,3,1,2
5947,11210,8636,61,8,5,3,0,0,0
5948,11214,9885,57,10,5,5,2,1,1
5949,11214,9857,43,0,0,0,1,0,1
5950,11215,8600,51,8,7,1,1,1,0
5951,11215,8540,49,5,3,2,1,1,0
5952,11222,9882,65,4,1,3,3,1,2
5953,11222,9880,35,2,0,2,1,0,1
5954,11225,9875,66,7,5,2,2,2,0
5955,11225,9858,34,4,1,3,2,1,1
5956,11226,9976,28,6,4,2,1,1,0
5957,11226,8600,72,9,3,6,1,1,0
5958,11229,9882,45,1,0,1,3,2,1
5959,11229,8530,55,7,0,7,1,0,1
5960,11230,9880,63,7,2,5,3,2,1
5961,11230,9885,37,3,1,2,1,0,1
5962,11232,8543,51,1,1,0,2,2,0
5963,11232,8686,49,5,2,3,1,0,1
5964,11234,9976,27,3,2,1,1,1,0
5965,11234,8564,73,12,2,10,1,1,0
5966,11236,9858,46,7,2,5,3,0,3
5967,11236,8636,54,6,3,3,0,0,0
5968,11247,9875,55,5,2,3,1,1,0
5969,11247,8529,45,4,0,4,1,1,0
5970,11248,8535,47,3,2,1,2,0,2
5971,11248,8686,53,6,2,4,0,0,0
5972,11251,8540,34,6,2,4,2,1,1
5973,11251,8564,66,7,1,6,1,0,1
5974,11260,8686,57,8,6,2,1,0,1
5975,11260,9885,43,7,3,4,0,0,0
5976,11261,8564,67,11,5,6,1,0,1
5977,11261,8636,33,7,5,2,1,0,1
5978,11267,8600,46,6,4,2,3,1,2
5979,11267,8686,54,3,2,1,0,0,0
5980,11269,8543,54,4,3,1,1,0,1
5981,11269,10167,46,6,3,3,0,0,0
5982,11270,9875,47,6,3,3,1,0,1
5983,11270,9857,53,8,2,6,0,0,0
5984,11272,10233,43,3,1,2,2,1,1
5985,11272,9885,57,10,4,6,0,0,0
5986,11274,8636,52,7,3,4,4,1,3
5987,11274,8533,48,2,1,1,0,0,0
5988,11276,8540,46,8,4,4,3,1,2
5989,11276,9880,54,3,1,2,1,1,0
5990,11291,9875,62,4,2,2,2,0,2
5991,11291,8540,38,5,4,1,2,0,2
5992,11300,8540,61,7,5,2,2,0,2
5993,11300,10167,39,1,0,1,0,0,0
5994,11301,9882,59,7,2,5,1,0,1
5995,11301,9858,41,2,1,1,0,0,0
5996,11304,8543,53,5,4,1,2,0,2
5997,11304,9885,47,2,1,1,0,0,0
5998,11309,8600,31,5,3,2,4,2,2
5999,11309,8543,69,7,2,5,1,1,0
6000,11311,10167,40,4,4,0,2,0,2
6001,11311,9857,60,5,3,2,0,0,0
6002,11317,8535,58,6,5,1,1,0,1
6003,11317,9857,42,3,1,2,1,0,1
6004,11320,9875,48,6,4,2,2,1,1
6005,11320,8636,52,2,1,1,0,0,0
6006,11322,8530,60,8,4,4,2,2,0
6007,11322,8686,40,2,1,1,0,0,0
6008,11324,9882,51,10,2,8,2,1,1
6009,11324,8540,49,6,1,5,0,0,0
6010,11329,8543,61,8,4,4,1,1,0
6011,11329,9888,39,7,3,4,0,0,0
6012,11333,8600,36,7,1,6,2,1,1
6013,11333,8564,64,5,1,4,0,0,0
6014,11339,8564,56,4,2,2,4,3,1
6015,11339,8543,44,6,2,4,3,0,3
6016,11344,9882,49,5,2,3,4,1,3
6017,11344,8529,51,4,2,2,1,0,1
6018,11347,8600,51,6,2,4,1,1,0
6019,11347,9882,49,2,1,1,0,0,0
6020,11351,9885,54,4,3,1,1,1,0
6021,11351,8529,46,3,1,2,1,0,1
6022,11352,8535,56,11,6,5,1,0,1
6023,11352,10167,44,3,1,2,0,0,0
6024,11353,8543,57,4,3,1,2,1,1
6025,11353,8533,43,1,1,0,3,0,3
6026,11354,9875,65,10,7,3,1,0,1
6027,11354,9880,35,5,1,4,0,0,0
6028,11357,8530,61,4,3,1,1,0,1
6029,11357,9888,39,3,3,0,1,0,1
6030,11358,9875,40,10,5,5,1,0,1
6031,11358,8686,60,11,5,6,0,0,0
6032,11360,8600,69,9,5,4,4,3,1
6033,11360,9880,31,0,0,0,0,0,0
6034,11362,9885,35,11,4,7,3,1,2
6035,11362,8636,65,10,7,3,0,0,0
6036,11366,9857,62,8,4,4,2,1,1
6037,11366,9882,38,5,4,1,2,0,2
6038,11367,8564,56,9,5,4,1,0,1
6039,11367,8533,44,8,5,3,0,0,0
6040,11368,8540,49,8,2,6,1,0,1
6041,11368,9857,51,2,1,1,1,0,1
6042,11369,8686,35,4,3,1,2,2,0
6043,11369,10233,65,5,0,5,1,0,1
6044,11370,8535,39,2,2,0,1,0,1
6045,11370,9882,61,5,4,1,0,0,0
6046,11374,8636,56,7,3,4,2,1,1
6047,11374,8529,44,3,0,3,1,1,0
6048,11378,10167,47,2,1,1,1,1,0
6049,11378,8686,53,2,1,1,1,0,1
6050,11387,9888,47,7,4,3,2,1,1
6051,11387,8686,53,12,8,4,0,0,0
6052,11402,9875,54,9,4,5,1,1,0
6053,11402,10233,46,6,2,4,1,0,1
6054,11406,9885,49,10,8,2,2,1,1
6055,11406,8600,51,6,1,5,2,1,1
6056,11415,8533,51,4,3,1,1,1,0
6057,11415,8551,49,4,1,3,2,1,1
6058,11416,8600,40,6,3,3,4,2,2
6059,11416,8540,60,8,2,6,1,0,1
6060,11419,8535,64,3,2,1,2,1,1
6061,11419,8533,36,2,2,0,0,0,0
6062,11424,8686,70,12,4,8,3,1,2
6063,11424,6269,30,3,1,2,3,2,1
6064,11428,8564,63,6,2,4,1,0,1
6065,11428,8535,37,2,0,2,1,0,1
6066,11432,8540,40,3,2,1,4,3,1
6067,11432,9885,60,4,2,2,0,0,0
6068,11435,8686,67,8,4,4,2,2,0
6069,11435,9888,33,1,1,0,3,1,2
6070,11440,9885,48,5,3,2,1,1,0
6071,11440,8543,52,11,4,7,0,0,0
6072,11444,8535,62,10,6,4,4,1,3
6073,11444,8540,38,3,2,1,0,0,0
6074,11445,8636,65,4,2,2,4,3,1
6075,11445,8551,35,2,0,2,0,0,0
6076,11455,10167,48,9,4,5,2,1,1
6077,11455,8540,52,2,1,1,4,2,2
6078,11456,8600,49,7,3,4,1,1,0
6079,11456,8636,51,2,2,0,1,0,1
6080,11463,8540,65,7,4,3,3,1,2
6081,11463,9880,35,7,4,3,2,1,1
6082,11468,9880,42,7,3,4,2,2,0
6083,11468,8636,58,3,1,2,2,2,0
6084,11470,8524,61,4,2,2,1,1,0
6085,11470,8535,39,5,1,4,3,1,2
6086,11472,9885,63,13,10,3,2,2,0
6087,11472,6269,37,8,4,4,3,0,3
6088,11473,8600,46,2,1,1,2,2,0
6089,11473,8543,54,11,2,9,3,2,1
6090,11485,8543,45,8,5,3,2,2,0
6091,11485,8551,55,4,1,3,2,1,1
6092,11487,8686,61,5,2,3,1,0,1
6093,11487,8530,39,3,1,2,0,0,0
6094,11494,8564,67,7,4,3,3,2,1
6095,11494,8636,33,6,3,3,2,1,1
6096,11497,8524,40,6,3,3,3,2,1
6097,11497,9885,60,7,4,3,0,0,0
6098,11502,8564,58,11,9,2,1,0,1
6099,11502,6269,42,2,0,2,1,0,1
6100,11504,8686,71,10,5,5,1,0,1
6101,11504,9880,29,4,1,3,0,0,0
6102,11508,9880,35,6,5,1,3,1,2
6103,11508,9875,65,9,4,5,2,0,2
6104,11512,9885,64,5,1,4,2,0,2
6105,11512,10167,36,2,0,2,1,0,1
6106,11520,8636,64,13,7,6,4,0,4
6107,11520,9888,36,3,2,1,3,0,3
6108,11527,8530,41,4,2,2,3,1,2
6109,11527,8551,59,11,3,8,3,0,3
6110,11529,8533,40,5,4,1,2,0,2
6111,11529,6269,60,7,6,1,2,0,2
6112,11532,9885,63,8,4,4,3,2,1
6113,11532,10167,37,3,1,2,4,1,3
6114,11540,8686,65,3,2,1,2,2,0
6115,11540,8636,35,3,1,2,2,1,1
6116,11541,8543,54,5,3,2,3,2,1
6117,11541,10233,46,2,0,2,0,0,0
6118,11544,9885,74,13,3,10,2,1,1
6119,11544,8551,26,3,1,2,1,0,1
6120,11547,8533,51,3,2,1,2,1,1
6121,11547,9875,49,5,0,5,1,0,1
6122,11551,8636,68,13,5,8,1,0,1
6123,11551,6269,32,5,3,2,1,0,1
6124,11553,8686,75,5,3,2,1,0,1
6125,11553,8551,25,3,1,2,0,0,0
6126,11555,8636,63,8,3,5,4,1,3
6127,11555,9857,37,3,1,2,0,0,0
6128,11557,8530,43,5,4,1,1,0,1
6129,11557,9885,57,17,9,8,1,0,1
6130,11559,8543,52,9,1,8,2,2,0
6131,11559,8540,48,2,0,2,4,2,2
6132,11563,9888,54,3,3,0,3,2,1
6133,11563,8551,46,7,3,4,0,0,0
6134,11566,9875,51,3,2,1,1,0,1
6135,11566,8636,49,2,0,2,0,0,0
6136,11572,8686,63,4,4,0,2,0,2
6137,11572,8524,37,0,0,0,1,0,1
6138,11575,8564,63,8,4,4,1,0,1
6139,11575,8540,37,7,4,3,1,0,1
6140,11577,8529,41,4,3,1,2,2,0
6141,11577,9875,59,3,2,1,2,0,2
6142,11584,9885,70,6,3,3,2,1,1
6143,11584,8535,30,3,0,3,1,1,0
6144,11586,8564,47,7,4,3,2,1,1
6145,11586,10167,53,8,3,5,2,1,1
6146,11587,9875,73,10,3,7,2,1,1
6147,11587,8600,27,1,1,0,1,0,1
6148,11590,9857,56,7,6,1,2,1,1
6149,11590,8524,44,10,7,3,0,0,0
6150,11596,8686,53,6,3,3,1,1,0
6151,11596,8564,47,9,6,3,3,0,3
6152,11598,8540,40,4,2,2,4,4,0
6153,11598,8600,60,10,5,5,0,0,0
6154,11599,8540,56,2,1,1,1,1,0
6155,11599,8524,44,1,0,1,1,0,1
6156,11604,10233,53,2,1,1,2,1,1
6157,11604,8543,47,2,0,2,7,1,6
6158,11607,9885,61,7,2,5,3,2,1
6159,11607,8551,39,4,2,2,1,0,1
6160,11608,8600,34,5,3,2,2,2,0
6161,11608,8535,66,5,3,2,0,0,0
6162,11609,10233,54,8,6,2,1,0,1
6163,11609,8636,46,7,3,4,2,0,2
6164,11610,10167,53,7,3,4,1,1,0
6165,11610,8543,47,2,1,1,1,0,1
6166,11612,8686,63,8,2,6,1,0,1
6167,11612,6269,37,8,1,7,0,0,0
6168,11620,9885,65,9,5,4,2,1,1
6169,11620,8540,35,2,1,1,0,0,0
6170,11621,9875,58,2,1,1,1,1,0
6171,11621,8543,42,3,0,3,0,0,0
6172,11636,8530,55,8,3,5,1,1,0
6173,11636,8529,45,6,2,4,3,0,3
6174,11638,8686,74,7,2,5,2,1,1
6175,11638,8535,26,5,4,1,0,0,0
6176,11640,8600,53,8,3,5,1,1,0
6177,11640,8636,47,3,2,1,2,0,2
6178,11641,9885,76,11,5,6,1,0,1
6179,11641,9880,24,4,3,1,0,0,0
6180,11642,6269,45,6,4,2,1,1,0
6181,11642,8543,55,5,1,4,2,1,1
6182,11665,8564,48,9,6,3,2,1,1
6183,11665,8524,52,4,2,2,1,0,1
6184,11675,8686,65,13,5,8,2,0,2
6185,11675,8530,35,4,4,0,1,0,1
6186,11678,8535,30,2,2,0,1,0,1
6187,11678,9888,70,4,1,3,0,0,0
6188,11680,9885,49,8,5,3,2,1,1
6189,11680,8529,51,0,0,0,0,0,0
6190,11684,8551,53,4,2,2,4,1,3
6191,11684,10167,47,4,1,3,2,2,0
6192,11706,8636,34,3,1,2,3,0,3
6193,11706,9857,66,4,2,2,0,0,0
6194,11709,10233,35,5,5,0,1,1,0
6195,11709,8533,65,9,2,7,1,1,0
6196,11711,9880,44,4,1,3,1,1,0
6197,11711,8564,56,4,0,4,0,0,0
6198,11716,8543,60,6,2,4,3,1,2
6199,11716,8535,40,6,0,6,1,0,1
6200,11725,8524,53,9,4,5,1,0,1
6201,11725,8600,47,2,1,1,0,0,0
6202,11727,8530,42,5,2,3,2,1,1
6203,11727,8636,58,2,0,2,2,2,0
6204,11728,8535,61,6,3,3,2,2,0
6205,11728,9880,39,3,1,2,0,0,0
6206,11736,8529,35,4,2,2,1,0,1
6207,11736,9875,65,3,1,2,0,0,0
6208,11737,8535,49,9,5,4,1,0,1
6209,11737,8530,51,5,1,4,0,0,0
6210,11739,10233,44,6,4,2,2,1,1
6211,11739,9885,56,6,5,1,0,0,0
6212,11742,8540,41,8,2,6,2,1,1
6213,11742,8686,59,2,0,2,0,0,0
6214,11745,8524,47,2,2,0,1,1,0
6215,11745,8636,53,4,2,2,0,0,0
6216,11751,10167,41,5,3,2,1,1,0
6217,11751,8564,59,6,1,5,0,0,0
6218,12515,9876,37,4,3,1,1,0,1
6219,12515,8524,63,6,2,4,0,0,0
6220,12521,8535,53,4,2,2,2,0,2
6221,12521,8686,47,5,1,4,1,0,1
6222,12522,7943,40,8,3,5,4,1,3
6223,12522,8529,60,7,2,5,0,0,0
6224,12526,7943,57,5,2,3,1,1,0
6225,12526,8533,43,5,3,2,2,0,2
6226,12528,8543,49,4,4,0,4,2,2
6227,12528,8529,51,4,1,3,3,1,2
6228,12530,9875,40,8,5,3,1,1,0
6229,12530,8686,60,7,4,3,0,0,0
6230,12531,8636,64,2,1,1,3,2,1
6231,12531,10167,36,4,1,3,2,0,2
6232,12532,8535,68,9,6,3,1,1,0
6233,12532,9882,32,5,1,4,2,0,2
6234,12533,8524,41,6,1,5,5,3,2
6235,12533,9804,59,13,1,12,1,0,1
6236,12534,10233,41,3,2,1,2,1,1
6237,12534,8600,59,1,0,1,0,0,0
6238,12535,10233,53,7,4,3,2,0,2
6239,12535,8529,47,6,3,3,0,0,0
6240,12536,8533,41,7,3,4,3,2,1
6241,12536,9880,59,2,0,2,2,0,2
6242,12538,9875,39,10,7,3,1,0,1
6243,12538,8535,61,6,1,5,0,0,0
6244,12540,9885,69,4,3,1,1,0,1
6245,12540,10167,31,2,2,0,0,0,0
6246,12542,8686,62,7,4,3,3,3,0
6247,12542,9804,38,5,2,3,1,0,1
6248,12544,7943,63,11,5,6,1,0,1
6249,12544,8524,37,3,1,2,0,0,0
6250,12547,10233,57,8,5,3,1,0,1
6251,12547,8540,43,5,3,2,1,0,1
6252,12550,8636,60,2,2,0,1,0,1
6253,12550,8564,40,2,0,2,1,0,1
6254,12552,10167,54,5,2,3,1,1,0
6255,12552,8534,46,4,2,2,1,1,0
6256,12554,8600,46,4,1,3,4,0,4
6257,12554,8533,54,5,4,1,1,0,1
6258,12555,8535,49,4,3,1,3,2,1
6259,12555,8529,51,9,3,6,2,2,0
6260,12559,9885,62,7,5,2,1,1,0
6261,12559,9804,38,8,2,6,5,2,3
6262,12561,10167,53,7,2,5,2,2,0
6263,12561,8540,47,3,1,2,0,0,0
6264,12562,8686,44,4,3,1,2,1,1
6265,12562,8636,56,2,1,1,4,0,4
6266,12563,9882,30,6,5,1,3,1,2
6267,12563,9875,70,2,0,2,1,0,1
6268,12566,8533,41,4,3,1,1,1,0
6269,12566,8529,59,5,1,4,0,0,0
6270,12567,8535,44,6,4,2,3,2,1
6271,12567,9885,56,8,2,6,2,0,2
6272,12569,9876,35,8,3,5,1,0,1
6273,12569,9882,65,6,3,3,0,0,0
6274,12570,8600,38,5,2,3,2,2,0
6275,12570,8636,62,9,3,6,1,1,0
6276,12571,9875,53,15,11,4,3,3,0
6277,12571,8534,47,4,2,2,1,0,1
6278,12573,8686,73,5,4,1,3,2,1
6279,12573,7943,27,3,1,2,1,0,1
6280,12576,8636,70,12,5,7,1,1,0
6281,12576,8533,30,7,4,3,1,0,1
6282,12578,8686,69,8,5,3,2,1,1
6283,12578,10233,31,3,3,0,1,0,1
6284,12579,9885,67,11,5,6,1,1,0
6285,12579,9882,33,4,2,2,0,0,0
6286,12580,8543,53,9,4,5,1,1,0
6287,12580,8524,47,2,0,2,1,0,1
6288,12581,9875,57,7,4,3,2,1,1
6289,12581,8564,43,3,0,3,1,0,1
6290,12583,10167,42,1,1,0,1,0,1
6291,12583,8529,58,6,1,5,0,0,0
6292,12584,9876,35,5,4,1,2,1,1
6293,12584,8600,65,9,4,5,1,1,0
6294,12586,9885,66,7,1,6,1,1,0
6295,12586,8529,34,3,3,0,0,0,0
6296,12587,8535,61,6,3,3,1,1,0
6297,12587,8534,39,5,2,3,1,0,1
6298,12588,9876,51,4,2,2,2,1,1
6299,12588,8533,49,4,2,2,0,0,0
6300,12590,9875,57,7,1,6,6,4,2
6301,12590,10167,43,0,0,0,1,1,0
6302,12592,8600,31,3,1,2,1,1,0
6303,12592,9882,69,9,3,6,1,0,1
6304,12593,7943,53,10,7,3,2,1,1
6305,12593,9880,47,2,1,1,1,1,0
6306,12594,9804,37,6,2,4,1,1,0
6307,12594,10233,63,6,3,3,3,2,1
6308,12596,8533,56,11,6,5,1,1,0
6309,12596,9804,44,6,4,2,1,0,1
6310,12598,10233,60,10,4,6,2,2,0
6311,12598,8524,40,5,2,3,0,0,0
6312,12599,8636,53,4,1,3,2,1,1
6313,12599,9885,47,8,6,2,2,1,1
6314,12600,8543,59,7,3,4,2,1,1
6315,12600,9882,41,2,1,1,0,0,0
6316,12601,8564,69,6,1,5,3,1,2
6317,12601,7943,31,3,2,1,1,0,1
6318,12604,8686,59,7,2,5,1,1,0
6319,12604,8600,41,1,1,0,1,0,1
6320,12605,8533,46,4,2,2,1,1,0
6321,12605,8524,54,10,5,5,2,1,1
6322,12606,9880,65,7,3,4,1,0,1
6323,12606,8529,35,5,0,5,0,0,0
6324,12609,8636,51,9,7,2,2,2,0
6325,12609,10233,49,7,1,6,0,0,0
6326,12610,9885,41,4,4,0,2,0,2
6327,12610,9875,59,3,1,2,2,0,2
6328,12615,9804,45,5,1,4,2,0,2
6329,12615,9880,55,6,1,5,0,0,0
6330,12616,8533,34,10,5,5,2,2,0
6331,12616,8535,66,8,2,6,2,0,2
6332,12618,7943,44,7,6,1,1,0,1
6333,12618,10233,56,5,0,5,1,0,1
6334,12621,8564,70,11,6,5,2,1,1
6335,12621,8524,30,7,3,4,2,1,1
6336,12622,8686,58,4,1,3,3,1,2
6337,12622,8540,42,2,1,1,0,0,0
6338,12623,9882,53,5,2,3,1,1,0
6339,12623,10167,47,5,3,2,1,0,1
6340,12624,8600,45,10,4,6,1,1,0
6341,12624,8529,55,7,2,5,2,0,2
6342,12625,8529,53,9,5,4,2,2,0
6343,12625,8524,47,2,1,1,2,1,1
6344,12626,8686,58,2,1,1,1,0,1
6345,12626,8534,42,9,4,5,0,0,0
6346,12627,8535,65,12,5,7,1,1,0
6347,12627,10233,35,2,1,1,1,1,0
6348,12628,8540,51,4,2,2,1,0,1
6349,12628,9876,49,6,2,4,0,0,0
6350,12635,9876,41,8,4,4,2,0,2
6351,12635,8524,59,7,2,5,0,0,0
6352,12637,9885,60,16,9,7,2,1,1
6353,12637,8533,40,4,2,2,0,0,0
6354,12638,9875,54,8,3,5,4,3,1
6355,12638,10233,46,4,3,1,1,1,0
6356,12640,8540,53,9,3,6,3,3,0
6357,12640,9882,47,6,3,3,0,0,0
6358,12643,8636,68,7,3,4,2,1,1
6359,12643,9804,32,3,0,3,0,0,0
6360,12644,8534,69,6,3,3,1,1,0
6361,12644,8600,31,1,0,1,0,0,0
6362,12647,10233,49,7,4,3,1,1,0
6363,12647,8535,51,6,2,4,1,0,1
6364,12648,8540,68,6,5,1,2,2,0
6365,12648,9876,32,7,3,4,2,1,1
6366,12649,8636,69,8,4,4,1,0,1
6367,12649,7943,31,7,4,3,0,0,0
6368,12651,9880,37,5,4,1,1,0,1
6369,12651,8543,63,6,4,2,0,0,0
6370,12652,9875,59,7,2,5,2,0,2
6371,12652,8533,41,3,0,3,0,0,0
6372,12654,9882,60,3,2,1,4,4,0
6373,12654,9804,40,5,2,3,3,2,1
6374,12655,8524,33,5,4,1,4,2,2
6375,12655,8535,67,10,5,5,1,0,1
6376,12656,8534,56,4,3,1,1,1,0
6377,12656,9880,44,3,0,3,0,0,0
6378,12657,10167,45,4,3,1,1,1,0
6379,12657,8533,55,4,0,4,2,1,1
6380,12660,8636,44,4,3,1,4,1,3
6381,12660,8540,56,3,1,2,1,0,1
6382,12661,8529,55,7,3,4,1,1,0
6383,12661,8686,45,4,1,3,1,0,1
6384,12662,7943,52,5,3,2,1,0,1
6385,12662,9882,48,6,2,4,0,0,0
6386,12663,9804,34,3,1,2,3,2,1
6387,12663,9876,66,11,2,9,0,0,0
6388,12664,8600,48,5,3,2,2,2,0
6389,12664,9875,52,4,1,3,0,0,0
6390,12665,9804,47,10,2,8,1,1,0
6391,12665,8529,53,3,2,1,4,2,2
6392,12667,8535,44,8,5,3,1,0,1
6393,12667,7943,56,8,3,5,0,0,0
6394,12672,9875,63,4,3,1,4,1,3
6395,12672,8540,37,2,0,2,0,0,0
6396,12674,9882,70,5,3,2,2,1,1
6397,12674,8533,30,4,0,4,2,0,2
6398,12678,10233,60,5,4,1,1,0,1
6399,12678,9882,40,2,1,1,0,0,0
6400,12679,8636,55,9,6,3,1,0,1
6401,12679,8529,45,5,1,4,0,0,0
6402,12681,8686,77,11,4,7,2,1,1
6403,12681,9876,23,3,2,1,1,1,0
6404,12682,7943,44,4,2,2,1,1,0
6405,12682,9875,56,2,1,1,5,1,4
6406,12683,8535,62,9,6,3,1,0,1
6407,12683,9804,38,6,1,5,0,0,0
6408,12686,8535,40,6,3,3,1,0,1
6409,12686,8636,60,9,3,6,0,0,0
6410,12688,9885,45,3,1,2,2,1,1
6411,12688,8686,55,9,3,6,3,0,3
6412,12689,7943,43,5,2,3,1,0,1
6413,12689,8543,57,6,3,3,0,0,0
6414,12690,8564,60,5,3,2,2,2,0
6415,12690,8533,40,7,3,4,2,1,1
6416,12691,9875,66,6,3,3,1,0,1
6417,12691,9804,34,4,2,2,0,0,0
6418,12694,8600,46,3,2,1,2,0,2
6419,12694,9880,54,6,4,2,0,0,0
6420,12695,8524,48,3,2,1,1,1,0
6421,12695,10167,52,8,3,5,3,1,2
6422,12696,9882,44,7,4,3,2,1,1
6423,12696,8529,56,5,1,4,1,0,1
6424,12697,8543,41,10,5,5,2,1,1
6425,12697,8535,59,3,2,1,0,0,0
6426,12699,8564,55,10,4,6,3,2,1
6427,12699,9876,45,5,3,2,4,0,4
6428,12700,8636,66,6,4,2,3,1,2
6429,12700,9875,34,6,5,1,2,1,1
6430,12702,8686,60,5,3,2,2,2,0
6431,12702,8533,40,4,2,2,1,1,0
6432,12706,8533,35,6,3,3,3,2,1
6433,12706,10233,65,7,4,3,0,0,0
6434,12708,9885,45,4,1,3,2,1,1
6435,12708,8540,55,7,2,5,1,0,1
6436,12709,8543,43,6,4,2,3,2,1
6437,12709,9804,57,5,1,4,3,2,1
6438,12712,10167,48,4,1,3,1,1,0
6439,12712,7943,52,10,3,7,1,0,1
6440,12713,8686,61,10,6,4,2,2,0
6441,12713,9882,39,4,2,2,1,0,1
6442,12715,9875,80,11,5,6,1,1,0
6443,12715,8524,20,4,4,0,1,1,0
6444,12718,9885,59,6,3,3,2,1,1
6445,12718,10233,41,4,3,1,3,0,3
6446,12719,9876,47,2,1,1,4,1,3
6447,12719,8543,53,11,5,6,0,0,0
6448,12721,8533,31,8,4,4,3,1,2
6449,12721,8540,69,5,1,4,2,0,2
6450,12722,8686,51,4,4,0,3,3,0
6451,12722,9880,49,1,0,1,2,1,1
6452,12724,9804,60,5,2,3,5,3,2
6453,12724,10167,40,6,1,5,0,0,0
6454,12725,9880,65,8,4,4,1,1,0
6455,12725,9876,35,6,3,3,0,0,0
6456,12728,8529,40,8,4,4,1,1,0
6457,12728,8543,60,8,3,5,0,0,0
6458,12730,8686,33,3,1,2,1,1,0
6459,12730,9875,67,7,3,4,1,0,1
6460,12734,8600,43,9,5,4,5,2,3
6461,12734,10233,57,8,5,3,0,0,0
6462,12735,8535,59,10,5,5,2,2,0
6463,12735,8524,41,9,3,6,2,1,1
6464,12737,10167,60,3,2,1,2,2,0
6465,12737,8533,40,1,0,1,0,0,0
6466,12738,8543,53,7,6,1,1,0,1
6467,12738,10233,47,3,2,1,0,0,0
6468,12742,7943,56,5,2,3,1,0,1
6469,12742,9882,44,3,0,3,1,0,1
6470,12743,9804,49,7,2,5,2,1,1
6471,12743,9876,51,4,2,2,0,0,0
6472,12744,9875,53,4,3,1,1,0,1
6473,12744,8600,47,4,1,3,2,0,2
6474,12747,8534,51,9,4,5,2,1,1
6475,12747,8543,49,3,1,2,1,0,1
6476,12748,9875,40,4,4,0,5,3,2
6477,12748,8535,60,2,2,0,2,1,1
6478,12749,9876,40,7,0,7,1,1,0
6479,12749,8636,60,0,0,0,1,1,0
6480,12750,10167,35,3,1,2,2,1,1
6481,12750,9885,65,8,7,1,1,0,1
6482,12753,8564,60,13,8,5,1,0,1
6483,12753,9882,40,4,2,2,0,0,0
6484,12757,8540,34,5,3,2,1,1,0
6485,12757,10233,66,2,0,2,3,1,2
6486,12760,8636,51,7,2,5,3,1,2
6487,12760,8564,49,6,2,4,1,0,1
6488,12761,8529,53,5,3,2,4,3,1
6489,12761,9875,47,4,3,1,2,0,2
6490,12763,9804,62,11,8,3,1,0,1
6491,12763,7943,38,2,0,2,1,0,1
6492,12764,8600,47,3,2,1,2,1,1
6493,12764,8533,53,12,4,8,3,2,1
6494,12767,8543,41,12,6,6,2,0,2
6495,12767,8533,59,2,1,1,1,0,1
6496,12768,8524,52,7,2,5,2,1,1
6497,12768,8534,48,10,7,3,1,0,1
6498,12769,9804,37,4,3,1,1,1,0
6499,12769,9885,63,5,2,3,2,0,2
6500,12774,9876,28,9,5,4,2,1,1
6501,12774,7943,72,8,2,6,0,0,0
6502,12776,8529,58,6,5,1,3,1,2
6503,12776,8533,42,5,1,4,0,0,0
6504,12777,9885,45,6,5,1,2,1,1
6505,12777,8535,55,2,1,1,1,0,1
6506,12779,9876,42,6,1,5,4,3,1
6507,12779,9882,58,11,6,5,1,0,1
6508,12782,10167,29,2,1,1,1,1,0
6509,12782,8543,71,5,2,3,1,0,1
6510,12784,9804,54,5,2,3,3,1,2
6511,12784,8540,46,4,0,4,1,0,1
6512,12786,8636,71,11,5,6,1,0,1
6513,12786,8533,29,5,0,5,1,0,1
6514,12787,8534,37,12,9,3,2,1,1
6515,12787,9804,63,7,1,6,0,0,0
6516,12791,9875,78,7,1,6,2,1,1
6517,12791,8564,22,1,1,0,4,2,2
6518,12793,10167,46,8,3,5,2,0,2
6519,12793,8529,54,4,3,1,0,0,0
6520,12795,8540,66,11,3,8,2,1,1
6521,12795,8524,34,6,1,5,2,1,1
6522,12796,8529,51,9,2,7,3,2,1
6523,12796,9885,49,4,3,1,1,0,1
6524,12797,8535,41,4,1,3,2,1,1
6525,12797,8534,59,4,0,4,2,1,1
6526,12798,9876,40,5,4,1,3,1,2
6527,12798,8533,60,7,3,4,2,0,2
6528,12799,8543,26,9,5,4,3,3,0
6529,12799,8636,74,7,2,5,0,0,0
6530,12803,9880,61,9,2,7,1,0,1
6531,12803,7943,39,5,3,2,0,0,0
6532,12805,9875,71,4,1,3,1,1,0
6533,12805,9880,29,2,1,1,1,0,1
6534,12809,8636,63,11,6,5,1,0,1
6535,12809,9885,37,4,3,1,1,0,1
6536,12810,8543,52,3,2,1,2,1,1
6537,12810,9882,48,1,1,0,2,1,1
6538,12811,7943,43,4,1,3,1,0,1
6539,12811,8564,57,3,2,1,1,0,1
6540,12813,8535,63,9,4,5,1,0,1
6541,12813,10167,37,7,2,5,3,0,3
6542,12815,8533,51,8,2,6,3,1,2
6543,12815,8524,49,4,4,0,1,1,0
6544,12816,8529,57,4,1,3,2,2,0
6545,12816,9880,43,5,1,4,1,0,1
6546,12820,9875,44,11,4,7,2,2,0
6547,12820,9885,56,4,2,2,0,0,0
6548,12821,8543,61,9,4,5,3,1,2
6549,12821,8686,39,1,0,1,0,0,0
6550,12827,8636,62,9,6,3,6,3,3
6551,12827,8534,38,5,0,5,3,1,2
6552,12829,9876,34,6,3,3,1,0,1
6553,12829,9885,66,3,2,1,0,0,0
6554,12832,9882,67,8,3,5,3,3,0
6555,12832,10167,33,1,1,0,3,1,2
6556,12833,8600,47,4,3,1,2,2,0
6557,12833,8529,53,4,3,1,1,1,0
6558,12835,8534,38,5,2,3,3,2,1
6559,12835,8564,62,5,2,3,3,1,2
6560,12838,8636,42,6,2,4,2,1,1
6561,12838,8524,58,5,4,1,0,0,0
6562,12842,10167,37,4,2,2,1,1,0
6563,12842,8686,63,5,1,4,1,0,1
6564,12843,8533,48,3,1,2,2,0,2
6565,12843,9882,52,7,4,3,0,0,0
6566,12846,8533,29,7,5,2,5,2,3
6567,12846,8534,71,3,1,2,0,0,0
6568,12847,10233,49,5,2,3,2,1,1
6569,12847,9882,51,3,2,1,1,0,1
6570,12849,8543,45,9,4,5,3,2,1
6571,12849,8540,55,11,5,6,0,0,0
6572,12852,9804,47,7,5,2,3,3,0
6573,12852,8535,53,14,10,4,1,1,0
6574,12853,10167,61,11,5,6,2,1,1
6575,12853,8600,39,3,0,3,1,0,1
6576,12855,8535,44,7,4,3,2,1,1
6577,12855,8636,56,8,2,6,4,0,4
6578,12856,8529,42,8,7,1,1,1,0
6579,12856,9876,58,10,3,7,0,0,0
6580,12861,10233,43,6,5,1,1,1,0
6581,12861,10167,57,3,3,0,1,0,1
6582,12863,9880,51,4,2,2,1,1,0
6583,12863,8600,49,3,0,3,0,0,0
6584,12865,8529,63,3,2,1,1,0,1
6585,12865,9882,37,5,2,3,0,0,0
6586,12867,8534,54,5,3,2,3,1,2
6587,12867,10233,46,3,1,2,0,0,0
6588,12868,8564,47,4,2,2,4,1,3
6589,12868,9876,53,10,4,6,0,0,0
6590,12870,8540,54,3,1,2,2,1,1
6591,12870,9880,46,2,0,2,1,0,1
6592,12874,8636,71,8,1,7,2,2,0
6593,12874,9880,29,2,1,1,2,1,1
6594,12875,8533,31,5,3,2,3,2,1
6595,12875,10233,69,4,1,3,1,0,1
6596,12876,8529,43,9,6,3,1,1,0
6597,12876,8534,57,8,2,6,1,0,1
6598,12879,8564,54,7,2,5,1,0,1
6599,12879,8535,46,4,1,3,0,0,0
6600,12880,9875,64,14,11,3,1,1,0
6601,12880,9876,36,5,2,3,1,0,1
6602,12881,7943,42,5,2,3,3,2,1
6603,12881,10167,58,7,2,5,2,2,0
6604,12883,8524,65,8,3,5,3,1,2
6605,12883,8600,35,3,1,2,2,0,2
6606,12884,9875,73,7,4,3,4,1,3
6607,12884,8524,27,4,2,2,0,0,0
6608,12888,9876,42,4,2,2,2,1,1
6609,12888,8543,58,4,2,2,1,1,0
6610,12890,8533,46,7,3,4,4,2,2
6611,12890,8540,54,7,3,4,0,0,0
6612,12891,8686,75,7,3,4,2,0,2
6613,12891,9880,25,1,1,0,0,0,0
6614,12893,9804,45,7,2,5,5,2,3
6615,12893,10167,55,4,2,2,2,0,2
6616,12894,8534,54,9,8,1,1,1,0
6617,12894,8533,46,2,1,1,0,0,0
6618,12895,8535,67,9,6,3,2,0,2
6619,12895,8564,33,4,2,2,0,0,0
6620,12896,9891,53,5,3,2,1,1,0
6621,12896,9804,47,14,7,7,0,0,0
6622,12899,9885,65,15,6,9,2,0,2
6623,12899,8600,35,3,0,3,0,0,0
6624,12903,9875,64,9,3,6,4,1,3
6625,12903,7943,36,6,4,2,1,1,0
6626,12904,8524,52,4,2,2,2,1,1
6627,12904,8543,48,5,3,2,1,0,1
6628,12906,208931,45,5,2,3,2,2,0
6629,12906,9891,55,2,2,0,0,0,0
6630,12908,8533,48,4,3,1,1,0,1
6631,12908,8564,52,7,3,4,0,0,0
6632,12909,9875,60,11,5,6,1,1,0
6633,12909,8540,40,3,2,1,3,0,3
6634,12913,10233,57,2,2,0,1,0,1
6635,12913,9804,43,8,2,6,0,0,0
6636,12914,9857,38,2,2,0,2,1,1
6637,12914,8524,62,4,3,1,4,3,1
6638,12916,8533,48,4,1,3,3,1,2
6639,12916,9882,52,4,2,2,0,0,0
6640,12918,9875,59,12,4,8,4,2,2
6641,12918,10233,41,3,1,2,1,0,1
6642,12919,8686,64,11,4,7,2,2,0
6643,12919,8636,36,5,3,2,2,1,1
6644,12921,8564,38,2,2,0,2,1,1
6645,12921,8543,62,3,1,2,0,0,0
6646,12922,8534,54,7,5,2,1,1,0
6647,12922,8540,46,6,2,4,1,0,1
6648,12925,9891,52,9,5,4,3,3,0
6649,12925,10233,48,3,3,0,1,0,1
6650,12926,9876,60,8,5,3,2,0,2
6651,12926,9857,40,3,0,3,0,0,0
6652,12927,8564,37,5,3,2,4,1,3
6653,12927,8524,63,8,1,7,0,0,0
6654,12928,9875,57,11,5,6,2,0,2
6655,12928,8600,43,4,1,3,0,0,0
6656,12929,8533,45,7,2,5,1,0,1
6657,12929,8540,55,4,0,4,0,0,0
6658,12930,8686,35,4,3,1,2,1,1
6659,12930,8543,65,2,0,2,1,0,1
6660,12931,9882,37,3,2,1,3,1,2
6661,12931,8535,63,9,2,7,1,0,1
6662,12932,208931,44,3,3,0,3,2,1
6663,12932,7943,56,3,1,2,0,0,0
6664,12933,9804,58,9,2,7,2,1,1
6665,12933,8636,42,2,1,1,0,0,0
6666,12934,9804,32,6,4,2,3,3,0
6667,12934,8524,68,8,6,2,1,0,1
6668,12938,7943,55,5,3,2,2,0,2
6669,12938,10233,45,3,0,3,0,0,0
6670,12940,8636,62,12,6,6,1,1,0
6671,12940,9891,38,5,4,1,3,1,2
6672,12942,8543,62,8,8,0,2,1,1
6673,12942,8540,38,10,5,5,0,0,0
6674,12944,8533,48,4,4,0,2,0,2
6675,12944,8600,52,6,3,3,0,0,0
6676,12945,8534,24,2,1,1,5,3,2
6677,12945,8543,76,12,5,7,4,1,3
6678,12946,9876,44,12,7,5,1,0,1
6679,12946,9891,56,4,1,3,0,0,0
6680,12947,208931,49,5,2,3,3,1,2
6681,12947,10233,51,6,1,5,1,1,0
6682,12948,9882,54,5,3,2,4,1,3
6683,12948,8564,46,8,4,4,2,1,1
6684,12951,8686,61,10,4,6,2,1,1
6685,12951,8524,39,2,0,2,0,0,0
6686,12953,9804,59,7,5,2,2,1,1
6687,12953,9857,41,2,2,0,1,0,1
6688,12955,9857,35,2,1,1,2,2,0
6689,12955,9875,65,7,3,4,0,0,0
6690,12956,208931,35,6,4,2,1,1,0
6691,12956,8564,65,8,3,5,2,1,1
6692,12959,8534,42,5,4,1,2,1,1
6693,12959,9876,58,13,7,6,1,0,1
6694,12960,8636,58,6,5,1,2,1,1
6695,12960,10233,42,4,1,3,2,1,1
6696,12962,9882,53,4,2,2,2,1,1
6697,12962,7943,47,7,6,1,0,0,0
6698,12966,10233,64,13,8,5,2,0,2
6699,12966,9857,36,4,0,4,0,0,0
6700,12968,8543,56,3,3,0,2,0,2
6701,12968,9882,44,4,2,2,0,0,0
6702,12969,9876,41,4,3,1,5,2,3
6703,12969,8564,59,8,3,5,0,0,0
6704,12972,7943,54,6,3,3,1,1,0
6705,12972,9804,46,3,1,2,3,2,1
6706,12974,8524,51,10,5,5,2,1,1
6707,12974,9875,49,5,3,2,1,0,1
6708,12975,8534,40,9,4,5,2,0,2
6709,12975,9857,60,5,0,5,0,0,0
6710,12976,9885,70,4,4,0,4,1,3
6711,12976,208931,30,5,2,3,0,0,0
6712,12977,8535,60,8,4,4,2,1,1
6713,12977,8533,40,6,0,6,1,0,1
6714,12978,9891,37,7,4,3,3,1,2
6715,12978,8564,63,14,9,5,1,0,1
6716,12980,8543,33,5,3,2,3,1,2
6717,12980,8636,67,4,3,1,1,0,1
6718,12983,8600,36,7,4,3,1,1,0
6719,12983,9804,64,3,2,1,2,0,2
6720,12986,9882,40,4,2,2,2,0,2
6721,12986,10233,60,13,3,10,1,0,1
6722,12988,208931,38,1,0,1,2,0,2
6723,12988,8543,62,4,0,4,0,0,0
6724,12989,9857,52,3,1,2,1,1,0
6725,12989,8564,48,13,6,7,2,2,0
6726,12990,9875,59,8,4,4,1,1,0
6727,12990,9804,41,3,2,1,0,0,0
6728,12992,7943,62,11,2,9,2,1,1
6729,12992,9891,38,1,0,1,2,0,2
6730,12993,8600,48,7,3,4,1,0,1
6731,12993,8524,52,11,3,8,0,0,0
6732,12995,9857,58,5,1,4,3,0,3
6733,12995,8533,42,4,1,3,0,0,0
6734,12996,208931,29,7,5,2,1,0,1
6735,12996,8600,71,4,1,3,0,0,0
6736,12999,9876,62,12,5,7,2,1,1
6737,12999,8540,38,5,2,3,0,0,0
6738,13001,8686,52,5,3,2,1,0,1
6739,13001,8564,48,8,6,2,1,0,1
6740,13002,9885,46,5,2,3,2,1,1
6741,13002,9882,54,3,1,2,2,1,1
6742,13005,7943,53,5,1,4,3,2,1
6743,13005,9857,47,6,3,3,0,0,0
6744,13009,8534,52,9,2,7,2,2,0
6745,13009,8564,48,2,1,1,3,0,3
6746,13013,8600,72,10,4,6,1,0,1
6747,13013,8540,28,3,2,1,0,0,0
6748,13014,8534,62,7,1,6,2,0,2
6749,13014,8533,38,4,2,2,0,0,0
6750,13015,8535,68,3,1,2,1,1,0
6751,13015,8564,32,1,0,1,0,0,0
6752,13016,9804,45,10,5,5,1,1,0
6753,13016,9891,55,7,3,4,3,0,3
6754,13017,8686,62,6,1,5,3,2,1
6755,13017,9876,38,4,3,1,1,0,1
6756,13022,9882,64,7,4,3,1,1,0
6757,13022,208931,36,7,3,4,3,1,2
6758,13023,9875,63,7,3,4,3,1,2
6759,13023,7943,37,5,4,1,0,0,0
6760,13024,9891,43,5,3,2,3,1,2
6761,13024,8524,57,6,2,4,1,1,0
6762,13026,8636,68,9,4,5,2,1,1
6763,13026,208931,32,7,6,1,2,1,1
6764,13028,10233,49,4,3,1,1,1,0
6765,13028,9876,51,10,2,8,0,0,0
6766,13029,8534,68,8,5,3,1,1,0
6767,13029,8564,32,5,3,2,1,0,1
6768,13032,9804,52,5,2,3,1,0,1
6769,13032,8535,48,4,1,3,1,0,1
6770,13038,8636,47,6,4,2,5,2,3
6771,13038,8564,53,5,0,5,1,0,1
6772,13041,208931,51,5,3,2,3,1,2
6773,13041,8540,49,1,0,1,0,0,0
6774,13044,8524,51,9,5,4,2,0,2
6775,13044,9876,49,2,0,2,2,0,2
6776,13047,8636,52,10,6,4,1,1,0
6777,13047,8533,48,5,1,4,1,0,1
6778,13050,9875,59,4,2,2,2,0,2
6779,13050,8543,41,2,0,2,0,0,0
6780,13052,9804,56,3,2,1,3,2,1
6781,13052,9882,44,3,2,1,0,0,0
6782,13054,9875,71,8,4,4,3,1,2
6783,13054,208931,29,0,0,0,0,0,0
6784,13055,9804,61,9,5,4,2,1,1
6785,13055,8533,39,4,1,3,1,1,0
6786,13056,8534,56,4,4,0,2,1,1
6787,13056,8524,44,6,6,0,0,0,0
6788,13057,9857,60,9,4,5,1,1,0
6789,13057,8535,40,3,3,0,2,1,1
6790,13060,8543,53,2,1,1,1,1,0
6791,13060,10233,47,4,1,3,4,3,1
6792,13061,7943,68,9,3,6,1,0,1
6793,13061,8540,32,2,2,0,0,0,0
6794,13062,8686,49,4,3,1,4,1,3
6795,13062,9882,51,6,1,5,0,0,0
6796,13063,8564,65,14,7,7,6,3,3
6797,13063,8600,35,6,3,3,2,2,0
6798,13069,8535,60,8,4,4,1,0,1
6799,13069,8636,40,1,0,1,1,0,1
6800,13073,8540,60,9,2,7,2,1,1
6801,13073,9804,40,9,0,9,0,0,0
6802,13074,9804,62,7,4,3,3,2,1
6803,13074,208931,38,1,1,0,1,0,1
6804,13080,8564,32,3,1,2,2,2,0
6805,13080,9875,68,7,2,5,1,0,1
6806,13087,8533,45,10,3,7,2,0,2
6807,13087,10233,55,8,4,4,1,0,1
6808,13089,9885,48,4,4,0,1,1,0
6809,13089,8636,52,4,1,3,1,0,1
6810,13093,9804,54,6,3,3,3,2,1
6811,13093,8564,46,8,5,3,1,0,1
6812,13097,8535,51,3,1,2,2,1,1
6813,13097,8686,49,3,0,3,0,0,0
6814,13102,9882,46,7,6,1,1,1,0
6815,13102,9876,54,6,3,3,1,0,1
6816,13103,9891,37,3,1,2,3,0,3
6817,13103,8600,63,3,2,1,0,0,0
6818,13109,9875,63,8,2,6,1,1,0
6819,13109,8540,37,5,3,2,0,0,0
6820,13111,9882,31,7,5,2,4,2,2
6821,13111,8534,69,10,5,5,0,0,0
6822,13114,8534,37,5,4,1,3,1,2
6823,13114,9875,63,7,3,4,1,1,0
6824,13115,8535,39,4,3,1,2,1,1
6825,13115,10233,61,8,2,6,2,0,2
6826,13118,8564,56,9,6,3,6,3,3
6827,13118,8636,44,7,4,3,0,0,0
6828,13122,9857,45,5,4,1,3,2,1
6829,13122,9882,55,5,2,3,1,0,1
6830,13123,7943,67,7,3,4,2,1,1
6831,13123,8524,33,3,2,1,2,0,2
6832,13127,8535,66,14,6,8,1,1,0
6833,13127,9891,34,7,3,4,1,1,0
6834,13130,9885,57,6,4,2,2,2,0
6835,13130,9804,43,7,2,5,0,0,0
6836,13136,9857,67,6,2,4,2,1,1
6837,13136,9876,33,1,0,1,0,0,0
6838,13137,8564,60,6,2,4,3,2,1
6839,13137,8524,40,5,2,3,1,0,1
6840,13140,8543,47,5,2,3,1,1,0
6841,13140,8686,53,3,1,2,2,0,2
6842,13145,8686,63,4,3,1,2,2,0
6843,13145,9857,37,4,1,3,3,0,3
6844,13146,8533,65,6,3,3,1,1,0
6845,13146,208931,35,5,1,4,0,0,0
6846,13152,8543,63,8,5,3,1,0,1
6847,13152,8540,37,5,0,5,0,0,0
6848,13155,8543,44,6,2,4,3,1,2
6849,13155,8534,56,2,2,0,0,0,0
6850,13157,208931,59,6,3,3,2,1,1
6851,13157,10233,41,7,3,4,1,1,0
6852,13158,8564,51,7,6,1,5,1,4
6853,13158,9882,49,4,3,1,0,0,0
6854,13160,9885,57,3,2,1,1,1,0
6855,13160,8540,43,6,3,3,1,0,1
6856,13162,8535,47,5,4,1,3,1,2
6857,13162,7943,53,2,0,2,0,0,0
6858,13163,9804,51,2,2,0,1,0,1
6859,13163,9857,49,3,1,2,1,0,1
6860,13166,8564,73,11,4,7,1,0,1
6861,13166,208931,27,2,0,2,0,0,0
6862,13167,8535,52,5,3,2,5,5,0
6863,13167,8600,48,3,1,2,2,0,2
6864,13168,8533,70,8,4,4,5,3,2
6865,13168,9891,30,1,1,0,1,1,0
6866,13169,8534,56,8,6,2,3,2,1
6867,13169,9876,44,10,3,7,0,0,0
6868,13172,7943,70,7,1,6,2,1,1
6869,13172,9882,30,2,1,1,1,0,1
6870,13173,9804,45,5,1,4,3,1,2
6871,13173,8686,55,7,6,1,2,0,2
6872,13174,8524,35,10,3,7,2,1,1
6873,13174,8533,65,5,1,4,2,1,1
6874,13178,9882,46,6,2,4,1,0,1
6875,13178,8543,54,6,3,3,0,0,0
6876,13180,8686,41,3,3,0,1,1,0
6877,13180,9875,59,4,2,2,1,0,1
6878,13181,8540,39,1,1,0,3,2,1
6879,13181,9891,61,6,1,5,2,1,1
6880,13183,8636,58,13,6,7,1,1,0
6881,13183,8600,42,6,2,4,0,0,0
6882,13184,9875,68,10,5,5,2,2,0
6883,13184,8524,32,1,0,1,1,0,1
6884,13186,9885,68,7,5,2,1,1,0
6885,13186,208931,32,3,1,2,4,2,2
6886,13187,8535,53,9,5,4,3,1,2
6887,13187,8533,47,6,2,4,0,0,0
6888,13188,9891,22,4,1,3,3,1,2
6889,13188,8564,78,12,8,4,1,0,1
6890,13191,10233,37,6,4,2,2,2,0
6891,13191,8686,63,7,4,3,3,2,1
6892,13195,8636,46,6,5,1,3,3,0
6893,13195,8534,54,4,2,2,3,0,3
6894,13196,10233,39,7,6,1,4,2,2
6895,13196,9882,61,5,2,3,0,0,0
6896,13197,9876,38,6,2,4,4,3,1
6897,13197,9885,62,9,1,8,3,1,2
6898,13198,208931,59,10,1,9,3,0,3
6899,13198,8543,41,7,5,2,0,0,0
6900,13199,8564,56,6,3,3,2,1,1
6901,13199,9857,44,3,1,2,0,0,0
6902,13200,9875,54,7,6,1,3,2,1
6903,13200,9804,46,5,3,2,1,0,1
6904,13201,8535,51,11,6,5,1,1,0
6905,13201,8540,49,2,2,0,0,0,0
6906,13203,8524,55,5,5,0,1,1,0
6907,13203,8600,45,1,1,0,2,0,2
6908,13204,10233,55,4,1,3,1,1,0
6909,13204,8524,45,4,3,1,0,0,0
6910,13205,9857,54,8,4,4,3,1,2
6911,13205,8533,46,4,2,2,2,0,2
6912,13208,9891,30,5,2,3,3,2,1
6913,13208,9875,70,16,12,4,1,1,0
6914,13209,9876,66,4,2,2,1,0,1
6915,13209,8540,34,0,0,0,1,0,1
6916,13210,8636,45,5,4,1,1,1,0
6917,13210,7943,55,2,0,2,0,0,0
6918,13212,9882,36,3,2,1,2,1,1
6919,13212,9885,64,8,3,5,2,0,2
6920,13215,9891,54,7,2,5,3,1,2
6921,13215,9857,46,7,6,1,2,0,2
6922,13217,8533,48,5,4,1,1,1,0
6923,13217,8636,52,4,2,2,3,0,3
6924,13218,9885,46,4,3,1,1,1,0
6925,13218,10233,54,2,0,2,1,1,0
6926,13220,9875,65,6,4,2,1,0,1
6927,13220,8543,35,3,0,3,0,0,0
6928,13221,7943,25,9,5,4,5,3,2
6929,13221,8686,75,10,5,5,0,0,0
6930,13222,9804,45,10,7,3,1,1,0
6931,13222,9882,55,8,1,7,4,1,3
6932,13225,9804,60,2,1,1,4,3,1
6933,13225,8533,40,5,1,4,3,3,0
6934,13229,9885,75,16,5,11,1,0,1
6935,13229,9891,25,3,1,2,1,0,1
6936,13230,8543,65,4,3,1,3,3,0
6937,13230,10233,35,4,3,1,4,3,1
6938,13232,9882,36,5,1,4,2,2,0
6939,13232,8686,64,17,4,13,2,1,1
6940,13240,9875,53,4,1,3,2,1,1
6941,13240,9885,47,5,1,4,4,0,4
6942,13241,8686,72,6,4,2,1,1,0
6943,13241,208931,28,8,1,7,0,0,0
6944,13242,7943,57,8,1,7,1,1,0
6945,13242,8533,43,5,4,1,1,1,0
6946,13243,9804,46,6,2,4,1,0,1
6947,13243,8540,54,2,0,2,2,0,2
6948,13246,8534,51,6,2,4,2,0,2
6949,13246,7943,49,2,0,2,0,0,0
6950,13248,9885,67,6,3,3,2,1,1
6951,13248,9857,33,0,0,0,3,1,2
6952,13250,8564,36,8,4,4,3,2,1
6953,13250,9875,64,6,3,3,2,1,1
6954,13251,8540,36,4,1,3,1,0,1
6955,13251,8686,64,7,3,4,0,0,0
6956,13252,9882,30,6,5,1,5,2,3
6957,13252,8636,70,10,4,6,0,0,0
6958,13257,10233,37,5,4,1,2,0,2
6959,13257,8533,63,9,3,6,0,0,0
6960,13260,8535,56,5,4,1,2,0,2
6961,13260,9875,44,6,2,4,0,0,0
6962,13262,7943,42,7,1,6,1,1,0
6963,13262,8543,58,5,2,3,2,0,2
6964,13264,208931,26,4,4,0,6,6,0
6965,13264,9857,74,4,2,2,1,1,0
6966,13266,8534,44,5,3,2,1,0,1
6967,13266,10233,56,7,3,4,0,0,0
6968,13268,9885,71,8,6,2,1,1,0
6969,13268,8524,29,1,1,0,2,1,1
6970,13270,7943,38,2,2,0,2,2,0
6971,13270,8564,62,7,0,7,2,1,1
6972,13272,9882,48,4,3,1,1,1,0
6973,13272,9876,52,5,1,4,1,0,1
6974,13694,10235,60,6,3,3,1,1,0
6975,13694,8593,40,8,3,5,1,0,1
6976,14119,8640,44,10,5,5,2,2,0
6977,14119,10235,56,8,5,3,1,0,1
6978,14206,8593,54,4,3,1,4,1,3
6979,14206,10235,46,7,3,4,2,1,1
6980,14251,8640,56,8,3,5,6,3,3
6981,14251,10235,44,9,3,6,1,1,0
6982,14287,10235,42,9,6,3,4,2,2
6983,14287,8593,58,5,2,3,1,1,0
6984,14368,8593,63,5,4,1,6,4,2
6985,14368,8640,37,1,0,1,0,0,0
6986,14467,8593,53,6,2,4,2,1,1
6987,14467,8640,47,8,2,6,0,0,0
6988,15416,10228,47,8,3,5,2,0,2
6989,15416,8526,53,6,2,4,0,0,0
6990,15419,8640,51,4,1,3,3,1,2
6991,15419,10217,49,2,0,2,0,0,0
6992,15420,10235,33,3,2,1,4,2,2
6993,15420,9908,67,6,2,4,2,1,1
6994,15421,8593,55,6,3,3,2,0,2
6995,15421,10229,45,7,4,3,1,0,1
6996,15422,10218,44,2,1,1,1,0,1
6997,15422,8464,56,4,3,1,0,0,0
6998,15423,8674,62,11,7,4,1,0,1
6999,15423,8611,38,2,0,2,1,0,1
7000,15424,8277,51,8,5,3,2,1,1
7001,15424,8525,49,5,4,1,0,0,0
7002,15425,6413,51,3,3,0,3,1,2
7003,15425,9908,49,3,1,2,2,0,2
7004,15430,7788,57,11,6,5,1,1,0
7005,15430,10217,43,8,1,7,1,0,1
7006,15431,8277,45,8,7,1,2,1,1
7007,15431,8593,55,7,4,3,0,0,0
7008,15433,10235,60,7,3,4,1,1,0
7009,15433,10229,40,11,3,8,3,1,2
7010,15434,8525,57,2,2,0,2,1,1
7011,15434,9791,43,5,2,3,0,0,0
7012,15435,6413,62,9,3,6,1,0,1
7013,15435,8674,38,2,1,1,0,0,0
7014,15437,8277,72,4,3,1,3,1,2
7015,15437,10218,28,12,4,8,3,1,2
7016,15438,8640,56,12,9,3,4,2,2
7017,15438,8526,44,8,1,7,0,0,0
7018,15439,10235,60,9,2,7,2,2,0
7019,15439,10217,40,2,1,1,1,0,1
7020,15441,9908,45,3,2,1,2,1,1
7021,15441,8611,55,9,0,9,4,1,3
7022,15443,10217,64,7,3,4,2,1,1
7023,15443,9803,36,1,0,1,2,2,0
7024,15444,10228,36,5,3,2,2,1,1
7025,15444,8611,64,2,2,0,2,0,2
7026,15445,8526,41,8,1,7,3,0,3
7027,15445,8464,59,2,1,1,0,0,0
7028,15447,6413,61,10,6,4,2,1,1
7029,15447,9791,39,5,0,5,0,0,0
7030,15451,10229,62,8,2,6,1,1,0
7031,15451,8277,38,3,2,1,0,0,0
7032,15453,9803,65,11,4,7,2,1,1
7033,15453,6413,35,4,2,2,6,3,3
7034,15456,8526,42,10,8,2,1,1,0
7035,15456,8674,58,2,2,0,3,1,2
7036,15457,10218,46,6,3,3,3,3,0
7037,15457,9791,54,9,1,8,3,0,3
7038,15462,10228,65,10,6,4,4,3,1
7039,15462,9803,35,1,0,1,3,1,2
7040,15464,8525,36,7,6,1,3,2,1
7041,15464,8611,64,11,6,5,0,0,0
7042,15467,8674,59,7,4,3,1,1,0
7043,15467,10217,41,2,0,2,2,1,1
7044,15468,9791,61,5,2,3,2,1,1
7045,15468,9908,39,4,1,3,2,0,2
7046,15470,10229,66,6,3,3,3,1,2
7047,15470,10217,34,6,2,4,2,0,2
7048,15471,8611,54,12,7,5,1,1,0
7049,15471,10218,46,3,1,2,0,0,0
7050,15472,8526,56,3,1,2,1,1,0
7051,15472,9908,44,6,4,2,3,1,2
7052,15473,8277,53,7,4,3,1,1,0
7053,15473,8640,47,7,2,5,2,0,2
7054,15475,8525,41,6,1,5,4,3,1
7055,15475,7788,59,4,0,4,2,1,1
7056,15476,10235,56,7,5,2,3,2,1
7057,15476,9791,44,3,1,2,2,0,2
7058,15478,9803,41,8,2,6,2,1,1
7059,15478,8674,59,5,1,4,2,0,2
7060,15479,10218,47,7,3,4,1,1,0
7061,15479,10228,53,13,5,8,2,0,2
7062,15480,8611,45,9,5,4,2,2,0
7063,15480,8526,55,8,0,8,2,2,0
7064,15481,8464,55,2,1,1,3,2,1
7065,15481,7788,45,3,2,1,1,0,1
7066,15483,10217,26,10,4,6,4,3,1
7067,15483,8525,74,1,0,1,2,2,0
7068,15484,8593,61,6,6,0,1,0,1
7069,15484,9908,39,4,3,1,1,0,1
7070,15486,10235,42,5,3,2,3,2,1
7071,15486,8674,58,9,2,7,2,1,1
7072,15491,6413,38,8,3,5,3,0,3
7073,15491,8640,62,5,1,4,0,0,0
7074,15492,9908,57,7,4,3,2,1,1
7075,15492,10229,43,4,0,4,1,0,1
7076,15494,10228,64,12,6,6,3,2,1
7077,15494,10217,36,5,1,4,2,1,1
7078,15496,8593,69,11,5,6,1,0,1
7079,15496,8526,31,5,3,2,0,0,0
7080,15497,8611,43,2,2,0,2,0,2
7081,15497,9791,57,5,4,1,0,0,0
7082,15498,8277,39,4,2,2,3,2,1
7083,15498,7788,61,4,2,2,0,0,0
7084,15499,10228,44,4,2,2,3,1,2
7085,15499,6413,56,8,3,5,2,1,1
7086,15500,10229,24,3,2,1,4,3,1
7087,15500,9803,76,7,1,6,2,1,1
7088,15501,10218,51,4,3,1,3,3,0
7089,15501,8526,49,2,1,1,1,0,1
7090,15502,8593,51,6,2,4,1,1,0
7091,15502,10217,49,6,1,5,2,1,1
7092,15503,10235,64,4,2,2,1,0,1
7093,15503,8640,36,6,2,4,1,0,1
7094,15504,8674,48,6,4,2,3,2,1
7095,15504,9908,52,9,4,5,1,0,1
7096,15506,8464,45,7,3,4,1,0,1
7097,15506,8674,55,9,3,6,1,0,1
7098,15507,8526,42,2,1,1,4,1,3
7099,15507,9791,58,3,1,2,0,0,0
7100,15508,8277,61,7,3,4,1,0,1
7101,15508,8593,39,5,1,4,0,0,0
7102,15509,10218,49,6,5,1,1,0,1
7103,15509,9803,51,5,2,3,0,0,0
7104,15510,10228,61,7,3,4,2,1,1
7105,15510,8525,39,6,4,2,1,0,1
7106,15512,6413,45,7,5,2,1,1,0
7107,15512,9908,55,10,4,6,1,1,0
7108,15513,8611,44,6,1,5,3,1,2
7109,15513,8640,56,7,3,4,1,1,0
7110,15515,8277,77,7,3,4,5,1,4
7111,15515,9803,23,4,2,2,2,0,2
7112,15518,8611,57,6,3,3,2,0,2
7113,15518,10217,43,1,0,1,2,0,2
7114,15519,10229,60,4,1,3,1,1,0
7115,15519,10218,40,4,1,3,0,0,0
7116,15520,8674,47,7,5,2,1,1,0
7117,15520,8640,53,8,3,5,2,0,2
7118,15524,8674,48,3,1,2,1,1,0
7119,15524,8525,52,4,2,2,0,0,0
7120,15525,8593,60,8,2,6,3,0,3
7121,15525,9791,40,1,1,0,2,0,2
7122,15526,7788,44,6,2,4,2,2,0
7123,15526,10229,56,5,2,3,1,0,1
7124,15527,8464,41,5,3,2,2,2,0
7125,15527,8611,59,12,3,9,1,1,0
7126,15529,8640,64,5,3,2,6,4,2
7127,15529,10218,36,2,1,1,0,0,0
7128,15530,8277,65,4,3,1,2,1,1
7129,15530,6413,35,4,0,4,1,0,1
7130,15531,9803,49,8,4,4,1,1,0
7131,15531,9908,51,7,3,4,1,0,1
7132,15532,10235,58,8,4,4,2,0,2
7133,15532,10228,42,8,1,7,0,0,0
7134,15534,8277,73,10,5,5,2,2,0
7135,15534,10218,27,7,2,5,1,0,1
7136,15535,8674,44,6,4,2,4,3,1
7137,15535,6413,56,8,6,2,1,0,1
7138,15537,8464,48,4,3,1,1,1,0
7139,15537,10229,52,8,4,4,1,0,1
7140,15540,10235,72,9,2,7,3,2,1
7141,15540,10217,28,1,1,0,1,1,0
7142,15541,8611,43,7,4,3,2,1,1
7143,15541,9908,57,5,1,4,0,0,0
7144,15546,9791,40,7,5,2,3,1,2
7145,15546,6413,60,2,2,0,2,1,1
7146,15547,10235,34,6,4,2,1,0,1
7147,15547,8593,66,3,2,1,3,0,3
7148,15549,7788,56,4,2,2,5,2,3
7149,15549,8674,44,8,3,5,1,0,1
7150,15551,7788,44,5,5,0,1,1,0
7151,15551,9908,56,7,3,4,0,0,0
7152,15552,9791,66,6,4,2,3,2,1
7153,15552,10229,34,6,1,5,0,0,0
7154,15554,9803,62,4,2,2,1,0,1
7155,15554,8611,38,3,2,1,1,0,1
7156,15557,6413,43,5,5,0,4,0,4
7157,15557,10235,57,11,4,7,0,0,0
7158,15558,10217,54,4,1,3,3,2,1
7159,15558,10218,46,7,4,3,0,0,0
7160,15560,6413,37,5,0,5,3,1,2
7161,15560,10217,63,3,0,3,0,0,0
7162,15562,10228,58,7,4,3,1,1,0
7163,15562,8464,42,5,1,4,1,1,0
7164,15563,8640,49,10,7,3,5,4,1
7165,15563,9791,51,3,3,0,2,1,1
7166,15564,7788,58,4,3,1,2,0,2
7167,15564,8611,42,6,2,4,0,0,0
7168,15566,8525,47,1,1,0,3,2,1
7169,15566,9908,53,6,1,5,1,0,1
7170,15568,8277,67,6,2,4,2,1,1
7171,15568,8526,33,8,5,3,1,0,1
7172,15569,10218,38,6,2,4,1,1,0
7173,15569,8464,62,3,3,0,0,0,0
7174,15571,6413,35,6,3,3,2,1,1
7175,15571,7788,65,7,1,6,0,0,0
7176,15572,8640,61,9,5,4,3,2,1
7177,15572,10217,39,3,1,2,0,0,0
7178,15574,9803,41,6,4,2,3,1,2
7179,15574,9791,59,4,3,1,2,2,0
7180,15576,9908,61,11,5,6,1,1,0
7181,15576,10235,39,4,0,4,2,2,0
7182,15578,8611,65,6,2,4,2,2,0
7183,15578,10217,35,1,1,0,0,0,0
7184,15580,10229,58,11,3,8,2,1,1
7185,15580,10218,42,3,0,3,1,0,1
7186,15584,8525,49,8,4,4,1,1,0
7187,15584,8593,51,8,7,1,1,1,0
7188,15585,8277,61,8,3,5,3,0,3
7189,15585,9803,39,3,1,2,0,0,0
7190,15586,10235,49,7,3,4,2,2,0
7191,15586,7788,51,3,0,3,2,1,1
7192,15587,9803,62,11,2,9,1,1,0
7193,15587,8526,38,7,0,7,0,0,0
7194,15590,6413,64,7,4,3,1,1,0
7195,15590,8611,36,7,2,5,1,0,1
7196,15591,10218,33,3,2,1,2,2,0
7197,15591,8674,67,7,2,5,1,1,0
7198,15594,10235,51,4,3,1,6,2,4
7199,15594,8277,49,2,1,1,2,1,1
7200,15596,10218,60,3,1,2,4,2,2
7201,15596,9908,40,7,4,3,1,0,1
7202,15597,10228,63,11,3,8,1,1,0
7203,15597,9791,37,4,1,3,3,1,2
7204,15598,10235,73,15,8,7,2,1,1
7205,15598,8526,27,3,3,0,1,0,1
7206,15600,7788,69,7,3,4,1,0,1
7207,15600,9803,31,3,0,3,0,0,0
7208,15602,8674,43,6,5,1,4,3,1
7209,15602,8277,57,7,3,4,0,0,0
7210,15603,10217,43,3,1,2,1,1,0
7211,15603,8464,57,5,2,3,0,0,0
7212,15604,8593,47,6,4,2,5,2,3
7213,15604,8640,53,4,2,2,1,0,1
7214,15605,9908,58,10,4,6,1,1,0
7215,15605,9791,42,1,0,1,4,1,3
7216,15606,8526,43,4,1,3,3,0,3
7217,15606,7788,57,4,1,3,1,0,1
7218,15608,10235,61,10,4,6,4,1,3
7219,15608,10218,39,1,0,1,1,0,1
7220,15609,8611,49,5,1,4,3,2,1
7221,15609,8525,51,6,3,3,0,0,0
7222,15612,10217,69,13,4,9,1,1,0
7223,15612,8674,31,4,2,2,1,0,1
7224,15614,8674,57,6,5,1,1,1,0
7225,15614,10218,43,5,3,2,3,1,2
7226,15615,9803,44,4,2,2,2,1,1
7227,15615,8526,56,4,3,1,0,0,0
7228,15623,6413,62,4,3,1,1,1,0
7229,15623,9803,38,4,2,2,1,1,0
7230,15624,9791,47,3,1,2,5,2,3
7231,15624,10218,53,4,2,2,0,0,0
7232,15626,8277,54,9,3,6,1,0,1
7233,15626,10217,46,3,2,1,3,0,3
7234,15627,8525,53,6,4,2,4,1,3
7235,15627,8640,47,4,1,3,2,0,2
7236,15629,9908,57,6,2,4,2,0,2
7237,15629,8464,43,4,3,1,0,0,0
7238,15630,8674,54,9,2,7,1,0,1
7239,15630,8526,46,8,3,5,1,0,1
7240,15631,10235,61,6,3,3,4,4,0
7241,15631,8611,39,5,3,2,2,1,1
7242,15632,8611,39,3,1,2,2,0,2
7243,15632,8526,61,7,3,4,0,0,0
7244,15633,9791,39,4,1,3,3,2,1
7245,15633,8277,61,5,0,5,0,0,0
7246,15635,10229,61,18,10,8,2,1,1
7247,15635,6413,39,3,1,2,2,1,1
7248,15636,9803,41,3,2,1,2,1,1
7249,15636,8640,59,3,1,2,3,0,3
7250,15637,8593,59,8,2,6,2,1,1
7251,15637,9908,41,3,1,2,0,0,0
7252,15638,8525,61,8,2,6,3,2,1
7253,15638,10217,39,2,0,2,2,1,1
7254,15641,8674,55,4,3,1,5,1,4
7255,15641,9803,45,4,3,1,0,0,0
7256,15642,8277,60,8,3,5,2,1,1
7257,15642,8640,40,11,4,7,0,0,0
7258,15643,10218,32,2,1,1,2,1,1
7259,15643,8611,68,6,1,5,2,1,1
7260,15644,10229,62,2,1,1,3,1,2
7261,15644,10217,38,5,2,3,0,0,0
7262,15647,8526,33,9,4,5,2,1,1
7263,15647,9908,67,12,7,5,0,0,0
7264,15650,10228,51,5,4,1,4,2,2
7265,15650,8674,49,1,1,0,1,0,1
7266,15651,8526,44,3,1,2,3,0,3
7267,15651,10229,56,9,2,7,0,0,0
7268,15652,10235,53,4,2,2,2,1,1
7269,15652,8525,47,3,1,2,0,0,0
7270,15653,8593,75,11,8,3,2,2,0
7271,15653,8611,25,5,2,3,3,0,3
7272,15654,8640,38,10,6,4,2,1,1
7273,15654,7788,62,7,4,3,1,0,1
7274,15656,9791,55,12,3,9,1,1,0
7275,15656,10217,45,3,0,3,3,0,3
7276,15659,7788,82,15,6,9,3,1,2
7277,15659,10218,18,2,1,1,0,0,0
7278,15662,8640,55,8,4,4,1,1,0
7279,15662,6413,45,6,5,1,2,1,1
7280,15663,8593,63,11,3,8,2,1,1
7281,15663,8526,37,3,0,3,0,0,0
7282,15665,8674,49,6,2,4,2,2,0
7283,15665,9791,51,4,0,4,1,0,1
7284,15666,10217,42,8,4,4,2,1,1
7285,15666,10228,58,2,1,1,0,0,0
7286,15667,8277,64,12,2,10,5,1,4
7287,15667,8611,36,4,0,4,3,2,1
7288,15669,8674,47,4,2,2,3,2,1
7289,15669,9908,53,3,2,1,1,0,1
7290,15670,10228,64,6,4,2,3,2,1
7291,15670,6413,36,4,0,4,1,1,0
7292,15671,10218,71,7,3,4,1,1,0
7293,15671,8526,29,4,1,3,0,0,0
7294,15674,9803,40,5,3,2,2,0,2
7295,15674,10229,60,4,2,2,1,0,1
7296,15676,8640,40,10,8,2,3,3,0
7297,15676,10235,60,4,1,3,1,1,0
7298,15677,8526,51,6,4,2,4,3,1
7299,15677,10229,49,7,5,2,1,0,1
7300,15679,8593,68,7,1,6,2,0,2
7301,15679,8611,32,2,0,2,0,0,0
7302,15680,7788,27,2,2,0,1,0,1
7303,15680,8640,73,10,7,3,0,0,0
7304,15682,8674,47,12,6,6,2,2,0
7305,15682,10228,53,5,3,2,3,2,1
7306,15687,8611,45,6,2,4,3,1,2
7307,15687,7788,55,0,0,0,1,1,0
7308,15690,8525,49,5,2,3,4,1,3
7309,15690,9908,51,3,0,3,1,1,0
7310,15691,9803,43,8,3,5,1,1,0
7311,15691,10235,57,6,2,4,3,1,2
7312,15692,8593,54,7,2,5,1,1,0
7313,15692,10218,46,2,0,2,4,1,3
7314,15697,8593,48,7,3,4,1,0,1
7315,15697,8674,52,2,1,1,1,0,1
7316,15698,10229,44,10,3,7,3,2,1
7317,15698,9791,56,3,2,1,2,0,2
7318,15701,10235,56,6,2,4,2,2,0
7319,15701,6413,44,2,1,1,0,0,0
7320,15705,8464,55,8,2,6,1,0,1
7321,15705,10217,45,4,2,2,0,0,0
7322,15707,8525,60,7,4,3,5,1,4
7323,15707,6413,40,7,3,4,1,1,0
7324,15708,10218,38,6,4,2,2,1,1
7325,15708,9908,62,7,2,5,0,0,0
7326,15709,10235,58,6,5,1,1,1,0
7327,15709,8526,42,8,6,2,3,1,2
7328,15710,8593,42,3,2,1,2,1,1
7329,15710,8640,58,13,6,7,3,1,2
7330,15711,8277,49,10,4,6,3,3,0
7331,15711,8674,51,2,0,2,3,1,2
7332,15713,7788,56,10,6,4,1,1,0
7333,15713,10229,44,6,2,4,1,0,1
7334,15714,8674,43,6,3,3,2,1,1
7335,15714,8525,57,3,0,3,0,0,0
7336,15717,8640,60,15,7,8,5,4,1
7337,15717,10218,40,7,2,5,1,0,1
7338,15718,8464,58,7,4,3,3,0,3
7339,15718,8611,42,7,4,3,0,0,0
7340,15719,10235,61,4,2,2,2,1,1
7341,15719,10228,39,2,1,1,2,2,0
7342,15721,8277,75,15,7,8,2,1,1
7343,15721,6413,25,6,3,3,1,0,1
7344,21518,8661,46,4,3,1,1,0,1
7345,21518,10267,54,5,3,2,0,0,0
7346,21520,8633,61,12,5,7,1,1,0
7347,21520,9783,39,2,1,1,0,0,0
7348,21539,10267,66,10,5,5,4,3,1
7349,21539,9869,34,3,0,3,2,1,1
7350,21544,9864,54,8,4,4,1,0,1
7351,21544,10205,46,6,3,3,0,0,0
7352,21545,10281,48,2,1,1,8,4,4
7353,21545,8633,52,11,2,9,1,0,1
7354,21550,8634,72,7,5,2,2,0,2
7355,21550,8305,28,7,4,3,0,0,0
7356,21553,8315,43,6,3,3,2,0,2
7357,21553,9783,57,8,7,1,0,0,0
7358,21555,8479,39,3,1,2,3,1,2
7359,21555,8633,61,8,3,5,1,1,0
7360,21559,10205,41,3,2,1,2,0,2
7361,21559,8479,59,4,1,3,0,0,0
7362,21561,8696,47,3,2,1,1,1,0
7363,21561,9906,53,3,0,3,4,2,2
7364,21564,8634,65,13,7,6,1,1,0
7365,21564,8302,35,3,2,1,0,0,0
7366,21566,8633,53,6,4,2,1,1,0
7367,21566,8305,47,3,1,2,1,0,1
7368,21570,8479,36,4,1,3,7,4,3
7369,21570,8661,64,2,2,0,1,1,0
7370,21571,10205,55,7,2,5,6,2,4
7371,21571,8305,45,2,1,1,1,1,0
7372,21572,8634,59,5,4,1,3,2,1
7373,21572,10267,41,2,2,0,0,0,0
7374,21576,8633,60,12,5,7,2,1,1
7375,21576,8302,40,6,1,5,1,0,1
7376,21578,8634,77,10,6,4,1,0,1
7377,21578,8633,23,3,2,1,0,0,0
7378,21580,9906,44,10,5,5,2,0,2
7379,21580,8603,56,5,3,2,0,0,0
7380,21582,9783,144,5,2,3,3,1,2
7381,21582,10281,-44,3,0,3,0,0,0
7382,21585,8302,59,10,5,5,2,1,1
7383,21585,10205,41,2,0,2,3,0,3
7384,21586,8558,27,2,1,1,3,3,0
7385,21586,10267,73,11,5,6,3,1,2
7386,21588,8315,47,4,1,3,3,3,0
7387,21588,8603,53,3,0,3,0,0,0
7388,21592,8661,44,8,3,5,2,2,0
7389,21592,8302,56,3,0,3,3,1,2
7390,21595,8558,40,8,5,3,3,2,1
7391,21595,9906,60,5,1,4,0,0,0
7392,21598,8305,53,7,2,5,2,0,2
7393,21598,9783,47,5,3,2,1,0,1
7394,21602,8371,43,1,1,0,4,2,2
7395,21602,8302,57,4,1,3,1,0,1
7396,21604,8633,48,10,3,7,2,2,0
7397,21604,10205,52,7,1,6,4,2,2
7398,21611,8558,64,10,4,6,2,1,1
7399,21611,9865,36,2,0,2,0,0,0
7400,21614,8634,66,8,4,4,2,1,1
7401,21614,8371,34,3,1,2,0,0,0
7402,21617,8302,43,2,1,1,4,2,2
7403,21617,9783,57,6,0,6,0,0,0
7404,21619,9865,47,6,2,4,1,0,1
7405,21619,9906,53,6,0,6,0,0,0
7406,21624,8302,66,8,1,7,1,1,0
7407,21624,8388,34,6,5,1,2,1,1
7408,21625,8634,66,9,6,3,1,0,1
7409,21625,9783,34,1,0,1,0,0,0
7410,21626,8633,49,6,4,2,3,1,2
7411,21626,8371,51,2,1,1,1,0,1
7412,21629,8633,53,13,9,4,3,1,2
7413,21629,8388,47,3,1,2,0,0,0
7414,21630,8634,66,13,4,9,4,1,3
7415,21630,8696,34,1,0,1,3,0,3
7416,21631,8302,63,10,4,6,1,0,1
7417,21631,9869,37,7,2,5,0,0,0
7418,21636,9865,51,6,3,3,1,0,1
7419,21636,10267,49,2,1,1,0,0,0
7420,21638,8634,72,8,4,4,2,2,0
7421,21638,8388,28,1,0,1,0,0,0
7422,21639,8633,48,9,4,5,3,1,2
7423,21639,9783,52,5,1,4,0,0,0
7424,21646,9906,52,7,4,3,2,1,1
7425,21646,9864,48,6,1,5,2,0,2
7426,21648,8634,67,2,1,1,1,1,0
7427,21648,8696,33,3,1,2,0,0,0
7428,21649,8388,51,6,3,3,1,0,1
7429,21649,8633,49,7,3,4,1,0,1
7430,21656,8315,57,5,3,2,3,1,2
7431,21656,9864,43,2,1,1,1,1,0
7432,21657,10267,48,2,1,1,2,2,0
7433,21657,9865,52,4,3,1,1,0,1
7434,21660,8633,54,8,6,2,2,1,1
7435,21660,8696,46,6,4,2,2,0,2
7436,21670,8633,59,6,3,3,1,0,1
7437,21670,9869,41,3,1,2,0,0,0
7438,21671,10267,61,11,5,6,2,2,0
7439,21671,9864,39,6,5,1,2,1,1
7440,21674,8558,36,6,1,5,2,2,0
7441,21674,8302,64,8,3,5,1,1,0
7442,21680,9783,60,7,5,2,2,2,0
7443,21680,10267,40,3,3,0,1,1,0
7444,21684,8633,59,8,3,5,1,1,0
7445,21684,8603,41,0,0,0,2,2,0
7446,21687,9906,47,8,3,5,2,0,2
7447,21687,8302,53,5,2,3,1,0,1
7448,21690,8302,57,6,3,3,2,1,1
7449,21690,8315,43,3,1,2,4,0,4
7450,21693,8603,49,9,5,4,1,0,1
7451,21693,10205,51,4,2,2,0,0,0
7452,21701,8558,54,7,2,5,2,2,0
7453,21701,10205,46,2,1,1,1,1,0
7454,21702,9906,37,5,3,2,3,1,2
7455,21702,8633,63,8,5,3,0,0,0
7456,21705,9864,31,3,1,2,1,0,1
7457,21705,8305,69,3,2,1,0,0,0
7458,21711,9906,59,12,9,3,3,1,2
7459,21711,10205,41,2,1,1,2,0,2
7460,21716,8315,43,4,2,2,3,3,0
7461,21716,8633,57,9,4,5,0,0,0
7462,21719,10281,46,4,1,3,1,1,0
7463,21719,8302,54,3,2,1,2,1,1
7464,21724,8634,59,11,7,4,1,1,0
7465,21724,9864,41,3,1,2,1,0,1
7466,21725,8661,39,1,1,0,2,1,1
7467,21725,9906,61,1,1,0,0,0,0
7468,21726,8315,48,7,5,2,3,1,2
7469,21726,10205,52,5,1,4,0,0,0
7470,21727,9865,51,5,2,3,1,0,1
7471,21727,8633,49,7,3,4,0,0,0
7472,21728,8371,45,2,2,0,1,1,0
7473,21728,9906,55,7,2,5,1,0,1
7474,21729,9869,48,6,3,3,3,1,2
7475,21729,8696,52,3,1,2,0,0,0
7476,21741,10267,58,4,3,1,3,0,3
7477,21741,8371,42,1,0,1,1,0,1
7478,21743,8305,48,6,5,1,1,1,0
7479,21743,8558,52,3,1,2,0,0,0
7480,21755,8633,56,9,2,7,2,2,0
7481,21755,10281,44,10,4,6,0,0,0
7482,21756,8479,23,3,2,1,1,1,0
7483,21756,8634,77,6,3,3,1,1,0
7484,21757,8302,56,4,4,0,2,1,1
7485,21757,8305,44,1,1,0,1,0,1
7486,21758,9869,54,6,3,3,3,2,1
7487,21758,8603,46,6,1,5,1,0,1
7488,21763,10267,56,10,5,5,5,3,2
7489,21763,8302,44,3,3,0,2,0,2
7490,21764,8634,67,10,7,3,2,2,0
7491,21764,8305,33,1,0,1,1,0,1
7492,21765,8633,61,10,4,6,2,1,1
7493,21765,8479,39,3,2,1,0,0,0
7494,21775,8633,60,9,3,6,1,1,0
7495,21775,8305,40,2,0,2,0,0,0
7496,21776,8634,64,8,5,3,4,2,2
7497,21776,8302,36,2,0,2,4,0,4
7498,21780,10205,37,4,3,1,2,1,1
7499,21780,8305,63,5,1,4,0,0,0
7500,21781,8302,52,4,2,2,3,1,2
7501,21781,8633,48,2,1,1,0,0,0
7502,21782,8634,69,8,4,4,3,2,1
7503,21782,10267,31,3,2,1,0,0,0
7504,21783,9783,53,9,3,6,1,1,0
7505,21783,9864,47,6,4,2,0,0,0
7506,21788,10267,48,9,4,5,1,1,0
7507,21788,8558,52,5,0,5,2,0,2
7508,21789,8603,54,2,1,1,3,2,1
7509,21789,9906,46,2,0,2,1,1,0
7510,21793,10281,64,7,5,2,1,1,0
7511,21793,9783,36,8,3,5,0,0,0
7512,21794,8634,65,8,7,1,1,1,0
7513,21794,8633,35,2,1,1,0,0,0
7514,21799,8661,41,6,3,3,2,1,1
7515,21799,8302,59,6,2,4,1,1,0
7516,21805,8558,46,4,1,3,4,1,3
7517,21805,9906,54,9,3,6,0,0,0
7518,21806,8634,55,5,3,2,4,1,3
7519,21806,10205,45,1,1,0,2,0,2
7520,21807,10267,56,6,5,1,2,2,0
7521,21807,8633,44,7,3,4,1,1,0
7522,21808,9869,48,12,6,6,2,1,1
7523,21808,9864,52,2,0,2,1,0,1
7524,21812,8634,58,10,6,4,4,1,3
7525,21812,8661,42,8,2,6,0,0,0
7526,21816,8633,48,4,2,2,1,1,0
7527,21816,10205,52,5,1,4,0,0,0
7528,21817,8371,52,7,3,4,3,1,2
7529,21817,8302,48,2,1,1,0,0,0
7530,21824,8371,43,5,1,4,2,1,1
7531,21824,8634,57,4,1,3,1,0,1
7532,21825,8633,58,6,4,2,6,3,3
7533,21825,8661,42,5,2,3,0,0,0
7534,21831,8479,44,1,1,0,2,1,1
7535,21831,9869,56,8,2,6,1,0,1
7536,21836,8661,46,11,5,6,3,2,1
7537,21836,10205,54,3,1,2,1,0,1
7538,21842,8634,66,9,4,5,3,0,3
7539,21842,8603,34,3,2,1,0,0,0
7540,21852,8633,44,8,5,3,2,2,0
7541,21852,8603,56,9,3,6,1,0,1
7542,21853,8558,29,4,2,2,2,0,2
7543,21853,8634,71,15,5,10,0,0,0
7544,21859,8558,44,3,1,2,4,3,1
7545,21859,8633,56,8,0,8,0,0,0
7546,21870,8633,47,13,5,8,3,1,2
7547,21870,9906,53,5,1,4,2,0,2
7548,21883,8315,44,5,3,2,2,2,0
7549,21883,8633,56,3,1,2,1,0,1
7550,21886,10267,67,7,2,5,6,2,4
7551,21886,8479,33,2,0,2,0,0,0
7552,21889,9864,46,2,2,0,1,0,1
7553,21889,8634,54,4,1,3,1,0,1
7554,21893,9783,41,5,3,2,4,3,1
7555,21893,8603,59,8,3,5,0,0,0
7556,21895,8633,10,5,3,2,2,0,2
7557,21895,9865,90,7,1,6,1,0,1
7558,21898,9783,40,2,2,0,1,1,0
7559,21898,8633,60,9,4,5,1,0,1
7560,21902,8394,35,7,4,3,2,0,2
7561,21902,9867,65,5,2,3,0,0,0
7562,21903,10267,56,4,3,1,2,1,1
7563,21903,8302,44,1,0,1,0,0,0
7564,21905,9869,23,6,2,4,1,0,1
7565,21905,8634,77,8,2,6,1,0,1
7566,21909,8302,60,4,4,0,1,1,0
7567,21909,10205,40,3,2,1,0,0,0
7568,21915,8634,69,7,6,1,2,0,2
7569,21915,8661,31,5,2,3,1,0,1
7570,21917,10267,53,6,2,4,1,0,1
7571,21917,8394,47,5,2,3,1,0,1
7572,21922,9783,53,10,5,5,3,1,2
7573,21922,9906,47,7,1,6,0,0,0
7574,21924,8634,62,6,2,4,2,1,1
7575,21924,8315,38,1,0,1,4,1,3
7576,21926,10267,49,2,2,0,5,2,3
7577,21926,8371,51,2,1,1,3,0,3
7578,21927,8394,44,2,1,1,3,2,1
7579,21927,9864,56,4,2,2,2,1,1
7580,21932,9906,44,6,4,2,2,1,1
7581,21932,8558,56,3,1,2,1,0,1
7582,21933,9783,52,3,1,2,5,3,2
7583,21933,8696,48,3,0,3,1,1,0
7584,21934,8634,61,4,3,1,1,0,1
7585,21934,8633,39,8,4,4,0,0,0
7586,21936,8661,51,1,1,0,2,2,0
7587,21936,10267,49,6,1,5,2,2,0
7588,21938,10281,31,3,2,1,2,1,1
7589,21938,8302,69,5,1,4,1,0,1
7590,21943,8634,62,9,8,1,6,4,2
7591,21943,9783,38,2,1,1,0,0,0
7592,21944,8633,67,18,13,5,4,1,3
7593,21944,9865,33,1,0,1,1,0,1
7594,21945,10267,63,3,2,1,5,1,4
7595,21945,8315,37,3,0,3,1,0,1
7596,21949,9869,57,7,4,3,4,2,2
7597,21949,8302,43,2,2,0,1,1,0
7598,21951,10205,49,7,4,3,4,2,2
7599,21951,9906,51,2,2,0,0,0,0
7600,21953,8634,64,3,3,0,1,1,0
7601,21953,8558,36,2,1,1,2,0,2
7602,21955,10267,54,6,3,3,4,1,3
7603,21955,8633,46,4,2,2,0,0,0
7604,21959,8302,69,7,5,2,2,1,1
7605,21959,8305,31,2,0,2,1,0,1
7606,21960,9906,56,2,1,1,2,1,1
7607,21960,9867,44,12,4,8,1,1,0
7608,21964,10267,61,7,3,4,1,1,0
7609,21964,9783,39,4,2,2,0,0,0
7610,21965,8633,60,5,1,4,2,1,1
7611,21965,8394,40,2,1,1,0,0,0
7612,21970,8302,60,2,1,1,3,0,3
7613,21970,9906,40,2,0,2,0,0,0
7614,21972,8634,68,7,1,6,3,1,2
7615,21972,10205,32,3,0,3,2,0,2
7616,21975,8394,53,7,2,5,3,1,2
7617,21975,9783,47,6,0,6,0,0,0
7618,21977,8661,41,6,3,3,4,1,3
7619,21977,8315,59,4,0,4,0,0,0
7620,21980,8302,78,9,4,5,1,0,1
7621,21980,8696,22,3,2,1,0,0,0
7622,21981,9867,32,5,4,1,2,1,1
7623,21981,8634,68,4,3,1,2,0,2
7624,21982,10205,43,3,1,2,4,2,2
7625,21982,9865,57,2,0,2,1,0,1
7626,21983,10267,56,4,4,0,1,0,1
7627,21983,9868,44,3,1,2,1,0,1
7628,21986,8661,41,3,2,1,1,1,0
7629,21986,8633,59,5,0,5,0,0,0
7630,21989,9869,38,7,4,3,1,0,1
7631,21989,9906,62,3,1,2,0,0,0
7632,21991,8634,67,11,4,7,3,3,0
7633,21991,8302,33,0,0,0,2,1,1
7634,21993,10267,53,9,2,7,1,0,1
7635,21993,10205,47,1,0,1,0,0,0
7636,21998,9906,45,3,2,1,4,2,2
7637,21998,8305,55,7,4,3,3,1,2
7638,22000,8634,71,7,2,5,1,1,0
7639,22000,10281,29,6,3,3,1,0,1
7640,22005,8558,54,4,2,2,1,1,0
7641,22005,8661,46,4,2,2,2,1,1
7642,22006,8315,51,7,3,4,1,1,0
7643,22006,9783,49,3,0,3,0,0,0
7644,22007,9864,43,3,2,1,2,1,1
7645,22007,8633,57,6,4,2,2,1,1
7646,22009,8633,45,7,2,5,1,1,0
7647,22009,8558,55,5,3,2,0,0,0
7648,22010,9868,64,9,2,7,4,1,3
7649,22010,8315,36,7,2,5,0,0,0
7650,22014,10267,46,4,2,2,3,2,1
7651,22014,10281,54,6,2,4,0,0,0
7652,22016,8305,36,6,1,5,4,4,0
7653,22016,8634,64,8,2,6,0,0,0
7654,22018,8633,61,8,7,1,2,1,1
7655,22018,9783,39,3,1,2,1,0,1
7656,22023,8302,46,3,1,2,4,2,2
7657,22023,10267,54,12,3,9,3,2,1
7658,22025,8634,72,6,1,5,1,1,0
7659,22025,9869,28,2,1,1,1,0,1
7660,22027,9864,45,1,1,0,2,0,2
7661,22027,9906,55,6,2,4,0,0,0
7662,22029,8633,56,9,6,3,3,1,2
7663,22029,8558,44,4,1,3,1,0,1
7664,22030,9868,45,4,3,1,1,1,0
7665,22030,8315,55,9,4,5,0,0,0
7666,22033,8302,61,4,2,2,1,1,0
7667,22033,8394,39,4,2,2,2,0,2
7668,22034,10281,53,7,2,5,3,1,2
7669,22034,10267,47,12,7,5,0,0,0
7670,22036,8634,41,5,5,0,3,1,2
7671,22036,8305,59,5,2,3,1,0,1
7672,22037,8696,46,4,2,2,1,0,1
7673,22037,9906,54,2,1,1,1,0,1
7674,22039,9868,34,2,2,0,2,1,1
7675,22039,8633,66,9,4,5,1,0,1
7676,22040,8315,51,1,1,0,2,1,1
7677,22040,10205,49,6,2,4,1,0,1
7678,22042,8302,51,3,2,1,2,1,1
7679,22042,8371,49,3,3,0,2,0,2
7680,22044,10267,60,10,10,0,1,1,0
7681,22044,9869,40,5,2,3,0,0,0
7682,22046,9906,37,5,3,2,4,2,2
7683,22046,8634,63,6,5,1,0,0,0
7684,22050,8633,56,3,2,1,1,1,0
7685,22050,10205,44,3,1,2,2,1,1
7686,22051,8315,54,7,2,5,1,1,0
7687,22051,9867,46,3,0,3,1,0,1
7688,22052,8302,46,3,3,0,1,1,0
7689,22052,8661,54,3,1,2,2,0,2
7690,22055,10267,38,8,5,3,3,2,1
7691,22055,8305,62,5,2,3,1,0,1
7692,22056,9865,47,5,3,2,3,1,2
7693,22056,9906,53,9,4,5,2,1,1
7694,22057,8634,61,6,3,3,2,2,0
7695,22057,8696,39,1,0,1,1,0,1
7696,22059,10205,42,6,4,2,3,2,1
7697,22059,9783,58,3,1,2,1,0,1
7698,22060,9867,48,7,2,5,2,0,2
7699,22060,8633,52,5,2,3,1,0,1
7700,22065,10267,37,1,1,0,6,1,5
7701,22065,9906,63,9,0,9,0,0,0
7702,22067,9864,31,1,1,0,1,1,0
7703,22067,8634,69,5,2,3,0,0,0
7704,22069,8558,56,8,6,2,4,2,2
7705,22069,10205,44,8,3,5,0,0,0
7706,22071,8633,63,13,8,5,2,1,1
7707,22071,8302,37,0,0,0,0,0,0
7708,22072,8315,41,7,3,4,2,2,0
7709,22072,10281,59,7,2,5,2,2,0
7710,22075,8394,48,7,4,3,2,0,2
7711,22075,9906,52,1,0,1,0,0,0
7712,22076,10267,58,6,3,3,1,0,1
7713,22076,8696,42,6,1,5,0,0,0
7714,22077,8634,66,9,5,4,2,1,1
7715,22077,9865,34,2,1,1,1,0,1
7716,22078,10205,49,8,5,3,4,0,4
7717,22078,9868,51,4,2,2,0,0,0
7718,22080,9783,35,3,2,1,1,1,0
7719,22080,8302,65,7,1,6,0,0,0
7720,22081,10281,55,6,3,3,1,1,0
7721,22081,8633,45,11,5,6,5,1,4
7722,22092,9869,42,4,1,3,1,0,1
7723,22092,8633,58,9,4,5,1,0,1
7724,22096,8634,62,3,2,1,5,3,2
7725,22096,8394,38,1,0,1,2,1,1
7726,22097,10267,48,9,5,4,1,0,1
7727,22097,9865,52,5,1,4,1,0,1
7728,22099,9868,53,2,1,1,2,1,1
7729,22099,8302,47,2,0,2,1,0,1
7730,22102,8633,49,9,7,2,4,2,2
7731,22102,8305,51,5,0,5,2,1,1
7732,22103,8315,51,5,3,2,1,1,0
7733,22103,9906,49,7,2,5,2,0,2
7734,22109,10205,42,3,1,2,3,1,2
7735,22109,8302,58,6,1,5,0,0,0
7736,22112,9783,54,3,1,2,1,1,0
7737,22112,8305,46,4,1,3,4,0,4
7738,22113,8633,61,10,7,3,1,1,0
7739,22113,9906,39,3,2,1,1,0,1
7740,22115,8661,34,3,3,0,1,1,0
7741,22115,8634,66,4,2,2,0,0,0
7742,22118,9783,62,5,2,3,2,2,0
7743,22118,8558,38,3,2,1,1,0,1
7744,22119,8633,44,10,6,4,2,2,0
7745,22119,9868,56,3,2,1,2,2,0
7746,22122,8302,48,2,2,0,1,1,0
7747,22122,8371,52,4,1,3,0,0,0
7748,22124,10267,64,14,6,8,2,2,0
7749,22124,9869,36,3,0,3,0,0,0
7750,22132,9906,59,8,4,4,1,1,0
7751,22132,9783,41,2,0,2,2,0,2
7752,22133,8696,44,2,1,1,1,1,0
7753,22133,8633,56,6,1,5,0,0,0
7754,22134,8634,59,9,5,4,2,1,1
7755,22134,8315,41,4,1,3,1,0,1
7756,22142,8558,53,5,3,2,1,1,0
7757,22142,9906,47,3,2,1,2,0,2
7758,22144,8634,53,4,2,2,2,1,1
7759,22144,8633,47,10,1,9,1,0,1
7760,22146,8661,41,8,4,4,1,1,0
7761,22146,10267,59,3,1,2,0,0,0
7762,22148,10281,28,7,4,3,1,1,0
7763,22148,8302,72,2,0,2,1,0,1
7764,22150,8305,44,4,3,1,1,1,0
7765,22150,10205,56,4,2,2,0,0,0
7766,22153,9783,30,2,1,1,2,1,1
7767,22153,8634,70,10,6,4,1,0,1
7768,22154,8633,57,18,9,9,3,2,1
7769,22154,9865,43,5,2,3,0,0,0
7770,22155,10267,66,6,2,4,2,0,2
7771,22155,8315,34,3,1,2,0,0,0
7772,22158,10281,46,1,1,0,2,1,1
7773,22158,9864,54,0,0,0,0,0,0
7774,22161,10205,39,4,3,1,2,2,0
7775,22161,9906,61,5,2,3,1,0,1
7776,22163,8558,41,3,3,0,3,2,1
7777,22163,8634,59,3,1,2,1,0,1
7778,22165,8633,49,10,6,4,2,1,1
7779,22165,10267,51,2,1,1,0,0,0
7780,22166,8315,57,7,2,5,1,0,1
7781,22166,8394,43,2,1,1,0,0,0
7782,22169,8305,62,6,1,5,1,1,0
7783,22169,8302,38,5,0,5,1,0,1
7784,22170,9906,51,5,4,1,3,0,3
7785,22170,9867,49,3,2,1,0,0,0
7786,22172,8634,66,7,2,5,1,0,1
7787,22172,9868,34,3,1,2,0,0,0
7788,22174,10267,59,7,2,5,3,2,1
7789,22174,9783,41,2,1,1,2,2,0
7790,22175,8633,66,10,3,7,2,1,1
7791,22175,8394,34,2,0,2,0,0,0
7792,22180,8302,49,3,2,1,4,3,1
7793,22180,9906,51,2,2,0,1,0,1
7794,22182,8634,59,5,4,1,2,1,1
7795,22182,10205,41,3,1,2,1,0,1
7796,22184,10267,62,6,4,2,1,1,0
7797,22184,8558,38,2,1,1,0,0,0
7798,22185,9783,52,5,1,4,1,0,1
7799,22185,8394,48,1,1,0,1,0,1
7800,22186,8633,59,10,4,6,2,2,0
7801,22186,8371,41,5,2,3,4,2,2
7802,22187,8315,61,4,2,2,2,2,0
7803,22187,8661,39,6,3,3,1,1,0
7804,22191,8634,79,5,3,2,2,1,1
7805,22191,9867,21,2,1,1,2,1,1
7806,22193,10267,58,6,4,2,1,0,1
7807,22193,9868,42,2,2,0,0,0,0
7808,22196,8633,64,5,4,1,3,1,2
7809,22196,8661,36,3,3,0,0,0,0
7810,22199,9906,60,2,1,1,3,2,1
7811,22199,9869,40,0,0,0,2,2,0
7812,22201,8634,63,4,1,3,1,1,0
7813,22201,8302,37,3,2,1,3,1,2
7814,22203,10205,38,5,3,2,1,1,0
7815,22203,10267,62,5,2,3,2,1,1
7816,22206,8661,66,3,2,1,1,0,1
7817,22206,9783,34,4,2,2,0,0,0
7818,22207,8315,28,3,2,1,6,1,5
7819,22207,8633,72,15,8,7,0,0,0
7820,22209,8696,59,9,8,1,1,1,0
7821,22209,9869,41,5,1,4,4,2,2
7822,22210,10281,15,5,2,3,3,3,0
7823,22210,8634,85,6,6,0,1,0,1
7824,22211,9865,59,4,1,3,2,1,1
7825,22211,8302,41,3,2,1,2,1,1
7826,22213,8394,51,3,2,1,1,0,1
7827,22213,10205,49,7,4,3,0,0,0
7828,22217,9864,39,2,1,1,3,1,2
7829,22217,8633,61,9,3,6,3,1,2
7830,22220,8633,52,9,4,5,2,0,2
7831,22220,10205,48,6,1,5,0,0,0
7832,22227,8634,71,7,2,5,1,1,0
7833,22227,8696,29,1,0,1,3,0,3
7834,22230,8633,48,10,4,6,4,2,2
7835,22230,9867,52,8,3,5,0,0,0
7836,22235,10267,52,8,2,6,2,0,2
7837,22235,9906,48,4,0,4,0,0,0
7838,22241,8302,45,14,5,9,3,2,1
7839,22241,8633,55,4,2,2,0,0,0
7840,22246,8696,54,5,2,3,2,1,1
7841,22246,10267,46,3,2,1,0,0,0
7842,22247,8634,70,10,4,6,4,2,2
7843,22247,9865,30,0,0,0,3,0,3
7844,22251,10281,49,11,3,8,2,1,1
7845,22251,8633,51,5,0,5,1,0,1
7846,22256,10267,25,4,1,3,2,2,0
7847,22256,8634,75,6,2,4,2,1,1
7848,22260,8558,41,2,1,1,2,0,2
7849,22260,8302,59,13,7,6,0,0,0
7850,22262,8633,64,9,5,4,2,1,1
7851,22262,9869,36,4,3,1,1,0,1
7852,22266,8634,77,9,6,3,3,3,0
7853,22266,8394,23,5,1,4,0,0,0
7854,22272,8633,42,14,8,6,3,1,2
7855,22272,8305,58,8,3,5,0,0,0
7856,22275,8634,75,11,6,5,1,0,1
7857,22275,8371,25,0,0,0,0,0,0
7858,22281,10267,59,9,6,3,3,1,2
7859,22281,9864,41,6,2,4,2,0,2
7860,22287,8633,65,11,2,9,1,0,1
7861,22287,8661,35,3,1,2,1,0,1
7862,22289,8302,65,9,5,4,1,0,1
7863,22289,10267,35,7,3,4,1,0,1
7864,22291,10205,53,10,5,5,3,1,2
7865,22291,8315,47,6,1,5,1,0,1
7866,22296,8558,43,6,4,2,2,2,0
7867,22296,9864,57,4,2,2,0,0,0
7868,22309,8305,60,7,5,2,1,1,0
7869,22309,8394,40,5,2,3,0,0,0
7870,22311,8634,76,9,3,6,1,0,1
7871,22311,9865,24,3,1,2,2,0,2
7872,22312,8315,48,9,6,3,7,1,6
7873,22312,8633,52,4,2,2,1,0,1
7874,22319,8394,37,5,3,2,1,0,1
7875,22319,10205,63,5,2,3,0,0,0
7876,22320,10267,52,3,2,1,2,0,2
7877,22320,9865,48,2,1,1,0,0,0
7878,22322,8371,60,4,2,2,3,2,1
7879,22322,8315,40,3,2,1,0,0,0
7880,22331,10267,55,7,2,5,2,2,0
7881,22331,8633,45,10,6,4,1,0,1
7882,22332,8371,36,2,1,1,2,2,0
7883,22332,8634,64,6,1,5,0,0,0
7884,22339,8302,61,2,1,1,2,2,0
7885,22339,9865,39,3,3,0,0,0,0
7886,22341,10267,44,7,6,1,2,0,2
7887,22341,8371,56,3,0,3,0,0,0
7888,22345,9906,46,3,3,0,2,1,1
7889,22345,9783,54,1,1,0,1,1,0
7890,22349,8305,54,7,3,4,1,1,0
7891,22349,9865,46,7,6,1,0,0,0
7892,22362,10267,47,7,4,3,2,1,1
7893,22362,8558,53,4,1,3,1,0,1
7894,22363,8634,75,12,8,4,2,2,0
7895,22363,8581,25,2,1,1,0,0,0
7896,22368,9865,63,2,1,1,2,2,0
7897,22368,8661,37,5,0,5,1,0,1
7898,22369,10205,44,4,2,2,1,1,0
7899,22369,8633,56,5,1,4,1,0,1
7900,22373,8581,43,6,6,0,2,0,2
7901,22373,10267,57,6,3,3,0,0,0
7902,22390,8634,71,7,2,5,8,4,4
7903,22390,10278,29,4,1,3,2,0,2
7904,22393,8302,62,14,4,10,2,1,1
7905,22393,9783,38,4,2,2,0,0,0
7906,22395,8558,57,9,6,3,1,1,0
7907,22395,10205,43,7,2,5,1,1,0
7908,22397,8371,45,1,1,0,3,1,2
7909,22397,8633,55,7,3,4,1,0,1
7910,22405,10205,51,10,5,5,2,1,1
7911,22405,8560,49,2,2,0,1,1,0
7912,22407,8633,66,10,4,6,1,1,0
7913,22407,8661,34,2,0,2,0,0,0
7914,22408,9869,35,2,1,1,3,1,2
7915,22408,8661,65,3,0,3,2,1,1
7916,22410,8634,66,9,6,3,3,0,3
7917,22410,10278,34,2,1,1,0,0,0
7918,22413,8302,51,3,1,2,1,1,0
7919,22413,9783,49,1,0,1,1,1,0
7920,22424,8581,40,6,4,2,2,0,2
7921,22424,10205,60,10,4,6,0,0,0
7922,22440,9906,40,7,6,1,1,0,1
7923,22440,8394,60,4,2,2,0,0,0
7924,22445,8581,34,2,2,0,4,1,3
7925,22445,8633,66,12,5,7,1,0,1
7926,22448,8661,26,5,3,2,1,1,0
7927,22448,8634,74,2,2,0,1,0,1
7928,22453,8696,49,7,4,3,3,1,2
7929,22453,10205,51,9,6,3,0,0,0
7930,22455,8633,63,13,3,10,2,1,1
7931,22455,9783,37,2,2,0,0,0,0
7932,22469,8634,77,13,6,7,3,2,1
7933,22469,8394,23,1,0,1,1,0,1
7934,22470,8315,39,5,2,3,1,0,1
7935,22470,8302,61,3,0,3,1,0,1
7936,22472,10205,48,3,1,2,2,2,0
7937,22472,9906,52,5,0,5,2,1,1
7938,22480,8302,39,3,1,2,1,1,0
7939,22480,8634,61,6,1,5,6,4,2
7940,22482,9906,51,10,3,7,3,2,1
7941,22482,9865,49,6,3,3,0,0,0
7942,22488,8661,57,3,3,0,2,2,0
7943,22488,8394,43,1,0,1,1,0,1
7944,22498,8315,51,10,1,9,1,1,0
7945,22498,9869,49,3,3,0,0,0,0
7946,22499,8634,68,10,3,7,2,2,0
7947,22499,9906,32,5,3,2,2,1,1
7948,22500,10278,60,9,6,3,2,1,1
7949,22500,10267,40,2,1,1,1,1,0
7950,22502,9864,51,5,4,1,1,1,0
7951,22502,8302,49,7,5,2,0,0,0
7952,22506,8633,56,8,3,5,4,1,3
7953,22506,8560,44,2,0,2,1,0,1
7954,22509,8305,46,5,2,3,2,0,2
7955,22509,10267,54,3,2,1,1,0,1
7956,22510,10205,30,2,1,1,3,0,3
7957,22510,8634,70,7,3,4,0,0,0
7958,22519,8305,60,6,4,2,1,0,1
7959,22519,8394,40,6,1,5,0,0,0
7960,22522,8315,56,6,4,2,2,2,0
7961,22522,8633,44,4,2,2,0,0,0
7962,22529,8394,49,9,4,5,4,2,2
7963,22529,10205,51,6,4,2,0,0,0
7964,22550,8394,38,2,2,0,2,2,0
7965,22550,8633,62,9,1,8,4,3,1
7966,22558,8661,45,5,3,2,4,2,2
7967,22558,10205,55,2,0,2,0,0,0
7968,22562,8560,46,4,3,1,1,1,0
7969,22562,10267,54,1,0,1,0,0,0
7970,22576,8696,44,5,3,2,2,1,1
7971,22576,9906,56,3,2,1,1,0,1
7972,22584,9783,27,5,2,3,1,1,0
7973,22584,8634,73,2,0,2,1,0,1
7974,22590,8560,63,7,6,1,3,1,2
7975,22590,8305,37,2,2,0,2,1,1
7976,22593,9783,41,7,2,5,1,0,1
7977,22593,10267,59,6,3,3,1,0,1
7978,22598,8661,57,6,4,2,3,1,2
7979,22598,8315,43,5,2,3,0,0,0
7980,22599,8634,72,7,4,3,8,2,6
7981,22599,9869,28,1,1,0,0,0,0
7982,22600,9906,34,2,0,2,2,1,1
7983,22600,10267,66,5,0,5,1,1,0
7984,22606,8633,66,13,8,5,1,1,0
7985,22606,8558,34,4,0,4,1,0,1
7986,22608,8634,71,12,4,8,3,1,2
7987,22608,8315,29,2,1,1,1,0,1
7988,22610,9906,44,4,2,2,2,2,0
7989,22610,8394,56,11,2,9,2,0,2
7990,22611,8302,62,7,5,2,2,1,1
7991,22611,10278,38,4,1,3,0,0,0
7992,22615,8633,72,12,5,7,2,0,2
7993,22615,8581,28,2,1,1,1,0,1
7994,22618,8634,72,9,4,5,1,0,1
7995,22618,8661,28,4,1,3,0,0,0
7996,22619,10267,49,5,1,4,3,0,3
7997,22619,8315,51,2,0,2,0,0,0
7998,22621,8302,45,9,8,1,4,2,2
7999,22621,9906,55,6,4,2,2,1,1
8000,22625,8633,60,8,6,2,3,3,0
8001,22625,9783,40,1,0,1,0,0,0
8002,22629,8394,40,4,2,2,2,1,1
8003,22629,8315,60,7,1,6,3,1,2
8004,22630,9869,27,5,3,2,3,0,3
8005,22630,8302,73,3,3,0,2,0,2
8006,22637,8558,39,6,2,4,3,2,1
8007,22637,8661,61,4,1,3,0,0,0
8008,22640,8315,49,4,2,2,2,2,0
8009,22640,8302,51,5,3,2,0,0,0
8010,22642,9906,59,4,2,2,1,1,0
8011,22642,10205,41,3,1,2,0,0,0
8012,22646,8560,48,4,1,3,1,1,0
8013,22646,9783,52,3,0,3,5,3,2
8014,22650,8315,37,6,3,3,4,2,2
8015,22650,8305,63,3,0,3,0,0,0
8016,22681,8633,54,7,7,0,2,0,2
8017,22681,8560,46,2,0,2,0,0,0
8018,22684,8302,57,11,3,8,1,0,1
8019,22684,7878,43,4,2,2,0,0,0
8020,22685,10267,49,4,2,2,2,2,0
8021,22685,8305,51,5,5,0,0,0,0
8022,22691,10205,44,4,1,3,3,2,1
8023,22691,8558,56,7,4,3,0,0,0
8024,22698,8558,58,10,2,8,7,4,3
8025,22698,8560,42,1,1,0,0,0,0
8026,22701,8603,58,10,5,5,2,0,2
8027,22701,10205,42,5,1,4,1,0,1
8028,22702,8315,61,3,2,1,4,3,1
8029,22702,8302,39,4,1,3,2,2,0
8030,22710,9869,53,5,3,2,5,2,3
8031,22710,8581,47,1,0,1,1,1,0
8032,22711,8560,36,6,4,2,2,1,1
8033,22711,8603,64,7,5,2,2,1,1
8034,22714,10205,64,7,3,4,3,2,1
8035,22714,9864,36,6,6,0,1,1,0
8036,22716,10267,45,3,1,2,6,2,4
8037,22716,8370,55,3,1,2,0,0,0
8038,22718,9906,40,9,3,6,4,2,2
8039,22718,8370,60,5,1,4,3,0,3
8040,22719,8696,32,1,1,0,1,1,0
8041,22719,10205,68,2,0,2,2,0,2
8042,22720,8302,54,5,1,4,1,1,0
8043,22720,8305,46,0,0,0,2,1,1
8044,22721,10267,39,5,4,1,2,0,2
8045,22721,8558,61,1,1,0,0,0,0
8046,22722,8581,33,4,2,2,2,1,1
8047,22722,8634,67,7,3,4,0,0,0
8048,22723,8371,48,6,3,3,1,1,0
8049,22723,8603,52,8,0,8,1,0,1
8050,22730,9869,36,7,4,3,5,2,3
8051,22730,8370,64,8,3,5,0,0,0
8052,22735,8603,52,5,1,4,1,0,1
8053,22735,10267,48,4,2,2,0,0,0
8054,22740,8581,46,8,4,4,1,1,0
8055,22740,7878,54,6,2,4,0,0,0
8056,22741,9906,66,13,6,7,1,0,1
8057,22741,8603,34,2,1,1,2,0,2
8058,22745,8634,60,3,3,0,1,0,1
8059,22745,8370,40,6,2,4,0,0,0
8060,22746,8371,56,9,6,3,3,1,2
8061,22746,10205,44,4,2,2,0,0,0
8062,22769,9906,59,11,4,7,1,1,0
8063,22769,8371,41,4,1,3,3,1,2
8064,22772,8302,42,8,4,4,2,1,1
8065,22772,9864,58,1,1,0,2,1,1
8066,22776,8394,36,4,3,1,1,0,1
8067,22776,8633,64,18,8,10,0,0,0
8068,22779,8560,53,9,4,5,3,2,1
8069,22779,9906,47,5,0,5,1,0,1
8070,22782,8633,62,12,5,7,1,1,0
8071,22782,8315,38,4,4,0,0,0,0
8072,22799,9906,60,3,1,2,1,1,0
8073,22799,10267,40,4,3,1,1,0,1
8074,22800,9864,48,4,4,0,1,1,0
8075,22800,7878,52,9,4,5,0,0,0
8076,22802,8371,61,7,2,5,1,1,0
8077,22802,9869,39,5,2,3,1,0,1
8078,22813,8394,42,5,1,4,1,1,0
8079,22813,8558,58,4,1,3,0,0,0
8080,22821,8394,58,11,8,3,3,2,1
8081,22821,8603,42,7,2,5,1,0,1
8082,22823,8305,51,11,3,8,1,0,1
8083,22823,8558,49,2,0,2,1,0,1
8084,22840,7878,59,7,2,5,3,2,1
8085,22840,10267,41,0,0,0,1,1,0
8086,22872,9906,46,8,2,6,1,1,0
8087,22872,8315,54,1,0,1,1,0,1
8088,22873,10205,38,2,2,0,2,1,1
8089,22873,8633,62,9,6,3,1,0,1
8090,22874,8302,65,7,4,3,3,0,3
8091,22874,8696,35,4,2,2,0,0,0
8092,22876,9864,43,4,2,2,2,2,0
8093,22876,8370,57,7,1,6,1,0,1
8094,22877,8634,72,7,5,2,4,2,2
8095,22877,7878,28,1,1,0,0,0,0
8096,22881,10205,41,8,5,3,1,1,0
8097,22881,8302,59,2,2,0,2,1,1
8098,22884,8315,61,8,4,4,2,2,0
8099,22884,8558,39,4,4,0,0,0,0
8100,22891,8633,60,7,3,4,1,1,0
8101,22891,8560,40,3,1,2,1,0,1
8102,22892,9906,57,3,1,2,2,1,1
8103,22892,8394,43,1,0,1,0,0,0
8104,22895,8305,35,3,1,2,2,1,1
8105,22895,10267,65,7,2,5,0,0,0
8106,22907,8394,49,4,3,1,4,2,2
8107,22907,9869,51,5,4,1,0,0,0
8108,22914,8370,49,7,2,5,1,0,1
8109,22914,8371,51,3,1,2,0,0,0
8110,22923,8633,57,9,5,4,1,1,0
8111,22923,9906,43,4,1,3,0,0,0
8112,22926,10267,53,4,4,0,1,1,0
8113,22926,8370,47,4,2,2,0,0,0
8114,22930,8633,73,5,2,3,2,1,1
8115,22930,9869,27,1,1,0,2,0,2
8116,22936,8558,53,3,1,2,1,1,0
8117,22936,10267,47,0,0,0,2,1,1
8118,22937,8634,70,10,7,3,1,0,1
8119,22937,8581,30,2,1,1,1,0,1
8120,22938,10267,53,5,1,4,1,1,0
8121,22938,8603,47,3,1,2,1,0,1
8122,22940,8633,38,5,3,2,1,1,0
8123,22940,8634,62,4,0,4,0,0,0
8124,22947,8302,64,8,3,5,1,0,1
8125,22947,8581,36,2,1,1,1,0,1
8126,22948,9864,44,9,3,6,3,1,2
8127,22948,10267,56,1,0,1,0,0,0
8128,22949,8394,28,9,3,6,2,1,1
8129,22949,8315,72,4,4,0,2,0,2
8130,22953,9869,40,3,2,1,1,0,1
8131,22953,8558,60,9,3,6,0,0,0
8132,22956,8603,45,2,2,0,1,1,0
8133,22956,9906,55,9,2,7,0,0,0
8134,22957,8633,49,3,3,0,3,2,1
8135,22957,8302,51,3,2,1,1,1,0
8136,22963,8634,66,5,4,1,3,3,0
8137,22963,8558,34,5,1,4,2,2,0
8138,22971,10267,59,6,3,3,4,2,2
8139,22971,8560,41,5,3,2,1,1,0
8140,22973,8634,53,6,4,2,2,0,2
8141,22973,8603,47,3,1,2,0,0,0
8142,22975,8633,61,9,4,5,1,0,1
8143,22975,8661,39,4,1,3,0,0,0
8144,22980,7878,33,3,1,2,4,2,2
8145,22980,10205,67,3,1,2,1,0,1
8146,22982,9869,42,11,3,8,1,0,1
8147,22982,10267,58,6,1,5,0,0,0
8148,22984,8633,73,10,5,5,3,1,2
8149,22984,8581,27,6,2,4,2,0,2
8150,22986,8315,64,10,2,8,2,0,2
8151,22986,8603,36,2,1,1,0,0,0
8152,22987,8302,57,5,3,2,1,0,1
8153,22987,8560,43,1,1,0,0,0,0
8154,22989,8696,28,2,1,1,2,0,2
8155,22989,8633,72,7,1,6,0,0,0
8156,22991,8394,59,8,2,6,2,1,1
8157,22991,8603,41,3,3,0,2,1,1
8158,23000,8302,38,6,3,3,2,1,1
8159,23000,10267,62,9,3,6,1,0,1
8160,23005,8560,51,5,2,3,1,1,0
8161,23005,8661,49,5,2,3,3,0,3
8162,23010,10267,63,14,9,5,4,2,2
8163,23010,7878,37,3,2,1,0,0,0
8164,23012,8661,44,4,4,0,2,2,0
8165,23012,8371,56,4,3,1,1,1,0
8166,23014,8634,69,6,1,5,2,1,1
8167,23014,9869,31,3,2,1,2,0,2
8168,23016,8633,51,5,4,1,1,0,1
8169,23016,8558,49,5,3,2,0,0,0
8170,23018,9906,62,8,2,6,2,0,2
8171,23018,7878,38,5,1,4,0,0,0
8172,23022,8696,22,3,2,1,5,2,3
8173,23022,8634,78,6,3,3,0,0,0
8174,23033,9864,55,6,2,4,2,1,1
8175,23033,8633,45,4,2,2,0,0,0
8176,23434,8634,45,10,4,6,1,0,1
8177,23434,8633,55,5,1,4,0,0,0
8178,23634,8634,66,9,5,4,2,1,1
8179,23634,8633,34,6,4,2,1,1,0
8180,23798,8302,42,6,2,4,4,2,2
8181,23798,10267,58,3,1,2,0,0,0
8182,23799,8581,48,4,1,3,2,1,1
8183,23799,10205,52,4,0,4,0,0,0
8184,23800,9906,41,6,4,2,1,0,1
8185,23800,8370,59,5,1,4,1,0,1
8186,23802,9910,61,8,5,3,2,0,2
8187,23802,8305,39,2,2,0,1,0,1
8188,23803,8560,60,10,5,5,3,1,2
8189,23803,8372,40,6,4,2,0,0,0
8190,23804,9783,45,5,2,3,3,1,2
8191,23804,7878,55,1,0,1,0,0,0
8192,23805,8634,59,4,1,3,1,0,1
8193,23805,10268,41,0,0,0,0,0,0
8194,23806,8633,61,9,7,2,5,2,3
8195,23806,7869,39,2,0,2,1,0,1
8196,23807,9865,66,7,5,2,4,2,2
8197,23807,8558,34,4,1,3,3,0,3
8198,23810,8305,37,5,1,4,3,1,2
8199,23810,9783,63,4,0,4,0,0,0
8200,23811,10268,45,4,3,1,2,2,0
8201,23811,8558,55,11,6,5,1,0,1
8202,23812,10267,47,2,1,1,5,2,3
8203,23812,10205,53,8,5,3,1,0,1
8204,23813,8315,37,5,3,2,1,1,0
8205,23813,8302,63,1,1,0,3,2,1
8206,23816,8633,65,8,3,5,2,1,1
8207,23816,7878,35,6,1,5,3,0,3
8208,23818,9906,35,1,1,0,3,1,2
8209,23818,8560,65,5,4,1,2,0,2
8210,23820,10268,41,6,3,3,3,1,2
8211,23820,8305,59,7,4,3,4,3,1
8212,23822,10267,49,3,2,1,3,2,1
8213,23822,8315,51,1,0,1,2,0,2
8214,23823,8581,41,7,4,3,2,2,0
8215,23823,8302,59,6,3,3,2,1,1
8216,23824,8634,71,4,3,1,1,1,0
8217,23824,9865,29,3,2,1,1,0,1
8218,23825,7878,29,4,1,3,5,3,2
8219,23825,9910,71,9,4,5,1,1,0
8220,23828,9864,44,2,0,2,1,1,0
8221,23828,9906,56,2,0,2,1,0,1
8222,23829,9783,56,9,3,6,1,1,0
8223,23829,8560,44,8,4,4,2,1,1
8224,23830,7869,44,5,3,2,3,1,2
8225,23830,10268,56,5,3,2,1,0,1
8226,23831,8305,49,7,1,6,1,1,0
8227,23831,10205,51,3,2,1,2,2,0
8228,23832,8315,48,3,2,1,2,1,1
8229,23832,8558,52,3,2,1,1,0,1
8230,23833,10267,68,10,3,7,2,2,0
8231,23833,8581,32,6,2,4,1,0,1
8232,23834,8634,73,8,5,3,1,0,1
8233,23834,8302,27,2,1,1,0,0,0
8234,23836,9910,57,6,3,3,2,1,1
8235,23836,8370,43,3,1,2,0,0,0
8236,23837,8372,36,5,2,3,1,1,0
8237,23837,8633,64,5,3,2,1,0,1
8238,23840,10205,46,5,1,4,1,0,1
8239,23840,7869,54,8,3,5,4,0,4
8240,23842,8558,48,5,4,1,2,1,1
8241,23842,8581,52,7,5,2,1,0,1
8242,23843,10267,32,6,2,4,5,2,3
8243,23843,8634,68,7,1,6,0,0,0
8244,23845,8370,51,5,3,2,1,1,0
8245,23845,9865,49,5,3,2,1,1,0
8246,23847,8633,65,11,6,5,2,0,2
8247,23847,9864,35,7,2,5,0,0,0
8248,23850,10205,66,13,6,7,2,1,1
8249,23850,8560,34,6,2,4,0,0,0
8250,23851,7869,29,3,2,1,1,1,0
8251,23851,8315,71,8,1,7,0,0,0
8252,23853,8558,23,2,2,0,1,1,0
8253,23853,8634,77,5,3,2,0,0,0
8254,23854,7878,37,5,3,2,4,3,1
8255,23854,10267,63,4,3,1,2,1,1
8256,23856,9865,52,4,3,1,3,2,1
8257,23856,8372,48,5,0,5,0,0,0
8258,23859,9906,51,3,2,1,1,0,1
8259,23859,10205,49,3,1,2,2,0,2
8260,23862,8634,77,11,3,8,3,1,2
8261,23862,8305,23,4,2,2,2,2,0
8262,23863,8558,47,4,3,1,2,2,0
8263,23863,7878,53,5,4,1,2,1,1
8264,23865,8372,36,3,3,0,2,2,0
8265,23865,8302,64,12,4,8,2,1,1
8266,23866,9865,43,6,3,3,2,2,0
8267,23866,8633,57,5,0,5,1,1,0
8268,23868,9864,51,11,7,4,3,2,1
8269,23868,10268,49,4,3,1,2,0,2
8270,23869,10205,53,10,8,2,1,1,0
8271,23869,9783,47,4,0,4,0,0,0
8272,23870,8315,59,2,1,1,1,0,1
8273,23870,9906,41,0,0,0,0,0,0
8274,23873,7878,41,6,5,1,1,1,0
8275,23873,8305,59,4,2,2,2,1,1
8276,23875,8372,51,4,3,1,3,2,1
8277,23875,10267,49,5,1,4,0,0,0
8278,23876,8302,36,5,3,2,1,0,1
8279,23876,8633,64,6,2,4,0,0,0
8280,23878,10205,56,9,5,4,1,0,1
8281,23878,10268,44,7,5,2,1,0,1
8282,23881,8634,64,8,3,5,1,1,0
8283,23881,8560,36,3,1,2,0,0,0
8284,23882,7869,45,1,1,0,3,1,2
8285,23882,7878,55,2,0,2,3,1,2
8286,23885,10267,39,3,2,1,6,2,4
8287,23885,8633,61,11,4,7,1,0,1
8288,23886,9910,46,4,2,2,1,1,0
8289,23886,8302,54,2,2,0,0,0,0
8290,23887,9864,76,7,3,4,1,0,1
8291,23887,9865,24,2,1,1,1,0,1
8292,23888,9864,38,6,3,3,1,1,0
8293,23888,10205,62,4,2,2,0,0,0
8294,23889,8315,65,6,3,3,7,1,6
8295,23889,10268,35,6,2,4,1,0,1
8296,23890,9783,55,8,2,6,2,1,1
8297,23890,8581,45,3,1,2,4,1,3
8298,23892,7878,60,6,3,3,2,1,1
8299,23892,8560,40,5,4,1,0,0,0
8300,23893,8370,68,8,2,6,2,1,1
8301,23893,7869,32,3,2,1,1,0,1
8302,23894,8372,40,7,3,4,1,1,0
8303,23894,8305,60,3,2,1,1,1,0
8304,23895,8558,46,5,3,2,3,1,2
8305,23895,8633,54,6,3,3,3,2,1
8306,23897,9865,49,9,2,7,2,1,1
8307,23897,8302,51,6,1,5,1,0,1
8308,23898,8315,54,7,4,3,1,1,0
8309,23898,10205,46,6,2,4,0,0,0
8310,23899,10268,43,6,4,2,1,0,1
8311,23899,8581,57,2,0,2,0,0,0
8312,23900,8634,61,5,2,3,3,1,2
8313,23900,9783,39,3,1,2,0,0,0
8314,23901,9906,60,7,4,3,2,1,1
8315,23901,7878,40,2,2,0,0,0,0
8316,23902,8560,54,3,2,1,3,2,1
8317,23902,8370,46,5,2,3,1,0,1
8318,23903,7869,58,7,3,4,2,1,1
8319,23903,8372,42,3,2,1,0,0,0
8320,23904,8633,60,14,10,4,1,1,0
8321,23904,8305,40,1,0,1,1,0,1
8322,23905,8558,54,5,2,3,1,0,1
8323,23905,9910,46,3,1,2,2,0,2
8324,23906,10267,77,7,3,4,3,0,3
8325,23906,9865,23,0,0,0,1,0,1
8326,23907,9864,54,4,2,2,6,4,2
8327,23907,8302,46,5,3,2,0,0,0
8328,23908,9864,32,10,6,4,1,1,0
8329,23908,10267,68,3,0,3,0,0,0
8330,23909,8302,46,5,3,2,1,0,1
8331,23909,8558,54,2,0,2,0,0,0
8332,23910,8305,40,7,4,3,3,2,1
8333,23910,9865,60,8,3,5,1,1,0
8334,23911,9910,54,6,4,2,1,1,0
8335,23911,7869,46,1,0,1,1,0,1
8336,23912,8633,59,6,3,3,3,2,1
8337,23912,8560,41,3,2,1,1,0,1
8338,23913,9906,42,5,2,3,2,2,0
8339,23913,8372,58,4,3,1,0,0,0
8340,23914,9783,48,5,2,3,2,1,1
8341,23914,8370,52,3,2,1,2,1,1
8342,23916,8634,75,11,5,6,3,2,1
8343,23916,10205,25,1,0,1,0,0,0
8344,23917,8581,46,4,2,2,1,1,0
8345,23917,8315,54,3,1,2,2,1,1
8346,23918,8302,54,7,4,3,1,1,0
8347,23918,10267,46,7,2,5,2,1,1
8348,23920,9910,54,5,4,1,1,1,0
8349,23920,8305,46,8,3,5,1,1,0
8350,23921,7869,40,6,4,2,5,2,3
8351,23921,8633,60,4,0,4,1,0,1
8352,23922,8372,41,5,3,2,1,1,0
8353,23922,8560,59,4,2,2,1,1,0
8354,23925,10268,19,3,3,0,2,1,1
8355,23925,8634,81,2,0,2,0,0,0
8356,23932,8560,49,1,1,0,1,0,1
8357,23932,8633,51,12,5,7,3,0,3
8358,23933,8372,48,3,1,2,1,0,1
8359,23933,9906,52,2,1,1,0,0,0
8360,23934,8370,61,6,4,2,1,1,0
8361,23934,9783,39,8,5,3,3,1,2
8362,23935,7878,64,7,3,4,1,1,0
8363,23935,10268,36,2,2,0,2,1,1
8364,23936,8634,69,6,5,1,2,1,1
8365,23936,10205,31,4,2,2,1,1,0
8366,23937,8315,46,7,2,5,1,1,0
8367,23937,8581,54,6,3,3,1,0,1
8368,23940,7869,54,8,2,6,1,1,0
8369,23940,9865,46,0,0,0,2,1,1
8370,23942,9906,45,8,3,5,3,1,2
8371,23942,8633,55,2,1,1,0,0,0
8372,23943,9783,59,7,5,2,1,1,0
8373,23943,8372,41,4,0,4,2,1,1
8374,23944,10268,44,8,5,3,8,2,6
8375,23944,8370,56,6,1,5,0,0,0
8376,23945,10205,39,5,2,3,2,2,0
8377,23945,7878,61,5,0,5,1,0,1
8378,23946,8634,74,10,4,6,2,1,1
8379,23946,8315,26,8,2,6,0,0,0
8380,23948,9864,57,10,3,7,1,1,0
8381,23948,8558,43,1,0,1,1,1,0
8382,23951,8560,62,2,1,1,5,3,2
8383,23951,9865,38,2,0,2,1,0,1
8384,23952,9906,36,5,2,3,1,1,0
8385,23952,9910,64,5,4,1,0,0,0
8386,23956,7878,46,5,2,3,1,0,1
8387,23956,8315,54,4,0,4,1,0,1
8388,23958,8305,44,6,4,2,2,0,2
8389,23958,8558,56,9,1,8,2,0,2
8390,23961,9865,48,3,0,3,1,1,0
8391,23961,9906,52,3,0,3,1,0,1
8392,23963,8633,53,6,4,2,6,1,5
8393,23963,10268,47,4,1,3,0,0,0
8394,23965,8315,52,12,6,6,4,1,3
8395,23965,8370,48,3,1,2,0,0,0
8396,23968,9864,51,6,5,1,1,1,0
8397,23968,8305,49,6,3,3,3,0,3
8398,23971,8302,66,5,3,2,1,0,1
8399,23971,9906,34,4,0,4,0,0,0
8400,23972,9865,29,6,4,2,1,0,1
8401,23972,9783,71,10,7,3,0,0,0
8402,23973,9910,47,7,1,6,2,1,1
8403,23973,10268,53,1,0,1,0,0,0
8404,23974,8633,52,8,4,4,2,0,2
8405,23974,10205,48,5,4,1,0,0,0
8406,23977,8634,70,7,4,3,1,0,1
8407,23977,7878,30,4,3,1,0,0,0
8408,23982,10268,62,8,3,5,2,2,0
8409,23982,9865,38,5,2,3,3,2,1
8410,23984,8633,67,6,2,4,3,1,2
8411,23984,8315,33,3,1,2,1,1,0
8412,23985,8581,46,6,4,2,1,0,1
8413,23985,8372,54,7,4,3,0,0,0
8414,23986,8370,38,4,3,1,2,1,1
8415,23986,8634,62,9,3,6,1,0,1
8416,23989,8305,49,7,6,1,3,2,1
8417,23989,8560,51,4,1,3,2,0,2
8418,23991,10267,54,9,5,4,1,0,1
8419,23991,9783,46,4,3,1,1,0,1
8420,23992,8302,48,5,3,2,6,2,4
8421,23992,10268,52,7,3,4,0,0,0
8422,23993,10205,67,14,7,7,4,1,3
8423,23993,9865,33,4,1,3,1,0,1
8424,23994,9910,66,6,1,5,1,1,0
8425,23994,8315,34,5,3,2,0,0,0
8426,23995,8633,65,8,5,3,1,0,1
8427,23995,8581,35,1,1,0,0,0,0
8428,23999,9906,51,5,4,1,2,2,0
8429,23999,8305,49,4,1,3,0,0,0
8430,24000,8558,42,3,2,1,2,1,1
8431,24000,9783,58,6,3,3,0,0,0
8432,24002,8302,42,5,4,1,4,2,2
8433,24002,10205,58,12,7,5,2,0,2
8434,24005,8634,53,6,2,4,3,2,1
8435,24005,8633,47,5,2,3,0,0,0
8436,24007,8370,48,8,3,5,3,2,1
8437,24007,9864,52,4,2,2,1,0,1
8438,24008,9864,53,13,4,9,2,0,2
8439,24008,8560,47,4,4,0,0,0,0
8440,24009,7869,53,5,2,3,1,1,0
8441,24009,9906,47,4,2,2,0,0,0
8442,24010,9783,56,4,1,3,2,2,0
8443,24010,8305,44,4,2,2,1,0,1
8444,24011,10268,57,4,1,3,5,0,5
8445,24011,8558,43,2,0,2,1,0,1
8446,24012,10205,44,4,2,2,2,0,2
8447,24012,10267,56,6,1,5,0,0,0
8448,24015,9910,40,2,1,1,1,1,0
8449,24015,8634,60,2,2,0,0,0,0
8450,24016,7878,37,6,1,5,3,1,2
8451,24016,8633,63,5,2,3,1,0,1
8452,24019,8302,53,6,3,3,1,1,0
8453,24019,8305,47,3,0,3,1,0,1
8454,24020,7869,47,3,2,1,2,1,1
8455,24020,9865,53,4,1,3,3,1,2
8456,24021,8560,56,9,3,6,2,1,1
8457,24021,9910,44,7,3,4,0,0,0
8458,24022,9906,38,4,2,2,4,2,2
8459,24022,8633,62,10,5,5,1,0,1
8460,24023,8372,59,6,3,3,2,1,1
8461,24023,9783,41,2,0,2,0,0,0
8462,24024,10268,39,3,2,1,1,0,1
8463,24024,8370,61,4,1,3,0,0,0
8464,24025,10205,57,6,1,5,2,0,2
8465,24025,7878,43,4,0,4,1,0,1
8466,24026,8315,42,4,2,2,2,1,1
8467,24026,8634,58,9,4,5,1,0,1
8468,24028,9906,60,4,3,1,3,2,1
8469,24028,8560,40,6,4,2,2,0,2
8470,24029,9783,56,5,4,1,1,1,0
8471,24029,7869,44,7,1,6,1,0,1
8472,24030,10268,54,6,2,4,1,1,0
8473,24030,8305,46,6,2,4,0,0,0
8474,24034,8634,70,9,3,6,2,0,2
8475,24034,9865,30,3,2,1,1,0,1
8476,24035,7878,25,3,2,1,2,1,1
8477,24035,9910,75,5,2,3,0,0,0
8478,24036,8370,49,13,6,7,3,2,1
8479,24036,8633,51,5,2,3,2,1,1
8480,24037,9864,59,6,1,5,1,1,0
8481,24037,8372,41,5,3,2,3,1,2
8482,24038,9864,52,6,2,4,1,1,0
8483,24038,9906,48,4,0,4,1,0,1
8484,24041,10205,47,3,1,2,2,1,1
8485,24041,8305,53,6,2,4,5,2,3
8486,24044,8634,61,9,5,4,2,1,1
8487,24044,8302,39,4,2,2,1,0,1
8488,24046,8370,54,4,1,3,3,2,1
8489,24046,9910,46,6,3,3,0,0,0
8490,24047,8372,45,3,2,1,1,1,0
8491,24047,8633,55,10,5,5,3,1,2
8492,24048,9783,59,5,2,3,5,2,3
8493,24048,9906,41,9,1,8,0,0,0
8494,24049,8560,53,3,2,1,4,2,2
8495,24049,10268,47,2,1,1,0,0,0
8496,24050,7869,37,10,8,2,2,2,0
8497,24050,10205,63,13,3,10,1,0,1
8498,24052,8581,43,6,3,3,2,0,2
8499,24052,8558,57,7,1,6,0,0,0
8500,24053,10267,32,4,2,2,3,1,2
8501,24053,8634,68,3,0,3,1,0,1
8502,24056,8372,38,5,2,3,0,0,0
8503,24056,9910,62,10,1,9,0,0,0
8504,24057,9864,31,3,2,1,0,0,0
8505,24057,8633,69,5,2,3,0,0,0
8506,24058,9783,47,4,2,2,0,0,0
8507,24058,9864,53,5,0,5,0,0,0
8508,24059,9906,52,9,7,2,0,0,0
8509,24059,10268,48,3,0,3,0,0,0
8510,24061,7869,53,7,5,2,0,0,0
8511,24061,8315,47,7,3,4,0,0,0
8512,24063,8634,60,7,3,4,0,0,0
8513,24063,8558,40,3,0,3,0,0,0
8514,24064,10267,59,6,4,2,0,0,0
8515,24064,7878,41,3,0,3,0,0,0
8516,24067,9910,60,7,4,3,0,0,0
8517,24067,8633,40,5,0,5,0,0,0
8518,24068,10268,48,5,1,4,0,0,0
8519,24068,9783,52,7,0,7,0,0,0
8520,24071,7869,60,2,2,0,0,0,0
8521,24071,8581,40,3,1,2,0,0,0
8522,24073,8558,46,2,1,1,0,0,0
8523,24073,7878,54,6,3,3,0,0,0
8524,24074,8370,43,5,3,2,0,0,0
8525,24074,10267,57,8,5,3,0,0,0
8526,24078,10268,35,2,2,0,0,0,0
8527,24078,9864,65,13,2,11,0,0,0
8528,24079,9783,56,3,2,1,0,0,0
8529,24079,10205,44,2,1,1,0,0,0
8530,24080,9906,58,5,2,3,0,0,0
8531,24080,8315,42,0,0,0,0,0,0
8532,24081,8581,52,6,2,4,0,0,0
8533,24081,8560,48,1,0,1,0,0,0
8534,24082,8634,67,9,6,3,0,0,0
8535,24082,7869,33,1,0,1,0,0,0
8536,24083,8305,49,7,2,5,0,0,0
8537,24083,7878,51,6,3,3,0,0,0
8538,24084,8558,55,6,4,2,0,0,0
8539,24084,8370,45,5,2,3,0,0,0
8540,24085,10267,59,3,3,0,0,0,0
8541,24085,8372,41,0,0,0,0,0,0
8542,24087,9865,44,4,1,3,0,0,0
8543,24087,9910,56,3,1,2,0,0,0
8544,24092,7878,63,11,6,5,0,0,0
8545,24092,7869,37,3,2,1,0,0,0
8546,24098,9864,48,6,3,3,0,0,0
8547,24098,10205,52,2,0,2,0,0,0
8548,24101,9906,34,5,1,4,0,0,0
8549,24101,8634,66,6,5,1,0,0,0
8550,24102,8560,61,6,3,3,0,0,0
8551,24102,7878,39,5,4,1,0,0,0
8552,24111,9906,55,1,0,1,0,0,0
8553,24111,7878,45,0,0,0,0,0,0
8554,24112,8370,61,3,3,0,0,0,0
8555,24112,8560,39,4,2,2,0,0,0
8556,24113,8372,47,2,1,1,0,0,0
8557,24113,7869,53,6,3,3,0,0,0
8558,24115,8558,48,3,3,0,0,0,0
8559,24115,9910,52,5,5,0,0,0,0
8560,24117,8302,53,6,5,1,0,0,0
8561,24117,9864,47,7,3,4,0,0,0
8562,24119,8305,59,8,3,5,0,0,0
8563,24119,10267,41,2,2,0,0,0,0
8564,24124,10268,68,9,3,6,0,0,0
8565,24124,8372,32,3,2,1,0,0,0
8566,24130,8302,52,8,4,4,0,0,0
8567,24130,8560,48,3,2,1,0,0,0
8568,24133,10268,44,4,2,2,0,0,0
8569,24133,8633,56,8,5,3,0,0,0
8570,24141,9906,42,4,2,2,0,0,0
8571,24141,8302,58,3,0,3,0,0,0
8572,24142,9865,56,7,5,2,0,0,0
8573,24142,9783,44,2,0,2,0,0,0
8574,24143,10268,43,6,2,4,0,0,0
8575,24143,9910,57,9,5,4,0,0,0
8576,24144,10205,54,11,8,3,0,0,0
8577,24144,8633,46,5,2,3,0,0,0
8578,24146,8370,55,3,3,0,0,0,0
8579,24146,8581,45,2,0,2,0,0,0
8580,24147,7878,35,2,2,0,0,0,0
8581,24147,8634,65,11,3,8,0,0,0
8582,24148,8305,54,5,2,3,0,0,0
8583,24148,7869,46,4,0,4,0,0,0
8584,24150,9906,61,7,3,4,0,0,0
8585,24150,10267,39,2,0,2,0,0,0
8586,24151,8302,57,7,2,5,0,0,0
8587,24151,9783,43,5,1,4,0,0,0
8588,24152,10268,40,1,1,0,0,0,0
8589,24152,9865,60,2,0,2,0,0,0
8590,24153,9910,73,9,3,6,0,0,0
8591,24153,10205,27,1,0,1,0,0,0
8592,24154,8315,34,6,3,3,0,0,0
8593,24154,8633,66,9,2,7,0,0,0
8594,24155,8581,43,4,3,1,0,0,0
8595,24155,8372,57,6,3,3,0,0,0
8596,24157,7878,48,4,1,3,0,0,0
8597,24157,9864,52,4,1,3,0,0,0
8598,24161,9783,34,6,4,2,0,0,0
8599,24161,10267,66,3,1,2,0,0,0
8600,24162,8302,48,8,1,7,0,0,0
8601,24162,10268,52,3,2,1,0,0,0
8602,24163,10205,40,9,4,5,0,0,0
8603,24163,9865,60,5,2,3,0,0,0
8604,24164,8315,42,9,6,3,0,0,0
8605,24164,9910,58,2,0,2,0,0,0
8606,24165,8633,52,10,4,6,0,0,0
8607,24165,8581,48,3,1,2,0,0,0
8608,24167,8370,56,4,2,2,0,0,0
8609,24167,7878,44,3,0,3,0,0,0
8610,24169,9906,56,8,7,1,0,0,0
8611,24169,8305,44,6,0,6,0,0,0
8612,24172,8302,57,7,3,4,0,0,0
8613,24172,10205,43,5,4,1,0,0,0
8614,24173,8315,54,2,1,1,0,0,0
8615,24173,9865,46,4,1,3,0,0,0
8616,24174,9910,65,4,2,2,0,0,0
8617,24174,8581,35,2,1,1,0,0,0
8618,24175,8633,37,9,5,4,0,0,0
8619,24175,8634,63,7,3,4,0,0,0
8620,24178,8581,39,3,3,0,0,0,0
8621,24178,9910,61,7,3,4,0,0,0
8622,24180,9864,53,9,4,5,0,0,0
8623,24180,8302,47,3,1,2,0,0,0
8624,24182,8372,42,4,3,1,0,0,0
8625,24182,7878,58,6,2,4,0,0,0
8626,24183,8305,67,6,2,4,0,0,0
8627,24183,8558,33,1,1,0,0,0,0
8628,24184,10205,38,3,1,2,0,0,0
8629,24184,8603,62,8,0,8,0,0,0
8630,24187,8370,63,6,5,1,0,0,0
8631,24187,10267,37,4,2,2,0,0,0
8632,24188,8372,45,4,3,1,0,0,0
8633,24188,8370,55,2,1,1,0,0,0
8634,24194,9906,45,6,5,1,0,0,0
8635,24194,9783,55,3,0,3,0,0,0
8636,24195,9864,59,5,2,3,0,0,0
8637,24195,9869,41,4,0,4,0,0,0
8638,24196,8315,48,9,3,6,0,0,0
8639,24196,8603,52,6,3,3,0,0,0
8640,24197,7878,44,5,3,2,0,0,0
8641,24197,8558,56,5,1,4,0,0,0
8642,24198,8305,57,3,1,2,0,0,0
8643,24198,8372,43,9,3,6,0,0,0
8644,24203,8581,55,9,2,7,0,0,0
8645,24203,9783,45,6,2,4,0,0,0
8646,24206,8558,59,2,2,0,0,0,0
8647,24206,8315,41,2,1,1,0,0,0
8648,24208,8370,62,2,1,1,0,0,0
8649,24208,8305,38,10,5,5,0,0,0
8650,24209,8372,42,10,5,5,0,0,0
8651,24209,10205,58,3,2,1,0,0,0
8652,24210,8634,58,6,3,3,0,0,0
8653,24210,8633,42,7,1,6,0,0,0
8654,24213,9910,64,5,3,2,0,0,0
8655,24213,9783,36,1,0,1,0,0,0
8656,24216,9864,53,10,7,3,0,0,0
8657,24216,8558,47,2,1,1,0,0,0
8658,24217,8315,55,10,5,5,0,0,0
8659,24217,7878,45,3,2,1,0,0,0
8660,24218,8305,38,7,6,1,0,0,0
8661,24218,10205,62,0,0,0,0,0,0
8662,24219,8372,37,4,2,2,0,0,0
8663,24219,8633,63,8,6,2,0,0,0
8664,24220,8560,46,5,1,4,0,0,0
8665,24220,8634,54,3,1,2,0,0,0
8666,24221,8302,62,8,4,4,0,0,0
8667,24221,10267,38,0,0,0,0,0,0
8668,24224,8603,46,5,2,3,0,0,0
8669,24224,8581,54,2,1,1,0,0,0
8670,24225,9906,52,7,3,4,0,0,0
8671,24225,8558,48,2,0,2,0,0,0
8672,24226,7878,69,5,4,1,0,0,0
8673,24226,9864,31,7,4,3,0,0,0
8674,24230,8372,39,4,1,3,0,0,0
8675,24230,8560,61,5,1,4,0,0,0
8676,24231,10267,33,6,2,4,0,0,0
8677,24231,8634,67,9,4,5,0,0,0
8678,24232,9783,42,3,1,2,0,0,0
8679,24232,8302,58,1,0,1,0,0,0
8680,24238,8633,57,5,3,2,0,0,0
8681,24238,10205,43,3,1,2,0,0,0
8682,24239,8560,55,5,3,2,0,0,0
8683,24239,8305,45,6,3,3,0,0,0
8684,24240,8372,51,8,4,4,0,0,0
8685,24240,10267,49,1,0,1,0,0,0
8686,24241,8634,65,7,3,4,0,0,0
8687,24241,9783,35,2,1,1,0,0,0
8688,24243,8306,58,8,5,3,0,0,0
8689,24243,8603,42,3,2,1,0,0,0
8690,24244,9910,48,5,3,2,0,0,0
8691,24244,8558,52,2,1,1,0,0,0
8692,24246,9906,43,3,2,1,0,0,0
8693,24246,8315,57,7,4,3,0,0,0
8694,24250,8305,37,3,1,2,0,0,0
8695,24250,10267,63,7,1,6,0,0,0
8696,24252,8634,69,6,3,3,0,0,0
8697,24252,9869,31,2,0,2,0,0,0
8698,24256,8315,47,7,2,5,0,0,0
8699,24256,8581,53,2,2,0,0,0,0
8700,24257,9864,58,5,2,3,0,0,0
8701,24257,9906,42,6,2,4,0,0,0
8702,24258,8633,48,11,7,4,0,0,0
8703,24258,8560,52,2,1,1,0,0,0
8704,24259,10205,39,4,3,1,0,0,0
8705,24259,10267,61,3,0,3,0,0,0
8706,24260,8305,51,7,5,2,0,0,0
8707,24260,9783,49,3,1,2,0,0,0
8708,24264,7878,42,8,3,5,0,0,0
8709,24264,8306,58,2,0,2,0,0,0
8710,24265,8315,41,6,4,2,0,0,0
8711,24265,9910,59,4,3,1,0,0,0
8712,24266,9864,53,7,2,5,0,0,0
8713,24266,8581,47,3,1,2,0,0,0
8714,24267,9906,43,7,5,2,0,0,0
8715,24267,8370,57,5,2,3,0,0,0
8716,24269,8633,48,8,4,4,0,0,0
8717,24269,10267,52,3,1,2,0,0,0
8718,24270,9783,55,4,1,3,0,0,0
8719,24270,10205,45,2,0,2,0,0,0
8720,24271,9869,46,5,4,1,0,0,0
8721,24271,8305,54,4,3,1,0,0,0
8722,24272,8603,54,6,1,5,0,0,0
8723,24272,8372,46,1,0,1,0,0,0
8724,24274,7878,33,3,2,1,0,0,0
8725,24274,8302,67,6,1,5,0,0,0
8726,24275,8306,61,6,3,3,0,0,0
8727,24275,8315,39,6,5,1,0,0,0
8728,24277,9906,51,5,3,2,0,0,0
8729,24277,8581,49,2,0,2,0,0,0
8730,24278,8560,49,11,2,9,0,0,0
8731,24278,10267,51,3,2,1,0,0,0
8732,24279,9783,48,7,3,4,0,0,0
8733,24279,8633,52,6,3,3,0,0,0
8734,24280,10205,48,1,1,0,0,0,0
8735,24280,9869,52,7,1,6,0,0,0
8736,24281,8603,49,4,2,2,0,0,0
8737,24281,8305,51,3,2,1,0,0,0
8738,24282,8372,52,8,3,5,0,0,0
8739,24282,8558,48,3,1,2,0,0,0
8740,24283,8634,61,5,3,2,0,0,0
8741,24283,7878,39,5,1,4,0,0,0
8742,24284,8315,54,4,3,1,0,0,0
8743,24284,8302,46,3,0,3,0,0,0
8744,24285,9864,42,2,2,0,0,0,0
8745,24285,8306,58,3,0,3,0,0,0
8746,24287,8370,57,5,1,4,0,0,0
8747,24287,8581,43,4,0,4,0,0,0
8748,24288,9910,68,5,3,2,0,0,0
8749,24288,8370,32,0,0,0,0,0,0
8750,24290,8302,57,17,4,13,0,0,0
8751,24290,9906,43,7,4,3,0,0,0
8752,24291,8634,69,17,7,10,0,0,0
8753,24291,9864,31,1,1,0,0,0,0
8754,24295,8633,67,10,4,6,0,0,0
8755,24295,8603,33,2,1,1,0,0,0
8756,24298,9910,52,7,3,4,0,0,0
8757,24298,8581,48,8,2,6,0,0,0
8758,24299,9906,37,6,2,4,0,0,0
8759,24299,8306,63,5,3,2,0,0,0
8760,24300,9864,47,6,2,4,0,0,0
8761,24300,8302,53,3,0,3,0,0,0
8762,24302,8372,48,4,3,1,0,0,0
8763,24302,7878,52,0,0,0,0,0,0
8764,24303,8305,37,4,3,1,0,0,0
8765,24303,8558,63,5,2,3,0,0,0
8766,24307,8370,45,8,3,5,0,0,0
8767,24307,10267,55,8,3,5,0,0,0
8768,24309,8306,58,6,3,3,0,0,0
8769,24309,8581,42,6,2,4,0,0,0
8770,24312,8372,54,2,1,1,0,0,0
8771,24312,8315,46,2,2,0,0,0,0
8772,24313,7878,44,9,4,5,0,0,0
8773,24313,8305,56,3,0,3,0,0,0
8774,24314,10205,53,4,3,1,0,0,0
8775,24314,8558,47,4,0,4,0,0,0
8776,24315,8603,36,1,1,0,0,0,0
8777,24315,8633,64,8,2,6,0,0,0
8778,24316,8560,57,3,1,2,0,0,0
8779,24316,9869,43,3,0,3,0,0,0
8780,24317,9783,43,4,3,1,0,0,0
8781,24317,10267,57,4,3,1,0,0,0
8782,24318,9910,42,4,2,2,0,0,0
8783,24318,8306,58,5,3,2,0,0,0
8784,24319,8302,47,6,3,3,0,0,0
8785,24319,8581,53,9,2,7,0,0,0
8786,24320,9906,34,4,1,3,0,0,0
8787,24320,8634,66,4,3,1,0,0,0
8788,24321,9864,47,2,1,1,0,0,0
8789,24321,8372,53,2,1,1,0,0,0
8790,24325,8603,56,2,1,1,0,0,0
8791,24325,8560,44,4,0,4,0,0,0
8792,24326,10267,53,5,4,1,0,0,0
8793,24326,9869,47,2,0,2,0,0,0
8794,24328,8370,46,8,4,4,0,0,0
8795,24328,8306,54,4,2,2,0,0,0
8796,24329,9910,80,13,2,11,0,0,0
8797,24329,8302,20,3,2,1,0,0,0
8798,24331,9906,55,4,1,3,0,0,0
8799,24331,8372,45,2,1,1,0,0,0
8800,24333,10205,41,5,2,3,0,0,0
8801,24333,8315,59,2,2,0,0,0,0
8802,24334,7878,37,6,3,3,0,0,0
8803,24334,8633,63,6,1,5,0,0,0
8804,24335,8560,49,3,0,3,0,0,0
8805,24335,8558,51,1,0,1,0,0,0
8806,24337,9783,47,4,1,3,0,0,0
8807,24337,9869,53,6,3,3,0,0,0
8808,24338,8306,45,8,4,4,0,0,0
8809,24338,8302,55,4,2,2,0,0,0
8810,24340,8372,41,6,3,3,0,0,0
8811,24340,8581,59,4,1,3,0,0,0
8812,24341,8305,61,6,3,3,0,0,0
8813,24341,9906,39,3,2,1,0,0,0
8814,24342,10205,42,6,5,1,0,0,0
8815,24342,9864,58,2,1,1,0,0,0
8816,24343,8315,39,4,4,0,0,0,0
8817,24343,8633,61,8,4,4,0,0,0
8818,24344,8560,48,3,1,2,0,0,0
8819,24344,7878,52,4,1,3,0,0,0
8820,24345,10267,62,9,6,3,0,0,0
8821,24345,8558,38,10,4,6,0,0,0
8822,24346,9783,53,17,8,9,0,0,0
8823,24346,8603,47,0,0,0,0,0,0
8824,24347,8370,60,6,3,3,0,0,0
8825,24347,9869,40,4,2,2,0,0,0
8826,24348,8302,41,6,4,2,0,0,0
8827,24348,8370,59,3,0,3,0,0,0
8828,24349,8634,51,8,4,4,0,0,0
8829,24349,8306,49,7,4,3,0,0,0
8830,24350,9910,64,6,4,2,0,0,0
8831,24350,8372,36,4,1,3,0,0,0
8832,24354,8560,43,5,4,1,0,0,0
8833,24354,8315,57,4,2,2,0,0,0
8834,24356,9783,56,11,5,6,0,0,0
8835,24356,8558,44,13,7,6,0,0,0
8836,24358,8634,65,9,3,6,0,0,0
8837,24358,8302,35,4,2,2,0,0,0
8838,24361,8581,43,3,2,1,0,0,0
8839,24361,10205,57,0,0,0,0,0,0
8840,24362,9906,29,5,3,2,0,0,0
8841,24362,8633,71,8,3,5,0,0,0
8842,24363,8560,69,4,2,2,0,0,0
8843,24363,9864,31,4,1,3,0,0,0
8844,24365,9783,62,5,2,3,0,0,0
8845,24365,7878,38,7,1,6,0,0,0
8846,24366,8558,39,5,2,3,0,0,0
8847,24366,9869,61,3,1,2,0,0,0
8848,24368,8370,29,3,2,1,0,0,0
8849,24368,8634,71,5,3,2,0,0,0
8850,24369,8302,53,7,2,5,0,0,0
8851,24369,8372,47,7,3,4,0,0,0
8852,24379,8302,52,5,5,0,0,0,0
8853,24379,8305,48,5,5,0,0,0,0
8854,24380,8306,30,4,3,1,0,0,0
8855,24380,10205,70,5,3,2,0,0,0
8856,24381,9910,41,3,1,2,0,0,0
8857,24381,8633,59,8,3,5,0,0,0
8858,24384,9783,56,6,5,1,0,0,0
8859,24384,9864,44,0,0,0,0,0,0
8860,24385,8315,43,4,1,3,0,0,0
8861,24385,9869,57,2,1,1,0,0,0
8862,24387,8558,38,7,3,4,0,0,0
8863,24387,8370,62,2,2,0,0,0,0
8864,24388,8370,44,3,2,1,0,0,0
8865,24388,8372,56,1,0,1,0,0,0
8866,24390,10205,46,7,2,5,0,0,0
8867,24390,8302,54,2,0,2,0,0,0
8868,24391,8306,49,7,3,4,0,0,0
8869,24391,8633,51,4,4,0,0,0,0
8870,24392,8560,59,7,1,6,0,0,0
8871,24392,9910,41,1,0,1,0,0,0
8872,24393,10267,54,4,1,3,0,0,0
8873,24393,8581,46,5,4,1,0,0,0
8874,24394,9906,59,7,1,6,0,0,0
8875,24394,9783,41,2,0,2,0,0,0
8876,24395,9869,57,5,2,3,0,0,0
8877,24395,9864,43,4,2,2,0,0,0
8878,24396,8315,47,8,5,3,0,0,0
8879,24396,8603,53,0,0,0,0,0,0
8880,24397,7878,32,5,2,3,0,0,0
8881,24397,8558,68,3,1,2,0,0,0
8882,24399,8581,53,6,1,5,0,0,0
8883,24399,8302,47,4,1,3,0,0,0
8884,24400,9906,31,4,1,3,0,0,0
8885,24400,8634,69,5,3,2,0,0,0
8886,24403,7878,57,6,1,5,0,0,0
8887,24403,10205,43,2,1,1,0,0,0
8888,24404,8558,48,6,3,3,0,0,0
8889,24404,8633,52,1,0,1,0,0,0
8890,24405,8560,70,5,3,2,0,0,0
8891,24405,8603,30,3,3,0,0,0,0
8892,24406,10267,55,9,4,5,0,0,0
8893,24406,9869,45,8,1,7,0,0,0
8894,24407,8370,62,3,2,1,0,0,0
8895,24407,9783,38,7,3,4,0,0,0
8896,24408,8305,52,3,1,2,0,0,0
8897,24408,8372,48,10,6,4,0,0,0
8898,24409,10205,38,9,4,5,0,0,0
8899,24409,8634,62,6,2,4,0,0,0
8900,24411,8560,65,7,3,4,0,0,0
8901,24411,8306,35,7,6,1,0,0,0
8902,24417,8370,68,5,3,2,0,0,0
8903,24417,7878,32,3,2,1,0,0,0
8904,24418,8305,48,8,2,6,0,0,0
8905,24418,8370,52,9,5,4,0,0,0
8906,24419,8372,52,6,3,3,0,0,0
8907,24419,10205,48,3,1,2,0,0,0
8908,24421,8302,73,8,4,4,0,0,0
8909,24421,8560,27,3,2,1,0,0,0
8910,24423,9783,33,3,2,1,0,0,0
8911,24423,9910,67,3,1,2,0,0,0
8912,24424,8581,52,8,3,5,0,0,0
8913,24424,9869,48,6,4,2,0,0,0
8914,24425,9906,58,10,4,6,0,0,0
8915,24425,8603,42,4,2,2,0,0,0
8916,24426,8558,30,2,1,1,0,0,0
8917,24426,9864,70,6,0,6,0,0,0
8918,24428,10205,54,4,1,3,0,0,0
8919,24428,8305,46,7,6,1,0,0,0
8920,24432,9783,55,7,2,5,0,0,0
8921,24432,8306,45,2,2,0,0,0,0
8922,24434,8581,44,4,2,2,0,0,0
8923,24434,8603,56,2,0,2,0,0,0
8924,24435,9906,46,4,3,1,0,0,0
8925,24435,8558,54,3,1,2,0,0,0
8926,24440,8372,36,4,1,3,0,0,0
8927,24440,8560,64,3,1,2,0,0,0
8928,24441,8634,66,14,9,5,0,0,0
8929,24441,10267,34,2,0,2,0,0,0
8930,24444,9910,63,8,5,3,0,0,0
8931,24444,8603,37,4,1,3,0,0,0
8932,24445,8581,42,5,3,2,0,0,0
8933,24445,8558,58,2,0,2,0,0,0
8934,24448,8633,56,8,4,4,0,0,0
8935,24448,10205,44,4,1,3,0,0,0
8936,24449,8560,63,8,2,6,0,0,0
8937,24449,8305,37,1,0,1,0,0,0
8938,24451,8634,62,4,3,1,0,0,0
8939,24451,9783,38,9,4,5,0,0,0
8940,24452,9869,45,6,4,2,0,0,0
8941,24452,8302,55,7,3,4,0,0,0
8942,24453,8603,62,10,3,7,0,0,0
8943,24453,8306,38,1,0,1,0,0,0
8944,24454,8558,39,5,2,3,0,0,0
8945,24454,9910,61,0,0,0,0,0,0
8946,24455,7878,44,5,3,2,0,0,0
8947,24455,8581,56,7,0,7,0,0,0
8948,24456,8315,79,7,2,5,0,0,0
8949,24456,9906,21,2,1,1,0,0,0
8950,24457,9864,60,4,2,2,0,0,0
8951,24457,8370,40,5,2,3,0,0,0
8952,24459,8560,54,2,1,1,0,0,0
8953,24459,10205,46,6,2,4,0,0,0
8954,24460,10267,52,2,1,1,0,0,0
8955,24460,8305,48,11,4,7,0,0,0
8956,24461,8372,45,4,1,3,0,0,0
8957,24461,9783,55,1,1,0,0,0,0
8958,24462,8634,81,7,3,4,0,0,0
8959,24462,9869,19,4,3,1,0,0,0
8960,24464,8306,68,8,5,3,0,0,0
8961,24464,8558,32,8,4,4,0,0,0
8962,24466,8315,64,8,4,4,0,0,0
8963,24466,8581,36,6,3,3,0,0,0
8964,24467,9864,44,4,3,1,0,0,0
8965,24467,9906,56,5,2,3,0,0,0
8966,24468,8633,45,8,6,2,0,0,0
8967,24468,8560,55,5,2,3,0,0,0
8968,24470,9783,55,10,5,5,0,0,0
8969,24470,8305,45,4,1,3,0,0,0
8970,24472,8603,32,1,1,0,0,0,0
8971,24472,8634,68,4,2,2,0,0,0
8972,24473,8558,48,6,1,5,0,0,0
8973,24473,8302,52,1,0,1,0,0,0
8974,24474,8306,63,5,2,3,0,0,0
8975,24474,7878,37,3,3,0,0,0,0
8976,24476,9864,59,10,6,4,0,0,0
8977,24476,8581,41,7,2,5,0,0,0
8978,24477,9906,32,7,4,3,0,0,0
8979,24477,8370,68,8,3,5,0,0,0
8980,24478,8560,36,6,2,4,0,0,0
8981,24478,8370,64,9,4,5,0,0,0
8982,24479,8633,46,7,4,3,0,0,0
8983,24479,10267,54,8,1,7,0,0,0
8984,24481,8305,54,10,5,5,0,0,0
8985,24481,9869,46,2,1,1,0,0,0
8986,24483,8634,75,4,4,0,0,0,0
8987,24483,8558,25,3,2,1,0,0,0
8988,24484,8302,66,9,4,5,0,0,0
8989,24484,7878,34,4,3,1,0,0,0
8990,24485,8315,40,4,1,3,0,0,0
8991,24485,8306,60,1,0,1,0,0,0
8992,24486,9864,41,6,2,4,0,0,0
8993,24486,9910,59,4,1,3,0,0,0
8994,24488,8560,49,8,2,6,0,0,0
8995,24488,10267,51,0,0,0,0,0,0
8996,24489,8633,58,5,3,2,0,0,0
8997,24489,9783,42,4,0,4,0,0,0
8998,24490,9869,52,9,4,5,0,0,0
8999,24490,10205,48,8,3,5,0,0,0
9000,24492,8558,47,3,2,1,0,0,0
9001,24492,8372,53,8,1,7,0,0,0
9002,24493,8634,57,6,4,2,0,0,0
9003,24493,7878,43,2,0,2,0,0,0
9004,24494,8302,36,5,3,2,0,0,0
9005,24494,8315,64,8,5,3,0,0,0
9006,24496,9906,52,4,2,2,0,0,0
9007,24496,9910,48,7,5,2,0,0,0
9008,24498,8370,46,5,3,2,0,0,0
9009,24498,8306,54,2,2,0,0,0,0
9010,24499,9910,49,7,3,4,0,0,0
9011,24499,8302,51,9,1,8,0,0,0
9012,24500,8634,56,8,6,2,0,0,0
9013,24500,8581,44,5,0,5,0,0,0
9014,24501,9906,49,6,4,2,0,0,0
9015,24501,8372,51,5,1,4,0,0,0
9016,24502,8305,42,5,1,4,0,0,0
9017,24502,9864,58,4,0,4,0,0,0
9018,24503,10205,44,6,3,3,0,0,0
9019,24503,8315,56,2,0,2,0,0,0
9020,24504,8633,62,11,6,5,0,0,0
9021,24504,7878,38,7,2,5,0,0,0
9022,24505,8560,48,4,1,3,0,0,0
9023,24505,8558,52,8,3,5,0,0,0
9024,24506,8603,27,3,3,0,0,0,0
9025,24506,10267,73,16,3,13,0,0,0
9026,24508,8306,49,4,2,2,0,0,0
9027,24508,8302,51,8,2,6,0,0,0
9028,24509,8634,58,9,5,4,0,0,0
9029,24509,9910,42,5,3,2,0,0,0
9030,24511,9906,49,7,2,5,0,0,0
9031,24511,8305,51,4,2,2,0,0,0
9032,24512,9864,54,8,1,7,0,0,0
9033,24512,10205,46,3,2,1,0,0,0
9034,24516,9783,44,2,1,1,0,0,0
9035,24516,8603,56,3,1,2,0,0,0
9036,24517,9869,45,4,3,1,0,0,0
9037,24517,8370,55,5,2,3,0,0,0
9038,24518,8370,52,4,3,1,0,0,0
9039,24518,8302,48,7,3,4,0,0,0
9040,24520,9910,71,3,3,0,0,0,0
9041,24520,8372,29,7,2,5,0,0,0
9042,24523,9864,32,7,4,3,0,0,0
9043,24523,8633,68,13,4,9,0,0,0
9044,24524,8560,48,9,5,4,0,0,0
9045,24524,8315,52,4,2,2,0,0,0
9046,24528,8634,62,18,3,15,0,0,0
9047,24528,8302,38,6,4,2,0,0,0
9048,24529,8306,62,7,1,6,0,0,0
9049,24529,8372,38,5,0,5,0,0,0
9050,24530,9910,62,10,5,5,0,0,0
9051,24530,8305,38,2,0,2,0,0,0
9052,24533,9864,39,6,4,2,0,0,0
9053,24533,8560,61,6,3,3,0,0,0
9054,24534,8315,45,5,5,0,0,0,0
9055,24534,10267,55,5,2,3,0,0,0
9056,24535,7878,56,2,2,0,0,0,0
9057,24535,9783,44,4,0,4,0,0,0
9058,24538,8634,45,5,4,1,0,0,0
9059,24538,8370,55,8,2,6,0,0,0
9060,24541,10205,27,4,3,1,0,0,0
9061,24541,9910,73,0,0,0,0,0,0
9062,24542,8581,42,8,4,4,0,0,0
9063,24542,8633,58,5,2,3,0,0,0
9064,24548,8372,34,3,2,1,0,0,0
9065,24548,8634,66,3,1,2,0,0,0
9066,24549,8302,57,10,8,2,0,0,0
9067,24549,8305,43,1,1,0,0,0,0
9068,24552,8560,35,3,3,0,0,0,0
9069,24552,8581,65,6,3,3,0,0,0
9070,24553,9906,51,9,4,5,0,0,0
9071,24553,10267,49,2,0,2,0,0,0
9072,24554,9864,48,3,3,0,0,0,0
9073,24554,9783,52,4,2,2,0,0,0
9074,24557,8558,37,3,1,2,0,0,0
9075,24557,8370,63,8,4,4,0,0,0
