,match_id,team_id,possession_until_halftime,shots_on,shots_on_first_half,shots_on_second_half,goals,goals_first_half,goals_second_half
0,1729,10260,54,11,6,5,1,1,0
1,1729,10261,46,1,0,1,1,1,0
2,1730,9825,61,12,7,5,1,1,0
3,1730,8659,39,2,0,2,0,0,0
4,1731,8472,43,4,2,2,1,0,1
5,1731,8650,57,11,4,7,0,0,0
6,1732,8654,56,5,3,2,2,2,0
7,1732,8528,44,7,1,6,1,0,1
8,1733,10252,54,5,4,1,4,0,4
9,1733,8456,46,9,2,7,2,0,2
10,1734,8668,59,2,1,1,3,1,2
11,1734,8655,41,8,4,4,2,1,1
12,1735,8549,49,7,3,4,4,1,3
13,1735,8586,51,2,0,2,0,0,0
14,1736,8559,47,5,3,2,3,3,0
15,1736,10194,53,1,0,1,1,0,1
16,1738,8462,36,7,5,2,4,3,1
17,1738,8455,64,6,5,1,0,0,0
18,1739,10260,58,11,6,5,2,2,0
19,1739,8654,42,3,2,1,0,0,0
20,1741,8456,43,11,3,8,2,0,2
21,1741,8549,57,5,5,0,0,0,0
22,1742,8559,55,13,7,6,1,0,1
23,1742,8668,45,6,5,1,0,0,0
24,1745,8650,54,9,5,4,1,0,1
25,1745,8462,46,1,1,0,0,0,0
26,1746,10252,49,2,2,0,2,1,1
27,1746,8655,51,7,4,3,3,1,2
28,1747,10261,51,4,2,2,2,2,0
29,1747,8659,49,5,1,4,1,0,1
30,1748,8528,44,4,3,1,2,1,1
31,1748,9879,56,1,0,1,0,0,0
32,1749,10260,53,7,2,5,5,4,1
33,1749,8667,47,3,0,3,3,1,2
34,1750,8650,53,5,2,3,2,1,1
35,1750,8586,47,5,2,3,1,0,1
36,1751,8668,48,5,4,1,1,0,1
37,1751,9879,52,7,3,4,0,0,0
38,1752,8654,55,8,1,7,1,1,0
39,1752,8549,45,8,2,6,1,0,1
40,1753,10261,44,5,3,2,2,0,2
41,1753,10252,56,1,1,0,0,0,0
42,1754,8559,51,8,3,5,1,0,1
43,1754,8456,49,7,3,4,1,0,1
44,1755,8659,57,7,2,5,2,1,1
45,1755,8655,43,4,1,3,2,0,2
46,1756,8528,53,9,4,5,2,1,1
47,1756,8462,47,8,3,5,1,0,1
48,1757,9825,63,4,3,1,2,1,1
49,1757,10194,37,3,2,1,1,0,1
50,1758,8455,54,8,6,2,5,3,2
51,1758,8472,46,0,0,0,0,0,0
52,1759,10260,43,9,5,4,2,1,1
53,1759,9825,57,6,3,3,2,1,1
54,1760,8650,65,8,7,1,3,2,1
55,1760,8659,35,2,1,1,0,0,0
56,1761,8462,52,3,3,0,1,1,0
57,1761,8472,48,4,2,2,2,0,2
58,1762,8654,57,11,7,4,1,0,1
59,1762,8668,43,3,1,2,3,0,3
60,1763,10252,67,10,7,3,2,1,1
61,1763,8549,33,5,2,3,1,1,0
62,1764,8456,48,6,2,4,1,1,0
63,1764,8586,52,5,2,3,2,1,1
64,1765,8455,57,9,6,3,2,1,1
65,1765,8655,43,3,1,2,0,0,0
66,1766,9879,49,5,4,1,2,1,1
67,1766,10261,51,6,1,5,1,0,1
68,1767,8667,53,8,2,6,1,0,1
69,1767,8559,47,7,1,6,0,0,0
70,1768,8528,51,9,2,7,5,2,3
71,1768,10194,49,1,0,1,0,0,0
72,1769,10260,59,11,5,6,2,1,1
73,1769,10194,41,0,0,0,1,0,1
74,1770,10252,42,4,4,0,1,1,0
75,1770,9825,58,8,3,5,1,0,1
76,1772,8549,39,2,1,1,1,1,0
77,1772,8668,61,7,5,2,2,0,2
78,1774,8655,60,8,4,4,2,1,1
79,1774,8472,40,5,3,2,1,0,1
80,1775,9879,55,13,3,10,2,1,1
81,1775,8586,45,5,3,2,1,1,0
82,1776,8650,61,7,4,3,2,1,1
83,1776,8559,39,10,1,9,2,2,0
84,1778,8667,53,3,0,3,1,1,0
85,1778,8456,47,3,0,3,0,0,0
86,1779,9879,57,5,4,1,1,1,0
87,1779,8650,43,8,5,3,0,0,0
88,1780,8472,45,4,3,1,3,2,1
89,1780,8654,55,6,5,1,1,0,1
90,1781,8655,41,10,4,6,3,1,2
91,1781,8586,59,10,2,8,0,0,0
92,1782,10252,40,7,3,4,3,1,2
93,1782,10260,60,5,4,1,1,0,1
94,1783,8559,47,2,2,0,1,0,1
95,1783,8549,53,10,4,6,0,0,0
96,1784,9825,53,5,2,3,1,0,1
97,1784,8456,47,4,1,3,0,0,0
98,1785,8462,57,4,3,1,1,0,1
99,1785,8667,43,7,2,5,0,0,0
100,1786,10194,59,9,4,5,2,2,0
101,1786,8659,41,3,1,2,4,3,1
102,1787,8668,56,5,3,2,1,0,1
103,1787,8528,44,7,4,3,0,0,0
104,1788,8455,62,17,8,9,1,0,1
105,1788,10261,38,0,0,0,0,0,0
106,1789,8650,55,11,4,7,1,1,0
107,1789,8654,45,3,2,1,0,0,0
108,1790,8472,51,6,2,4,3,0,3
109,1790,8559,49,4,1,3,2,0,2
110,1791,8668,53,5,3,2,1,1,0
111,1791,8586,47,6,1,5,1,0,1
112,1792,9879,44,2,1,1,1,0,1
113,1792,10252,56,6,0,6,2,0,2
114,1793,8549,46,7,1,6,1,0,1
115,1793,10261,54,6,2,4,0,0,0
116,1794,10260,54,8,4,4,1,1,0
117,1794,8456,46,1,0,1,0,0,0
118,1795,8462,57,2,1,1,2,0,2
119,1795,8655,43,2,2,0,0,0,0
120,1796,10194,54,8,4,4,2,2,0
121,1796,8667,46,5,0,5,2,0,2
122,1797,8528,41,7,3,4,3,0,3
123,1797,8659,59,9,2,7,1,0,1
124,1799,10260,75,10,5,5,2,2,0
125,1799,8472,25,1,0,1,0,0,0
126,1800,8528,51,7,3,4,2,0,2
127,1800,9825,49,3,1,2,1,0,1
128,1801,8586,42,9,3,6,1,1,0
129,1801,8654,58,5,1,4,3,3,0
130,1803,10261,60,4,3,1,4,3,1
131,1803,10194,40,4,0,4,0,0,0
132,1804,8655,34,2,2,0,1,0,1
133,1804,8650,66,5,0,5,0,0,0
134,1806,8559,47,8,3,5,3,2,1
135,1806,8455,53,4,2,2,3,1,2
136,1808,8549,51,6,3,3,3,0,3
137,1808,8667,49,6,3,3,0,0,0
138,1809,8650,57,12,7,5,3,2,1
139,1809,8667,43,3,2,1,0,0,0
140,1810,8472,52,7,5,2,1,1,0
141,1810,8659,48,13,7,6,1,1,0
142,1811,8586,32,5,3,2,1,0,1
143,1811,10260,68,10,5,5,0,0,0
144,1812,10252,53,4,1,3,1,0,1
145,1812,8559,47,1,0,1,0,0,0
146,1815,8462,45,7,3,4,2,1,1
147,1815,10261,55,2,1,1,1,1,0
148,1816,9879,59,7,2,5,3,3,0
149,1816,10194,41,0,0,0,0,0,0
150,1817,8528,60,1,1,0,3,1,2
151,1817,8655,40,4,3,1,0,0,0
152,1820,8650,41,7,4,3,2,2,0
153,1820,9825,59,3,1,2,1,1,0
154,1821,8654,52,12,6,6,3,1,2
155,1821,10252,48,6,4,2,0,0,0
156,1822,8455,66,7,5,2,1,0,1
157,1822,8668,34,9,5,4,0,0,0
158,1823,8586,47,6,4,2,2,1,1
159,1823,10261,53,3,3,0,2,0,2
160,1824,10194,56,4,1,3,2,1,1
161,1824,8655,44,6,1,5,0,0,0
162,1825,8549,45,6,4,2,5,4,1
163,1825,9879,55,10,7,3,1,0,1
164,1826,8559,48,8,5,3,2,2,0
165,1826,8462,52,7,6,1,4,1,3
166,1829,8650,70,9,5,4,1,0,1
167,1829,8559,30,1,1,0,0,0,0
168,1830,8655,57,3,1,2,2,1,1
169,1830,8472,43,9,0,9,1,0,1
170,1831,9879,57,7,5,2,2,2,0
171,1831,8586,43,9,3,6,0,0,0
172,1832,10252,56,7,5,2,2,0,2
173,1832,9825,44,3,0,3,1,0,1
174,1833,8549,43,5,3,2,2,0,2
175,1833,8668,57,4,1,3,1,0,1
176,1834,8667,45,6,3,3,1,0,1
177,1834,8456,55,9,8,1,0,0,0
178,1835,8654,52,6,3,3,3,0,3
179,1835,8462,48,15,4,11,0,0,0
180,1836,10194,44,4,1,3,1,1,0
181,1836,10260,56,8,3,5,0,0,0
182,1837,10261,56,3,2,1,3,0,3
183,1837,8528,44,9,3,6,1,0,1
184,1838,8455,63,14,6,8,1,1,0
185,1838,8659,37,5,1,4,0,0,0
186,1839,8650,57,6,3,3,3,1,2
187,1839,8549,43,4,2,2,2,0,2
188,1840,8472,49,4,3,1,1,1,0
189,1840,8586,51,6,0,6,0,0,0
190,1841,10261,57,6,2,4,1,0,1
191,1841,8559,43,3,1,2,0,0,0
192,1842,8456,56,5,4,1,1,0,1
193,1842,8654,44,0,0,0,0,0,0
194,1844,9825,55,8,2,6,1,1,0
195,1844,9879,45,2,2,0,2,0,2
196,1845,8659,53,7,2,5,3,2,1
197,1845,8668,47,4,2,2,0,0,0
198,1846,10260,59,7,3,4,6,2,4
199,1846,8462,41,4,1,3,2,2,0
200,1847,10194,48,1,1,0,2,1,1
201,1847,10252,52,0,0,0,2,0,2
202,1848,8528,51,9,5,4,1,1,0
203,1848,8455,49,4,1,3,0,0,0
204,1849,10260,45,12,7,5,2,0,2
205,1849,8549,55,2,2,0,0,0,0
206,1850,9825,54,6,2,4,1,0,1
207,1850,8462,46,4,2,2,0,0,0
208,1851,10194,48,4,1,3,3,1,2
209,1851,8654,52,12,5,7,0,0,0
210,1852,8472,38,6,4,2,1,0,1
211,1852,8668,62,3,1,2,0,0,0
212,1853,8650,64,11,9,2,2,2,0
213,1853,10261,36,6,0,6,0,0,0
214,1855,8455,54,17,9,8,1,1,0
215,1855,9879,46,1,1,0,1,0,1
216,1856,8559,47,9,3,6,1,1,0
217,1856,8528,53,6,6,0,2,0,2
218,1857,8659,47,7,3,4,2,0,2
219,1857,8586,53,5,2,3,0,0,0
220,1858,10252,60,3,1,2,1,1,0
221,1858,8667,40,3,1,2,0,0,0
222,1859,8455,45,6,4,2,1,0,1
223,1859,10260,55,6,3,3,0,0,0
224,1860,9825,61,7,1,6,1,1,0
225,1860,8559,39,3,0,3,2,0,2
226,1862,8668,51,2,2,0,1,0,1
227,1862,8667,49,0,0,0,1,0,1
228,1863,8549,51,4,2,2,4,1,3
229,1863,8472,49,4,2,2,1,1,0
230,1865,9879,51,8,5,3,1,0,1
231,1865,8655,49,7,3,4,0,0,0
232,1866,8462,53,6,2,4,3,0,3
233,1866,8456,47,8,4,4,0,0,0
234,1867,8650,59,5,2,3,1,0,1
235,1867,10194,41,0,0,0,0,0,0
236,1868,8586,48,4,2,2,3,1,2
237,1868,8528,52,5,4,1,1,0,1
238,1870,10252,60,2,1,1,1,0,1
239,1870,8472,40,4,2,2,2,0,2
240,1871,8586,56,15,10,5,3,3,0
241,1871,8462,44,4,4,0,1,0,1
242,1872,8654,54,6,4,2,3,2,1
243,1872,9879,46,5,1,4,0,0,0
244,1873,8456,51,2,2,0,6,2,4
245,1873,8528,49,8,1,7,0,0,0
246,1874,10261,53,3,3,0,1,1,0
247,1874,8655,47,3,1,2,1,0,1
248,1875,10260,54,13,6,7,1,0,1
249,1875,8559,46,3,3,0,1,0,1
250,1877,8667,43,4,3,1,2,1,1
251,1877,9825,57,5,2,3,1,0,1
252,1878,8455,53,19,10,9,2,2,0
253,1878,10194,47,1,1,0,3,0,3
254,1880,8586,59,11,6,5,2,0,2
255,1880,10194,41,1,0,1,0,0,0
256,1881,8667,31,12,7,5,1,1,0
257,1881,8654,69,10,4,6,0,0,0
258,1882,10260,57,6,4,2,2,0,2
259,1882,8659,43,4,3,1,0,0,0
260,1884,8528,44,2,2,0,1,1,0
261,1884,8650,56,3,1,2,2,0,2
262,1885,9825,49,4,2,2,3,1,2
263,1885,8668,51,4,2,2,2,0,2
264,1886,8456,66,4,2,2,2,1,1
265,1886,10261,34,0,0,0,2,0,2
266,1887,8655,44,11,3,8,1,1,0
267,1887,8559,56,1,1,0,0,0,0
268,1888,8455,63,12,6,6,1,1,0
269,1888,8549,37,6,3,3,0,0,0
270,1889,10260,53,11,6,5,2,1,1
271,1889,8668,47,5,1,4,0,0,0
272,1890,9825,63,9,3,6,3,1,2
273,1890,8654,37,2,1,1,0,0,0
274,1891,8455,54,4,3,1,1,1,0
275,1891,8650,46,14,5,9,3,2,1
276,1893,8655,48,12,3,9,3,3,0
277,1893,8549,52,6,2,4,2,1,1
278,1894,8472,55,10,8,2,2,0,2
279,1894,10261,45,14,6,8,4,0,4
280,1896,8586,56,8,3,5,3,2,1
281,1896,8559,44,5,3,2,1,1,0
282,1897,8667,63,10,5,5,2,0,2
283,1897,8659,37,4,0,4,1,0,1
284,1898,8456,51,6,1,5,1,1,0
285,1898,10194,49,3,2,1,0,0,0
286,1900,8586,56,7,5,2,1,1,0
287,1900,9825,44,1,0,1,0,0,0
288,1901,8654,41,5,3,2,2,0,2
289,1901,10260,59,8,5,3,1,0,1
290,1902,8668,66,8,4,4,2,2,0
291,1902,8559,34,5,0,5,1,0,1
292,1904,8655,51,11,5,6,2,1,1
293,1904,10252,49,5,2,3,1,1,0
294,1905,10261,52,6,4,2,1,0,1
295,1905,8659,48,4,1,3,3,0,3
296,1906,8462,47,4,3,1,4,2,2
297,1906,8650,53,4,1,3,0,0,0
298,1907,9879,48,3,3,0,1,1,0
299,1907,8528,52,4,1,3,1,0,1
300,1909,8655,42,6,1,5,1,0,1
301,1909,10260,58,5,2,3,0,0,0
302,1910,9825,65,8,5,3,3,2,1
303,1910,8472,35,2,2,0,0,0,0
304,1911,8650,54,7,3,4,1,1,0
305,1911,8456,46,4,1,3,2,0,2
306,1912,8455,62,9,5,4,1,0,1
307,1912,10252,38,6,2,4,0,0,0
308,1913,8528,46,8,6,2,2,2,0
309,1913,8549,54,3,1,2,1,0,1
310,1914,8668,48,7,3,4,2,1,1
311,1914,10261,52,1,0,1,1,0,1
312,1915,9879,53,10,3,7,3,3,0
313,1915,8659,47,7,3,4,1,1,0
314,1916,8559,55,6,3,3,1,0,1
315,1916,8654,45,9,3,6,0,0,0
316,1917,8586,48,6,1,5,2,1,1
317,1917,8667,52,3,1,2,1,0,1
318,1918,8462,49,3,1,2,1,1,0
319,1918,10194,51,2,2,0,0,0,0
320,1919,10260,54,12,7,5,2,0,2
321,1919,8462,46,2,0,2,0,0,0
322,1920,9879,51,4,2,2,1,1,0
323,1920,9825,49,6,3,3,2,1,1
324,1921,8586,52,8,5,3,2,1,1
325,1921,8472,48,4,0,4,0,0,0
326,1922,8456,55,5,2,3,1,0,1
327,1922,8654,45,10,6,4,0,0,0
328,1924,8659,39,10,4,6,1,1,0
329,1924,8668,61,6,4,2,4,2,2
330,1925,8650,57,9,6,3,1,1,0
331,1925,8549,43,3,2,1,3,0,3
332,1926,8559,49,5,3,2,2,1,1
333,1926,10261,51,12,4,8,1,0,1
334,1927,8655,59,5,3,2,3,2,1
335,1927,8667,41,4,2,2,1,0,1
336,1928,8528,51,6,5,1,1,1,0
337,1928,8455,49,12,8,4,1,0,1
338,1930,8659,35,6,2,4,2,2,0
339,1930,9825,65,4,0,4,3,1,2
340,1931,8462,48,6,3,3,1,1,0
341,1931,8455,52,10,7,3,1,1,0
342,1932,8559,44,9,4,5,2,2,0
343,1932,10194,56,3,0,3,0,0,0
344,1933,8528,43,8,2,6,5,4,1
345,1933,8654,57,2,0,2,0,0,0
346,1934,8472,45,2,2,0,3,2,1
347,1934,8650,55,11,7,4,0,0,0
348,1935,10261,51,5,3,2,3,1,2
349,1935,10260,49,7,4,3,0,0,0
350,1936,8456,56,6,2,4,3,1,2
351,1936,10252,44,5,0,5,4,3,1
352,1938,9879,54,10,3,7,3,2,1
353,1938,8667,46,2,1,1,1,0,1
354,1939,10260,64,8,3,5,2,0,2
355,1939,8650,36,3,1,2,0,0,0
356,1940,9825,54,9,2,7,1,1,0
357,1940,8655,46,4,2,2,4,1,3
358,1942,8659,44,3,2,1,5,3,2
359,1942,8654,56,4,4,0,0,0,0
360,1943,8586,45,9,5,4,1,0,1
361,1943,10252,55,5,3,2,0,0,0
362,1944,8668,55,9,4,5,2,1,1
363,1944,10194,45,2,1,1,0,0,0
364,1945,8462,53,3,3,0,1,1,0
365,1945,8549,47,8,1,7,1,0,1
366,1946,8559,48,5,3,2,2,1,1
367,1946,9879,52,4,2,2,0,0,0
368,1947,10261,49,4,1,3,1,1,0
369,1947,8667,51,1,0,1,2,0,2
370,1948,8456,44,3,1,2,1,1,0
371,1948,8455,56,5,1,4,2,1,1
372,1949,10260,53,8,5,3,1,0,1
373,1949,9879,47,1,1,0,0,0,0
374,1950,9825,59,12,6,6,3,1,2
375,1950,10261,41,1,0,1,2,1,1
376,1951,8456,46,6,3,3,2,1,1
377,1951,8472,54,4,3,1,0,0,0
378,1952,8655,38,7,3,4,2,1,1
379,1952,8654,62,4,1,3,0,0,0
380,1953,8650,52,5,1,4,4,1,3
381,1953,10252,48,2,1,1,0,0,0
382,1954,8462,41,2,2,0,2,0,2
383,1954,8668,59,7,2,5,0,0,0
384,1956,8559,36,10,3,7,1,1,0
385,1956,8659,64,7,4,3,2,0,2
386,1957,8528,57,1,1,0,1,0,1
387,1957,8667,43,4,1,3,0,0,0
388,1959,8650,57,4,2,2,4,2,2
389,1959,10252,43,4,3,1,1,1,0
390,1960,8455,58,11,3,8,2,1,1
391,1960,8586,42,6,5,1,0,0,0
392,1962,8456,54,10,3,7,2,1,1
393,1962,8472,46,4,2,2,1,0,1
394,1963,8655,49,12,6,6,1,0,1
395,1963,8654,51,1,1,0,0,0,0
396,1964,9879,62,11,9,2,3,2,1
397,1964,10260,38,13,1,12,3,1,2
398,1965,8659,53,2,1,1,3,2,1
399,1965,8559,47,9,5,4,1,1,0
400,1966,8462,48,9,4,5,1,1,0
401,1966,8668,52,3,0,3,3,0,3
402,1967,10194,53,2,1,1,2,1,1
403,1967,8549,47,6,3,3,2,0,2
404,1969,10260,58,6,3,3,1,1,0
405,1969,10252,42,4,4,0,1,0,1
406,1970,8456,43,4,2,2,1,1,0
407,1970,9825,57,7,2,5,4,0,4
408,1971,8472,52,8,3,5,4,1,3
409,1971,8654,48,7,1,6,3,0,3
410,1972,8668,62,7,3,4,6,1,5
411,1972,8528,38,10,2,8,4,0,4
412,1973,8455,52,10,2,8,2,1,1
413,1973,10261,48,6,2,4,0,0,0
414,1974,8586,53,4,3,1,1,1,0
415,1974,8655,47,5,0,5,0,0,0
416,1975,8650,52,9,5,4,1,1,0
417,1975,9879,48,2,0,2,1,0,1
418,1976,8559,41,7,4,3,4,2,2
419,1976,8549,59,4,2,2,2,1,1
420,1977,10194,37,5,5,0,1,0,1
421,1977,8659,63,12,2,10,0,0,0
422,1978,8462,39,1,1,0,1,0,1
423,1978,8667,61,1,0,1,0,0,0
424,1980,8472,40,7,7,0,1,1,0
425,1980,10260,60,4,2,2,2,0,2
426,1981,8586,64,9,3,6,2,2,0
427,1981,8654,36,5,2,3,5,0,5
428,1982,10252,47,6,3,3,2,1,1
429,1982,8668,53,3,3,0,0,0,0
430,1983,8549,53,9,4,5,2,1,1
431,1983,8667,47,4,1,3,1,0,1
432,1984,9879,47,9,3,6,1,1,0
433,1984,8456,53,6,0,6,0,0,0
434,1985,8659,48,4,3,1,1,1,0
435,1985,8462,52,2,0,2,1,0,1
436,1986,10194,54,9,4,5,3,1,2
437,1986,10261,46,5,2,3,0,0,0
438,1987,8528,51,3,1,2,3,1,2
439,1987,9825,49,1,0,1,1,0,1
440,1988,8559,35,4,3,1,3,2,1
441,1988,8455,65,10,6,4,0,0,0
442,1989,8650,54,13,8,5,2,0,2
443,1989,9825,46,0,0,0,0,0,0
444,1990,8472,51,5,2,3,2,1,1
445,1990,8667,49,2,2,0,0,0,0
446,1991,8586,53,18,8,10,1,1,0
447,1991,10261,47,5,3,2,0,0,0
448,1992,8654,48,9,4,5,2,1,1
449,1992,10252,52,7,6,1,0,0,0
450,1993,8549,48,18,10,8,3,3,0
451,1993,9879,52,6,1,5,2,0,2
452,1994,8456,56,9,3,6,3,2,1
453,1994,8659,44,12,3,9,0,0,0
454,1995,8462,48,13,9,4,1,1,0
455,1995,8559,52,1,1,0,2,2,0
456,1996,8655,54,4,2,2,1,1,0
457,1996,10194,46,2,0,2,0,0,0
458,1997,8528,49,6,4,2,4,3,1
459,1997,10260,51,6,2,4,1,1,0
460,1998,8668,51,6,3,3,2,2,0
461,1998,8455,49,10,3,7,0,0,0
462,1999,8586,58,2,1,1,3,2,1
463,1999,10260,42,12,8,4,2,0,2
464,2000,9825,56,11,3,8,4,3,1
465,2000,8549,44,6,2,4,0,0,0
466,2002,8456,51,7,2,5,4,2,2
467,2002,8668,49,5,1,4,0,0,0
468,2003,10261,54,7,4,3,3,1,2
469,2003,8462,46,6,2,4,1,0,1
470,2005,9879,59,5,1,4,3,1,2
471,2005,10194,41,4,0,4,1,1,0
472,2006,8559,44,5,3,2,4,1,3
473,2006,10252,56,6,5,1,1,1,0
474,2007,8472,46,4,4,0,2,1,1
475,2007,8659,54,6,3,3,1,0,1
476,2008,8650,53,7,5,2,3,2,1
477,2008,8667,47,2,0,2,1,0,1
478,2009,10261,42,4,3,1,1,1,0
479,2009,8650,58,11,6,5,3,1,2
480,2010,8668,48,6,4,2,1,1,0
481,2010,8472,52,6,1,5,1,0,1
482,2011,8586,52,13,9,4,1,1,0
483,2011,8659,48,7,4,3,1,0,1
484,2012,8667,39,5,2,3,1,1,0
485,2012,10252,61,6,3,3,1,0,1
486,2013,8549,48,8,7,1,2,1,1
487,2013,10260,52,3,0,3,1,0,1
488,2014,8655,44,8,2,6,3,0,3
489,2014,8456,56,6,4,2,2,0,2
490,2015,8462,42,5,1,4,2,0,2
491,2015,9825,58,6,2,4,0,0,0
492,2016,10194,44,5,2,3,2,1,1
493,2016,8654,56,2,2,0,0,0,0
494,2017,8528,53,13,9,4,2,2,0
495,2017,8559,47,2,0,2,3,3,0
496,2018,9879,40,2,2,0,2,1,1
497,2018,8455,60,4,2,2,2,0,2
498,2019,10260,68,6,3,3,3,0,3
499,2019,8456,32,5,2,3,2,0,2
500,2020,9825,56,9,2,7,2,1,1
501,2020,8455,44,5,4,1,1,0,1
502,2021,8650,57,7,2,5,1,1,0
503,2021,8654,43,2,1,1,0,0,0
504,2022,8668,38,6,3,3,2,1,1
505,2022,8586,62,0,0,0,0,0,0
506,2023,8549,44,4,3,1,1,1,0
507,2023,10261,56,7,3,4,0,0,0
508,2024,8655,48,4,2,2,2,1,1
509,2024,8462,52,4,1,3,1,0,1
510,2025,10252,44,5,3,2,1,1,0
511,2025,9879,56,8,5,3,3,1,2
512,2026,8472,53,2,2,0,2,2,0
513,2026,8559,47,2,0,2,1,0,1
514,2027,8528,55,6,5,1,3,2,1
515,2027,8659,45,6,3,3,2,2,0
516,2028,8667,58,4,2,2,2,1,1
517,2028,10194,42,0,0,0,0,0,0
518,2030,8586,43,9,8,1,1,0,1
519,2030,8456,57,4,1,3,2,0,2
520,2031,8668,59,6,2,4,3,2,1
521,2031,8654,41,6,1,5,1,0,1
522,2032,8549,57,6,5,1,1,0,1
523,2032,10252,43,6,2,4,0,0,0
524,2033,10261,49,4,1,3,1,1,0
525,2033,9879,51,4,2,2,3,2,1
526,2034,8667,59,9,5,4,2,2,0
527,2034,8559,41,8,5,3,1,1,0
528,2035,8659,41,7,3,4,1,1,0
529,2035,8650,59,7,3,4,3,0,3
530,2036,8462,47,2,2,0,1,1,0
531,2036,8472,53,8,2,6,1,0,1
532,2037,8528,44,3,2,1,2,0,2
533,2037,10194,56,6,4,2,0,0,0
534,2038,8655,39,5,4,1,1,1,0
535,2038,8455,61,11,6,5,3,0,3
536,2039,9825,67,9,7,2,1,1,0
537,2039,10194,33,1,1,0,2,2,0
538,2040,8586,48,3,2,1,3,0,3
539,2040,8650,52,2,0,2,0,0,0
540,2041,8455,65,6,3,3,2,2,0
541,2041,8472,35,4,0,4,1,0,1
542,2042,8654,46,7,2,5,2,1,1
543,2042,8549,54,4,1,3,0,0,0
544,2043,10261,45,3,3,0,2,1,1
545,2043,10252,55,7,5,2,0,0,0
546,2045,8659,52,6,4,2,2,2,0
547,2045,8655,48,4,4,0,1,1,0
548,2046,8668,52,12,6,6,1,1,0
549,2046,9879,48,8,2,6,0,0,0
550,2047,10260,48,4,2,2,3,2,1
551,2047,8667,52,9,4,5,1,0,1
552,2050,8586,45,14,5,9,2,2,0
553,2050,10252,55,9,5,4,2,1,1
554,2052,8455,47,5,2,3,2,2,0
555,2052,8456,53,3,1,2,3,0,3
556,2054,9879,59,11,5,6,2,1,1
557,2054,8559,41,5,1,4,0,0,0
558,2055,8654,58,12,8,4,1,0,1
559,2055,8659,42,5,2,3,0,0,0
560,2058,8472,48,3,2,1,2,1,1
561,2058,8528,52,9,3,6,1,0,1
562,2059,8650,64,13,6,7,1,0,1
563,2059,10194,36,2,0,2,0,0,0
564,2060,8549,48,12,4,8,2,2,0
565,2060,8472,52,11,5,6,0,0,0
566,2061,8586,45,7,3,4,5,1,4
567,2061,8528,55,5,2,3,0,0,0
568,2062,8654,57,4,3,1,1,1,0
569,2062,10261,43,9,3,6,3,0,3
570,2064,9879,52,5,2,3,2,2,0
571,2064,8655,48,2,2,0,3,1,2
572,2065,8559,40,7,3,4,5,1,4
573,2065,9825,60,5,0,5,0,0,0
574,2066,8659,55,7,3,4,3,1,2
575,2066,10252,45,4,2,2,1,1,0
576,2067,8667,48,4,3,1,1,0,1
577,2067,8668,52,7,3,4,0,0,0
578,2068,10260,47,8,4,4,2,0,2
579,2068,8455,53,16,7,9,0,0,0
580,2069,8559,19,5,3,2,3,1,2
581,2069,10260,81,19,12,7,1,1,0
582,2070,9825,53,12,4,8,2,1,1
583,2070,8667,47,3,0,3,1,1,0
584,2071,8472,44,2,2,0,1,0,1
585,2071,10252,56,7,6,1,1,0,1
586,2072,8650,49,8,2,6,1,1,0
587,2072,8668,51,2,1,1,1,0,1
588,2074,8655,47,6,5,1,3,1,2
589,2074,10261,53,1,0,1,0,0,0
590,2076,8586,55,7,2,5,1,0,1
591,2076,8462,45,5,3,2,1,0,1
592,2077,8455,55,13,6,7,3,0,3
593,2077,10194,45,6,1,5,0,0,0
594,2078,8456,49,8,2,6,2,1,1
595,2078,8528,51,4,1,3,1,0,1
596,2080,8586,61,15,8,7,1,1,0
597,2080,8667,39,4,3,1,0,0,0
598,2081,8654,55,5,2,3,1,1,0
599,2081,8559,45,6,3,3,0,0,0
600,2082,8668,54,3,1,2,2,1,1
601,2082,10261,46,9,4,5,1,0,1
602,2083,8650,55,6,3,3,2,1,1
603,2083,8456,45,2,2,0,0,0,0
604,2084,8655,39,4,2,2,2,1,1
605,2084,10260,61,8,6,2,0,0,0
606,2085,8659,43,6,1,5,2,1,1
607,2085,9879,57,5,4,1,0,0,0
608,2086,10194,45,3,3,0,1,1,0
609,2086,8462,55,11,3,8,0,0,0
610,2087,8528,55,11,3,8,1,1,0
611,2087,8549,45,2,1,1,0,0,0
612,2088,8455,49,15,9,6,1,1,0
613,2088,10252,51,2,2,0,1,1,0
614,2089,10260,77,10,6,4,1,1,0
615,2089,8659,23,2,1,1,3,1,2
616,2090,9825,53,11,4,7,1,1,0
617,2090,8668,47,4,3,1,4,0,4
618,2091,8650,51,8,4,4,3,2,1
619,2091,8528,49,3,2,1,2,1,1
620,2092,8462,44,3,3,0,2,1,1
621,2092,10252,56,6,1,5,1,0,1
622,2093,8455,60,8,4,4,2,2,0
623,2093,8549,40,4,1,3,2,0,2
624,2094,8456,65,10,4,6,1,0,1
625,2094,10261,35,2,1,1,1,0,1
626,2095,8472,41,7,3,4,3,1,2
627,2095,9879,59,10,5,5,2,0,2
628,2096,8559,47,5,2,3,4,2,2
629,2096,8655,53,1,0,1,0,0,0
630,2097,8667,52,3,2,1,3,1,2
631,2097,8654,48,7,5,2,1,0,1
632,2098,10194,43,3,1,2,3,1,2
633,2098,8586,57,5,5,0,1,1,0
634,2099,10261,51,6,5,1,1,1,0
635,2099,8472,49,3,2,1,1,0,1
636,2101,9825,66,10,3,7,2,1,1
637,2101,8654,34,6,2,4,0,0,0
638,2102,8668,41,10,6,4,5,2,3
639,2102,10260,59,10,8,2,0,0,0
640,2103,8456,54,8,1,7,1,0,1
641,2103,10194,46,6,3,3,0,0,0
642,2104,8655,53,2,2,0,3,2,1
643,2104,8549,47,1,0,1,0,0,0
644,2105,8667,52,6,3,3,2,2,0
645,2105,8659,48,14,6,8,2,0,2
646,2106,8462,53,11,7,4,2,2,0
647,2106,9879,47,5,2,3,2,1,1
648,2108,8455,55,6,5,1,1,1,0
649,2108,8650,45,2,1,1,1,1,0
650,2109,10260,53,18,11,7,3,2,1
651,2109,8658,47,3,1,2,2,1,1
652,2110,8586,57,9,3,6,2,1,1
653,2110,8650,43,3,0,3,1,0,1
654,2111,10252,46,4,4,0,2,1,1
655,2111,8528,54,8,4,4,1,0,1
656,2113,8654,60,9,6,3,3,2,1
657,2113,8602,40,10,2,8,4,2,2
658,2114,8655,48,8,7,1,2,1,1
659,2114,8456,52,3,1,2,2,2,0
660,2115,8559,43,4,3,1,1,0,1
661,2115,8472,57,9,5,4,0,0,0
662,2116,9879,54,3,2,1,1,0,1
663,2116,8462,46,4,3,1,0,0,0
664,2117,8191,49,10,4,6,1,1,0
665,2117,10194,51,4,2,2,1,0,1
666,2119,8528,48,5,5,0,4,3,1
667,2119,8191,52,8,3,5,0,0,0
668,2120,8455,58,14,8,6,3,2,1
669,2120,8655,42,4,2,2,3,3,0
670,2121,8668,55,9,7,2,2,0,2
671,2121,8559,45,4,0,4,2,0,2
672,2122,8472,42,6,3,3,3,1,2
673,2122,8658,58,11,5,6,1,0,1
674,2124,8654,46,6,3,3,1,1,0
675,2124,9825,54,6,4,2,1,0,1
676,2125,10252,45,6,2,4,4,1,3
677,2125,8602,55,4,4,0,1,1,0
678,2126,8667,52,2,1,1,5,3,2
679,2126,8462,48,3,0,3,3,0,3
680,2128,8456,48,8,4,4,1,1,0
681,2128,9879,52,2,1,1,1,0,1
682,2129,8462,52,8,3,5,1,1,0
683,2129,8528,48,4,1,3,1,0,1
684,2130,8655,35,2,1,1,3,3,0
685,2130,10260,65,9,5,4,1,0,1
686,2131,8650,62,4,3,1,1,1,0
687,2131,9879,38,2,0,2,1,0,1
688,2132,8668,46,3,3,0,2,1,1
689,2132,10252,54,6,3,3,1,1,0
690,2133,8667,41,4,1,3,1,0,1
691,2133,8191,59,4,2,2,0,0,0
692,2134,8455,53,15,8,7,3,1,2
693,2134,8559,47,6,4,2,0,0,0
694,2135,8658,40,5,4,1,4,1,3
695,2135,8456,60,8,4,4,0,0,0
696,2136,9825,59,8,5,3,2,1,1
697,2136,8586,41,6,1,5,3,0,3
698,2137,8602,42,5,3,2,2,1,1
699,2137,10194,58,4,4,0,1,0,1
700,2138,8654,54,6,4,2,3,2,1
701,2138,8472,46,5,1,4,1,0,1
702,2139,8528,55,13,5,8,1,1,0
703,2139,9879,45,6,1,5,0,0,0
704,2141,8602,51,3,1,2,3,0,3
705,2141,9825,49,8,4,4,2,0,2
706,2142,8654,52,8,3,5,3,2,1
707,2142,8668,48,4,1,3,0,0,0
708,2143,8586,53,4,1,3,3,1,2
709,2143,8472,47,8,3,5,2,1,1
710,2144,8456,41,7,3,4,1,1,0
711,2144,8191,59,1,1,0,0,0,0
712,2145,8650,54,15,9,6,2,1,1
713,2145,8658,46,0,0,0,1,0,1
714,2148,8455,56,6,4,2,1,1,0
715,2148,10260,44,8,2,6,0,0,0
716,2150,9825,54,5,4,1,4,3,1
717,2150,8472,46,1,1,0,2,1,1
718,2151,8462,54,10,2,8,1,0,1
719,2151,10194,46,3,1,2,1,0,1
720,2153,8602,31,4,3,1,1,0,1
721,2153,8455,69,12,5,7,0,0,0
722,2154,8654,46,8,4,4,3,1,2
723,2154,8667,54,6,5,1,0,0,0
724,2155,8650,52,7,4,3,2,1,1
725,2155,8456,48,3,0,3,0,0,0
726,2156,10260,70,7,5,2,4,4,0
727,2156,8668,30,6,1,5,2,0,2
728,2158,8655,58,8,3,5,3,2,1
729,2158,8559,42,7,3,4,0,0,0
730,2159,10260,43,4,2,2,4,3,1
731,2159,8462,57,11,6,5,1,0,1
732,2160,8191,44,9,3,6,1,1,0
733,2160,8654,56,3,1,2,2,1,1
734,2162,8456,72,6,2,4,3,0,3
735,2162,8667,28,2,1,1,1,0,1
736,2163,9879,49,10,3,7,3,2,1
737,2163,8559,51,2,2,0,1,0,1
738,2164,8650,45,8,5,3,2,1,1
739,2164,8668,55,7,3,4,1,0,1
740,2165,8655,53,5,2,3,2,1,1
741,2165,10194,47,5,4,1,1,0,1
742,2166,8586,40,18,9,9,3,1,2
743,2166,10252,60,2,1,1,1,0,1
744,2167,9825,57,9,6,3,2,1,1
745,2167,8455,43,4,3,1,0,0,0
746,2168,8528,47,8,3,5,1,1,0
747,2168,8472,53,0,0,0,3,0,3
748,2169,8462,51,2,2,0,2,1,1
749,2169,8191,49,7,3,4,0,0,0
750,2170,10260,57,3,2,1,4,3,1
751,2170,8654,43,6,1,5,3,2,1
752,2171,8658,47,10,5,5,3,1,2
753,2171,8528,53,7,5,2,0,0,0
754,2172,8559,48,8,4,4,1,1,0
755,2172,8602,52,7,5,2,1,1,0
756,2173,8455,45,6,3,3,1,1,0
757,2173,8456,55,8,5,3,1,0,1
758,2174,8472,45,5,2,3,1,1,0
759,2174,9879,55,3,2,1,1,0,1
760,2175,8586,47,8,5,3,2,1,1
761,2175,8668,53,5,4,1,0,0,0
762,2176,8650,52,11,3,8,1,1,0
763,2176,8655,48,3,2,1,1,0,1
764,2178,9825,63,7,3,4,2,2,0
765,2178,10194,37,4,1,3,0,0,0
766,2180,8528,54,7,5,2,2,1,1
767,2180,10194,46,6,3,3,2,0,2
768,2182,8586,60,17,6,11,1,1,0
769,2182,8602,40,1,0,1,0,0,0
770,2183,8650,51,4,4,0,3,0,3
771,2183,9825,49,4,1,3,0,0,0
772,2184,8667,45,8,5,3,2,2,0
773,2184,8655,55,9,2,7,4,1,3
774,2185,8668,49,6,4,2,1,1,0
775,2185,8455,51,11,4,7,3,0,3
776,2186,9879,58,4,3,1,3,1,2
777,2186,8191,42,8,5,3,0,0,0
778,2188,8658,56,10,8,2,5,3,2
779,2188,8654,44,8,2,6,1,1,0
780,2189,8456,40,4,1,3,1,1,0
781,2189,8586,60,3,2,1,1,1,0
782,2190,8472,52,7,3,4,1,1,0
783,2190,10252,48,2,1,1,0,0,0
784,2191,10194,53,5,3,2,4,2,2
785,2191,9879,47,4,1,3,0,0,0
786,2192,10260,64,11,4,7,2,1,1
787,2192,8602,36,1,0,1,0,0,0
788,2193,8667,64,4,2,2,3,1,2
789,2193,8668,36,3,1,2,0,0,0
790,2194,9825,49,10,4,6,2,1,1
791,2194,8191,51,3,1,2,0,0,0
792,2195,8654,53,8,3,5,1,0,1
793,2195,8559,47,6,2,4,0,0,0
794,2196,8658,51,5,2,3,2,1,1
795,2196,8655,49,6,1,5,3,1,2
796,2197,8650,54,8,2,6,2,0,2
797,2197,8528,46,7,4,3,0,0,0
798,2198,8455,60,10,6,4,2,1,1
799,2198,8462,40,2,1,1,1,0,1
800,2199,9825,60,7,5,2,2,0,2
801,2199,8667,40,3,0,3,2,0,2
802,2200,8191,45,6,1,5,1,0,1
803,2200,8602,55,9,4,5,0,0,0
804,2202,8455,55,6,4,2,5,3,2
805,2202,8654,45,3,1,2,0,0,0
806,2203,8462,47,4,1,3,2,1,1
807,2203,8650,53,2,0,2,2,2,0
808,2204,8456,48,3,1,2,3,1,2
809,2204,8472,52,4,2,2,1,0,1
810,2205,10260,53,5,4,1,4,2,2
811,2205,9879,47,6,3,3,1,0,1
812,2206,8668,53,8,5,3,3,1,2
813,2206,8658,47,3,1,2,0,0,0
814,2208,10252,65,7,5,2,1,1,0
815,2208,10194,35,7,0,7,1,1,0
816,2209,8528,55,3,1,2,1,0,1
817,2209,8655,45,2,0,2,0,0,0
818,2210,8462,49,7,3,4,1,1,0
819,2210,8654,51,7,2,5,1,0,1
820,2211,8668,62,4,2,2,5,1,4
821,2211,8472,38,4,1,3,0,0,0
822,2212,8456,57,4,1,3,2,1,1
823,2212,10194,43,4,2,2,0,0,0
824,2214,10260,56,9,6,3,3,2,1
825,2214,8667,44,5,4,1,1,0,1
826,2215,9879,52,6,3,3,2,2,0
827,2215,8586,48,3,1,2,1,0,1
828,2217,8455,61,16,10,6,1,0,1
829,2217,8658,39,7,1,6,1,0,1
830,2218,9825,63,8,4,4,3,1,2
831,2218,10252,37,3,2,1,0,0,0
832,2219,9825,53,10,6,4,3,0,3
833,2219,8559,47,4,2,2,0,0,0
834,2220,8455,60,8,5,3,2,2,0
835,2220,8472,40,2,1,1,0,0,0
836,2222,8655,53,3,3,0,7,4,3
837,2222,9879,47,0,0,0,2,0,2
838,2224,8586,56,7,2,5,1,1,0
839,2224,8667,44,6,2,4,2,1,1
840,2225,10260,59,10,3,7,2,1,1
841,2225,8191,41,2,1,1,0,0,0
842,2226,8602,46,3,2,1,1,0,1
843,2226,8528,54,6,4,2,0,0,0
844,2227,8650,54,11,5,6,2,1,1
845,2227,10194,46,3,1,2,0,0,0
846,2228,8456,52,10,5,5,1,0,1
847,2228,8668,48,4,1,3,1,0,1
848,2229,8456,51,4,1,3,4,1,3
849,2229,8602,49,4,2,2,0,0,0
850,2230,8586,60,9,4,5,2,2,0
851,2230,8654,40,2,1,1,0,0,0
852,2231,10194,56,8,5,3,3,2,1
853,2231,8658,44,7,1,6,0,0,0
854,2232,8462,46,5,3,2,2,1,1
855,2232,9825,54,6,3,3,1,0,1
856,2233,8668,58,11,4,7,1,0,1
857,2233,8191,42,9,4,5,0,0,0
858,2234,8455,55,11,6,5,2,2,0
859,2234,9879,45,3,1,2,0,0,0
860,2236,8472,45,8,4,4,1,1,0
861,2236,8655,55,7,1,6,1,0,1
862,2237,10252,53,5,3,2,3,1,2
863,2237,8650,47,8,5,3,1,0,1
864,2238,10260,65,9,6,3,2,1,1
865,2238,8528,35,5,1,4,1,0,1
866,2239,8528,45,6,4,2,3,2,1
867,2239,10252,55,9,5,4,1,0,1
868,2240,8654,60,8,4,4,1,0,1
869,2240,8602,40,0,0,0,1,0,1
870,2241,8655,48,2,0,2,3,1,2
871,2241,8456,52,2,0,2,2,1,1
872,2242,8586,46,8,3,5,3,2,1
873,2242,8650,54,5,1,4,0,0,0
874,2243,8455,58,11,4,7,2,1,1
875,2243,8667,42,4,0,4,2,0,2
876,2244,8462,61,9,8,1,2,2,0
877,2244,9879,39,8,4,4,0,0,0
878,2245,8191,49,4,2,2,2,1,1
879,2245,10194,51,3,0,3,1,0,1
880,2246,8559,45,6,2,4,1,0,1
881,2246,8472,55,4,2,2,0,0,0
882,2247,10260,66,13,6,7,1,1,0
883,2247,8658,34,5,1,4,2,0,2
884,2248,8668,55,5,2,3,1,0,1
885,2248,9825,45,5,1,4,0,0,0
886,2249,8462,56,6,4,2,3,2,1
887,2249,8658,44,4,2,2,0,0,0
888,2250,10194,54,3,1,2,2,1,1
889,2250,8650,46,4,3,1,0,0,0
890,2251,8586,52,17,4,13,1,1,0
891,2251,8667,48,2,0,2,1,0,1
892,2252,8528,55,12,7,5,1,1,0
893,2252,8602,45,6,2,4,1,0,1
894,2253,10260,67,10,5,5,1,1,0
895,2253,8191,33,8,1,7,0,0,0
896,2254,8456,49,5,3,2,1,1,0
897,2254,8668,51,5,4,1,3,2,1
898,2255,8472,33,2,2,0,2,1,1
899,2255,8455,67,9,3,6,0,0,0
900,2256,9825,52,3,3,0,3,1,2
901,2256,8559,48,5,2,3,0,0,0
902,2257,9879,49,9,7,2,1,1,0
903,2257,8655,51,3,2,1,2,0,2
904,2258,10252,60,5,2,3,3,1,2
905,2258,8654,40,2,0,2,0,0,0
906,2260,8586,60,5,2,3,3,1,2
907,2260,9879,40,5,2,3,0,0,0
908,2262,8654,54,6,3,3,1,1,0
909,2262,8462,46,8,4,4,3,1,2
910,2263,10260,64,10,8,2,2,1,1
911,2263,8667,36,4,3,1,0,0,0
912,2265,8668,63,4,3,1,3,1,2
913,2265,8472,37,3,0,3,0,0,0
914,2266,8455,62,11,6,5,2,1,1
915,2266,8658,38,2,1,1,0,0,0
916,2267,8528,52,4,3,1,2,1,1
917,2267,8655,48,2,0,2,5,1,4
918,2268,10252,54,1,1,0,2,2,0
919,2268,9825,46,11,5,6,1,0,1
920,2269,8654,51,3,1,2,1,1,0
921,2269,8655,49,3,0,3,3,1,2
922,2270,8668,47,4,3,1,3,1,2
923,2270,8528,53,3,1,2,0,0,0
924,2271,10194,47,3,1,2,2,2,0
925,2271,8472,53,4,3,1,1,1,0
926,2272,8462,44,4,2,2,2,1,1
927,2272,8456,56,5,4,1,0,0,0
928,2273,8559,46,4,3,1,2,1,1
929,2273,8650,54,13,4,9,4,1,3
930,2274,8667,53,3,1,2,1,1,0
931,2274,8602,47,4,2,2,0,0,0
932,2276,8191,49,4,3,1,4,2,2
933,2276,8455,51,5,1,4,1,1,0
934,2277,10260,52,3,2,1,1,1,0
935,2277,9825,48,2,0,2,0,0,0
936,2278,8658,49,7,3,4,2,2,0
937,2278,8586,51,10,6,4,1,0,1
938,2279,8462,38,5,4,1,1,0,1
939,2279,10260,62,7,3,4,0,0,0
940,2280,8655,49,4,3,1,5,1,4
941,2280,10194,51,3,0,3,0,0,0
942,2282,8586,52,13,5,8,5,3,2
943,2282,10252,48,3,2,1,2,1,1
944,2283,8654,46,10,4,6,2,1,1
945,2283,8191,54,1,0,1,1,0,1
946,2284,9825,55,7,5,2,2,2,0
947,2284,8455,45,2,0,2,1,1,0
948,2285,8559,51,11,7,4,3,1,2
949,2285,9879,49,3,1,2,1,0,1
950,2286,8667,59,3,2,1,1,0,1
951,2286,8456,41,7,3,4,0,0,0
952,2287,8650,67,4,2,2,1,0,1
953,2287,8668,33,5,1,4,0,0,0
954,2288,8658,64,9,7,2,4,2,2
955,2288,8602,36,6,3,3,1,1,0
956,2289,9825,49,4,3,1,2,1,1
957,2289,8650,51,6,1,5,2,1,1
958,2290,9879,55,9,5,4,2,1,1
959,2290,8191,45,2,1,1,2,1,1
960,2291,8654,55,7,4,3,1,0,1
961,2291,8658,45,6,5,1,2,0,2
962,2293,8528,48,8,7,1,2,1,1
963,2293,10194,52,7,3,4,0,0,0
964,2294,8472,48,3,2,1,2,1,1
965,2294,8462,52,7,1,6,0,0,0
966,2295,8655,55,8,5,3,1,0,1
967,2295,8667,45,3,1,2,0,0,0
968,2297,8455,49,8,3,5,1,1,0
969,2297,8668,51,4,3,1,1,0,1
970,2298,8456,55,2,2,0,5,0,5
971,2298,8559,45,5,3,2,0,0,0
972,2299,8658,45,7,3,4,3,1,2
973,2299,9879,55,5,2,3,1,0,1
974,2300,8462,56,5,2,3,1,1,0
975,2300,10194,44,3,1,2,1,0,1
976,2301,8654,52,8,4,4,3,0,3
977,2301,8667,48,3,2,1,0,0,0
978,2302,8559,37,8,5,3,4,3,1
979,2302,8655,63,4,1,3,1,0,1
980,2303,8668,51,4,3,1,2,1,1
981,2303,10260,49,2,1,1,1,1,0
982,2304,9825,60,11,4,7,2,2,0
983,2304,8472,40,4,1,3,2,1,1
984,2305,8586,52,9,4,5,4,1,3
985,2305,8528,48,6,3,3,0,0,0
986,2306,8602,38,8,3,5,1,1,0
987,2306,8455,62,1,1,0,2,0,2
988,2307,8456,53,3,0,3,4,1,3
989,2307,8650,47,1,0,1,1,1,0
990,2308,8191,57,5,3,2,1,0,1
991,2308,10252,43,4,1,3,0,0,0
992,2309,8472,52,5,3,2,3,2,1
993,2309,9879,48,1,0,1,1,0,1
994,2310,8586,60,7,1,6,2,1,1
995,2310,8668,40,4,0,4,1,1,0
996,2311,10194,52,4,3,1,3,2,1
997,2311,9825,48,10,2,8,1,1,0
998,2312,8654,37,8,3,5,1,1,0
999,2312,10260,63,8,5,3,1,0,1
1000,2313,8655,40,5,3,2,2,1,1
1001,2313,8650,60,0,0,0,3,1,2
1002,2314,10252,56,4,1,3,2,0,2
1003,2314,8667,44,5,2,3,0,0,0
1004,2315,8455,60,15,5,10,2,2,0
1005,2315,8456,40,4,1,3,1,0,1
1006,2316,8528,44,5,2,3,1,1,0
1007,2316,8658,56,4,2,2,3,2,1
1008,2317,8191,53,6,2,4,2,0,2
1009,2317,8462,47,2,1,1,1,0,1
1010,2319,8650,46,3,2,1,3,2,1
1011,2319,8528,54,5,1,4,0,0,0
1012,2320,8654,47,9,5,4,3,0,3
1013,2320,8559,53,6,5,1,0,0,0
1014,2321,8456,53,9,7,2,2,2,0
1015,2321,8586,47,7,2,5,0,0,0
1016,2322,8455,59,6,3,3,1,1,0
1017,2322,8462,41,3,3,0,3,0,3
1018,2323,8667,46,2,1,1,2,1,1
1019,2323,8668,54,6,1,5,0,0,0
1020,2324,8658,53,2,2,0,7,2,5
1021,2324,8655,47,2,0,2,1,1,0
1022,2325,10252,44,7,3,4,2,2,0
1023,2325,8472,56,3,1,2,0,0,0
1024,2326,8191,34,4,3,1,1,0,1
1025,2326,9825,66,11,2,9,1,0,1
1026,2327,10260,53,4,3,1,2,1,1
1027,2327,8602,47,7,4,3,0,0,0
1028,2328,9879,52,4,2,2,2,1,1
1029,2328,10194,48,2,1,1,1,0,1
1030,2329,9825,60,15,9,6,2,1,1
1031,2329,8462,40,5,1,4,3,1,2
1032,2330,10252,48,3,3,0,6,5,1
1033,2330,8650,52,15,5,10,1,0,1
1034,2331,8655,51,7,4,3,1,1,0
1035,2331,8472,49,4,3,1,0,0,0
1036,2332,8586,45,9,5,4,1,0,1
1037,2332,8654,55,8,4,4,0,0,0
1038,2333,8456,65,11,8,3,1,0,1
1039,2333,8602,35,4,1,3,0,0,0
1040,2334,8455,55,5,2,3,1,1,0
1041,2334,9879,45,1,0,1,0,0,0
1042,2336,8667,38,3,2,1,2,1,1
1043,2336,8559,62,12,4,8,1,0,1
1044,2337,8191,44,5,3,2,5,3,2
1045,2337,8668,56,11,7,4,1,1,0
1046,2338,10260,58,9,6,3,1,1,0
1047,2338,8528,42,7,3,4,4,1,3
1048,2339,8655,44,8,4,4,1,1,0
1049,2339,8586,56,4,2,2,0,0,0
1050,2340,8472,48,8,6,2,3,1,2
1051,2340,8456,52,13,1,12,1,0,1
1052,2341,10252,43,4,2,2,2,1,1
1053,2341,10194,57,5,0,5,3,0,3
1054,2342,9879,36,5,3,2,2,2,0
1055,2342,10260,64,16,8,8,2,1,1
1056,2343,8650,58,8,2,6,2,2,0
1057,2343,8462,42,2,0,2,1,0,1
1058,2344,9825,59,7,4,3,1,1,0
1059,2344,8667,41,2,1,1,2,0,2
1060,2345,8658,49,4,3,1,1,1,0
1061,2345,8668,51,6,3,3,3,2,1
1062,2346,8559,51,4,2,2,2,2,0
1063,2346,8528,49,6,4,2,1,0,1
1064,2347,8191,55,11,3,8,3,1,2
1065,2347,8602,45,4,2,2,2,0,2
1066,2348,8455,55,12,6,6,1,0,1
1067,2348,8654,45,3,0,3,0,0,0
1068,2349,8191,49,6,5,1,2,1,1
1069,2349,8528,51,11,2,9,1,0,1
1070,2350,8472,53,7,5,2,1,1,0
1071,2350,8658,47,11,4,7,1,1,0
1072,2351,9825,60,4,2,2,4,3,1
1073,2351,8654,40,4,3,1,1,0,1
1074,2352,10252,54,8,3,5,3,0,3
1075,2352,8602,46,4,1,3,1,0,1
1076,2353,8455,52,8,5,3,7,3,4
1077,2353,8655,48,2,2,0,0,0,0
1078,2354,8462,58,5,2,3,4,0,4
1079,2354,8667,42,1,1,0,0,0,0
1080,2355,8559,34,4,4,0,2,2,0
1081,2355,8668,66,11,4,7,2,0,2
1082,2356,8456,54,5,3,2,1,0,1
1083,2356,9879,46,4,1,3,0,0,0
1084,2357,10260,55,4,2,2,2,1,1
1085,2357,8650,45,1,0,1,2,1,1
1086,2358,8586,53,7,3,4,1,1,0
1087,2358,10194,47,4,4,0,0,0,0
1088,2359,8650,55,15,7,8,1,1,0
1089,2359,8472,45,2,0,2,0,0,0
1090,2360,8456,46,6,2,4,3,2,1
1091,2360,8528,54,4,4,0,1,1,0
1092,2361,8462,45,4,3,1,1,1,0
1093,2361,8586,55,7,3,4,3,2,1
1094,2362,10260,48,4,3,1,1,1,0
1095,2362,8559,52,12,7,5,2,1,1
1096,2364,8668,53,12,4,8,2,1,1
1097,2364,8602,47,2,2,0,3,0,3
1098,2365,9879,53,8,4,4,2,1,1
1099,2365,8667,47,3,2,1,0,0,0
1100,2366,8455,62,5,4,1,8,2,6
1101,2366,10252,38,2,0,2,0,0,0
1102,2367,8655,47,5,3,2,2,1,1
1103,2367,8191,53,1,0,1,2,0,2
1104,2368,9825,52,8,3,5,1,0,1
1105,2368,8658,48,3,3,0,0,0,0
1106,2370,10194,53,2,1,1,3,2,1
1107,2370,8667,47,3,0,3,1,1,0
1108,2372,8455,53,3,3,0,3,2,1
1109,2372,10260,47,3,2,1,1,0,1
1110,2374,8668,54,4,2,2,1,1,0
1111,2374,8654,46,3,1,2,1,1,0
1112,2375,8456,65,5,4,1,3,1,2
1113,2375,8191,35,7,3,4,1,0,1
1114,2376,8559,44,6,3,3,2,0,2
1115,2376,10252,56,8,5,3,1,0,1
1116,2378,9825,55,12,5,7,1,1,0
1117,2378,8602,45,4,0,4,1,0,1
1118,2379,8654,59,7,5,2,1,0,1
1119,2379,8472,41,4,2,2,2,0,2
1120,2380,10194,41,4,2,2,1,1,0
1121,2380,8602,59,7,3,4,1,0,1
1122,2381,8528,52,11,4,7,2,1,1
1123,2381,8462,48,2,1,1,3,1,2
1124,2382,9825,59,10,3,7,2,2,0
1125,2382,8586,41,9,2,7,0,0,0
1126,2383,8456,60,6,3,3,1,1,0
1127,2383,8658,40,2,0,2,0,0,0
1128,2384,8650,57,11,5,6,4,1,3
1129,2384,9879,43,2,1,1,0,0,0
1130,2385,8191,40,3,2,1,5,2,3
1131,2385,8667,60,4,1,3,0,0,0
1132,2386,8559,40,4,2,2,3,1,2
1133,2386,8455,60,9,2,7,2,1,1
1134,2387,8655,39,7,3,4,1,1,0
1135,2387,10260,61,7,4,3,3,2,1
1136,2388,8668,55,7,4,3,3,1,2
1137,2388,10252,45,4,3,1,3,0,3
1138,2389,9825,58,7,3,4,3,1,2
1139,2389,8528,42,10,2,8,1,0,1
1140,2390,8455,46,8,4,4,1,1,0
1141,2390,8586,54,12,7,5,2,0,2
1142,2391,8191,40,2,1,1,1,0,1
1143,2391,8472,60,7,4,3,0,0,0
1144,2392,10194,64,4,2,2,3,2,1
1145,2392,8559,36,5,1,4,2,1,1
1146,2393,8462,49,10,5,5,1,1,0
1147,2393,10252,51,6,3,3,2,1,1
1148,2394,8650,61,9,4,5,1,0,1
1149,2394,8654,39,2,1,1,0,0,0
1150,2395,9879,52,2,2,0,4,1,3
1151,2395,8602,48,0,0,0,3,1,2
1152,2396,8668,46,2,1,1,4,1,3
1153,2396,8655,54,10,8,2,1,0,1
1154,2398,10260,53,5,3,2,3,2,1
1155,2398,8456,47,4,2,2,2,2,0
1156,2399,9879,44,4,1,3,2,2,0
1157,2399,8668,56,7,1,6,0,0,0
1158,2400,8667,40,6,3,3,3,1,2
1159,2400,8472,60,3,2,1,0,0,0
1160,2402,8654,45,2,1,1,2,1,1
1161,2402,8528,55,6,2,4,1,0,1
1162,2403,10260,54,7,3,4,1,0,1
1163,2403,8586,46,2,1,1,1,0,1
1164,2404,8455,54,12,7,5,1,0,1
1165,2404,10194,46,2,1,1,0,0,0
1166,2405,8650,49,6,4,2,3,1,2
1167,2405,8191,51,7,2,5,1,1,0
1168,2406,8559,57,7,4,3,3,1,2
1169,2406,8462,43,3,1,2,1,0,1
1170,2407,10252,54,7,6,1,6,2,4
1171,2407,8658,46,10,5,5,1,1,0
1172,2409,8667,43,1,1,0,5,2,3
1173,2409,8528,57,3,0,3,1,1,0
1174,2410,8559,41,5,1,4,3,1,2
1175,2410,8586,59,8,5,3,1,0,1
1176,2411,10260,61,8,4,4,5,1,4
1177,2411,8472,39,5,4,1,2,0,2
1178,2413,8602,51,11,7,4,2,0,2
1179,2413,8462,49,4,2,2,0,0,0
1180,2414,8456,52,11,5,6,1,1,0
1181,2414,10252,48,5,2,3,0,0,0
1182,2416,8655,45,5,3,2,1,0,1
1183,2416,9825,55,4,2,2,0,0,0
1184,2417,9879,55,3,1,2,1,1,0
1185,2417,8654,45,3,2,1,2,1,1
1186,2418,8455,48,8,1,7,2,1,1
1187,2418,8650,52,2,0,2,1,0,1
1188,2421,8528,42,3,2,1,3,1,2
1189,2421,8455,58,3,1,2,1,0,1
1190,2423,8658,49,5,2,3,1,1,0
1191,2423,8559,51,4,3,1,0,0,0
1192,2424,10252,53,10,7,3,2,1,1
1193,2424,8655,47,2,1,1,2,0,2
1194,2425,9825,58,6,2,4,2,0,2
1195,2425,9879,42,1,0,1,0,0,0
1196,2426,10260,51,11,8,3,2,0,2
1197,2426,10194,49,7,3,4,1,0,1
1198,2427,8456,55,7,4,3,2,1,1
1199,2427,8654,45,6,1,5,2,1,1
1200,2428,8650,55,5,3,2,2,0,2
1201,2428,8667,45,8,4,4,1,0,1
1202,2429,9825,52,4,2,2,1,1,0
1203,2429,10260,48,6,2,4,1,0,1
1204,2430,8586,70,15,10,5,2,2,0
1205,2430,8658,30,4,4,0,6,3,3
1206,2431,9879,39,2,1,1,2,1,1
1207,2431,10252,61,1,1,0,1,1,0
1208,2432,8668,59,14,8,6,2,1,1
1209,2432,8528,41,5,1,4,1,1,0
1210,2433,8602,56,14,8,6,2,1,1
1211,2433,8667,44,2,1,1,0,0,0
1212,2434,8654,53,4,3,1,1,0,1
1213,2434,8655,47,8,3,5,1,0,1
1214,2435,8650,65,13,4,9,2,1,1
1215,2435,8559,35,3,3,0,3,3,0
1216,2436,8462,41,7,3,4,1,1,0
1217,2436,8456,59,7,2,5,2,1,1
1218,2437,8472,53,6,2,4,1,1,0
1219,2437,10194,47,5,1,4,0,0,0
1220,2438,8455,58,17,9,8,1,1,0
1221,2438,8191,42,2,0,2,1,0,1
1222,2439,8650,48,11,7,4,2,2,0
1223,2439,8191,52,4,3,1,1,0,1
1224,2440,8667,51,5,4,1,3,2,1
1225,2440,8472,49,4,1,3,1,1,0
1226,2441,10260,40,12,8,4,1,1,0
1227,2441,8586,60,7,2,5,0,0,0
1228,2442,8456,55,3,1,2,2,0,2
1229,2442,9825,45,7,0,7,0,0,0
1230,2443,8655,54,4,1,3,1,1,0
1231,2443,8602,46,3,1,2,3,0,3
1232,2444,9879,51,10,3,7,2,2,0
1233,2444,8668,49,9,4,5,1,0,1
1234,2445,8658,46,7,3,4,4,3,1
1235,2445,10252,54,4,1,3,1,0,1
1236,2446,8559,58,6,3,3,2,1,1
1237,2446,8462,42,8,2,6,0,0,0
1238,2447,8455,53,14,4,10,1,0,1
1239,2447,10194,47,1,0,1,0,0,0
1240,2448,8654,47,6,4,2,2,1,1
1241,2448,8528,53,6,4,2,1,0,1
1242,2449,8456,55,3,2,1,2,2,0
1243,2449,10260,45,8,0,8,0,0,0
1244,2450,9825,55,10,8,2,2,0,2
1245,2450,8528,45,5,3,2,2,0,2
1246,2451,8650,51,10,4,6,2,2,0
1247,2451,8654,49,4,1,3,0,0,0
1248,2452,10252,53,5,2,3,3,1,2
1249,2452,8462,47,12,3,9,2,1,1
1250,2453,8668,51,9,4,5,2,1,1
1251,2453,8655,49,6,3,3,2,1,1
1252,2454,8602,58,3,0,3,3,1,2
1253,2454,9879,42,5,0,5,2,0,2
1254,2455,10194,52,6,2,4,1,1,0
1255,2455,8559,48,5,1,4,1,0,1
1256,2456,8667,49,8,4,4,1,0,1
1257,2456,8658,51,8,4,4,1,0,1
1258,2457,8472,59,4,2,2,2,1,1
1259,2457,8191,41,1,1,0,1,0,1
1260,2458,8586,47,3,2,1,2,1,1
1261,2458,8455,53,13,2,11,1,0,1
1262,2459,8650,58,5,2,3,3,1,2
1263,2459,8667,42,3,3,0,2,0,2
1264,2460,8191,44,8,5,3,2,0,2
1265,2460,8586,56,9,7,2,0,0,0
1266,2461,8455,51,6,4,2,1,0,1
1267,2461,8528,49,8,8,0,0,0,0
1268,2462,8602,42,13,5,8,2,2,0
1269,2462,8472,58,7,4,3,3,0,3
1270,2463,10260,61,5,5,0,3,3,0
1271,2463,10194,39,1,0,1,0,0,0
1272,2464,8462,49,12,6,6,2,1,1
1273,2464,8668,51,8,5,3,2,1,1
1274,2466,9879,46,11,4,7,2,1,1
1275,2466,9825,54,3,1,2,0,0,0
1276,2467,8655,51,9,3,6,4,3,1
1277,2467,10252,49,3,1,2,1,0,1
1278,2468,8658,52,5,2,3,1,1,0
1279,2468,8559,48,4,0,4,0,0,0
1280,2469,10260,54,13,3,10,5,2,3
1281,2469,8472,46,1,1,0,1,0,1
1282,2470,8602,54,5,4,1,3,2,1
1283,2470,8462,46,5,4,1,2,1,1
1284,2471,9879,32,6,4,2,4,1,3
1285,2471,8654,68,11,4,7,2,0,2
1286,2473,8455,52,9,5,4,1,1,0
1287,2473,8650,48,7,4,3,1,0,1
1288,2474,8191,54,10,7,3,1,0,1
1289,2474,8658,46,5,2,3,1,0,1
1290,2475,8559,59,10,5,5,2,1,1
1291,2475,8586,41,7,1,6,1,1,0
1292,2476,8667,44,4,1,3,1,1,0
1293,2476,8528,56,4,3,1,0,0,0
1294,2477,10252,39,6,2,4,1,1,0
1295,2477,8456,61,7,5,2,0,0,0
1296,2478,8655,38,4,1,3,3,2,1
1297,2478,9825,62,12,4,8,0,0,0
1298,2479,8654,68,10,5,5,4,4,0
1299,2479,10194,32,3,0,3,0,0,0
1300,2480,10260,62,8,2,6,3,1,2
1301,2480,8559,38,10,3,7,1,0,1
1302,2481,9879,68,12,7,5,1,1,0
1303,2481,8667,32,4,0,4,0,0,0
1304,2482,8602,53,9,5,4,1,0,1
1305,2482,8668,47,4,0,4,0,0,0
1306,2483,8655,60,4,2,2,1,0,1
1307,2483,8191,40,3,1,2,0,0,0
1308,2484,10252,51,2,2,0,1,1,0
1309,2484,8455,49,13,3,10,0,0,0
1310,2485,8650,53,7,1,6,1,0,1
1311,2485,8472,47,6,3,3,1,0,1
1312,2486,8528,57,8,4,4,2,1,1
1313,2486,8456,43,4,2,2,0,0,0
1314,2487,8586,57,3,2,1,1,1,0
1315,2487,8462,43,9,4,5,1,0,1
1316,2488,9825,65,12,7,5,4,2,2
1317,2488,8658,35,1,1,0,0,0,0
1318,2490,8655,45,3,1,2,2,0,2
1319,2490,8668,55,8,4,4,1,0,1
1320,2491,8559,47,9,5,4,1,1,0
1321,2491,9879,53,6,1,5,1,1,0
1322,2493,9825,55,8,4,4,2,2,0
1323,2493,8650,45,3,2,1,1,0,1
1324,2495,8472,60,2,1,1,2,0,2
1325,2495,8658,40,3,0,3,0,0,0
1326,2497,8602,60,8,4,4,1,1,0
1327,2497,10194,40,3,0,3,2,1,1
1328,2498,8528,51,7,4,3,3,1,2
1329,2498,8483,49,4,3,1,2,0,2
1330,2499,10260,54,8,5,3,1,1,0
1331,2499,8586,46,6,5,1,1,0,1
1332,2500,9825,52,18,6,12,2,0,2
1333,2500,8654,48,5,3,2,2,0,2
1334,2501,8658,44,7,3,4,6,1,5
1335,2501,10252,56,3,0,3,1,0,1
1336,2508,8659,36,5,3,2,1,0,1
1337,2508,8483,64,7,0,7,0,0,0
1338,2511,8455,48,6,2,4,2,0,2
1339,2511,8650,52,4,1,3,0,0,0
1340,2515,8654,43,9,6,3,2,2,0
1341,2515,8658,57,5,1,4,0,0,0
1342,2517,8659,43,4,2,2,1,1,0
1343,2517,8456,57,5,2,3,3,2,1
1344,2518,8668,52,6,4,2,1,1,0
1345,2518,8483,48,3,0,3,2,0,2
1346,2520,8659,44,8,7,1,3,2,1
1347,2520,8654,56,3,2,1,0,0,0
1348,2522,10194,54,6,6,0,2,1,1
1349,2522,8658,46,8,1,7,1,0,1
1350,2523,8650,49,1,1,0,2,1,1
1351,2523,8528,51,10,5,5,2,1,1
1352,2525,8559,35,3,1,2,1,1,0
1353,2525,8668,65,9,5,4,1,0,1
1354,2526,8655,46,1,1,0,1,1,0
1355,2526,10261,54,2,0,2,0,0,0
1356,2532,8668,53,13,5,8,2,1,1
1357,2532,9825,47,5,2,3,1,0,1
1358,2533,10261,55,8,3,5,1,0,1
1359,2533,9879,45,8,7,1,0,0,0
1360,2535,8602,57,7,4,3,5,3,2
1361,2535,8559,43,8,2,6,0,0,0
1362,2536,10194,56,5,4,1,3,2,1
1363,2536,8650,44,6,3,3,2,0,2
1364,2537,8528,58,3,1,2,1,0,1
1365,2537,8659,42,8,3,5,1,0,1
1366,2540,8586,46,5,3,2,3,2,1
1367,2540,9825,54,6,2,4,0,0,0
1368,2541,8650,68,9,6,3,3,1,2
1369,2541,8654,32,3,2,1,4,1,3
1370,2542,8472,47,4,1,3,2,1,1
1371,2542,8668,53,7,4,3,3,1,2
1372,2543,10252,53,12,3,9,1,0,1
1373,2543,8655,47,6,3,3,1,0,1
1374,2544,9879,35,7,4,3,2,0,2
1375,2544,8456,65,3,1,2,0,0,0
1376,2545,8455,61,10,7,3,1,1,0
1377,2545,8658,39,0,0,0,0,0,0
1378,2546,8559,62,8,5,3,2,1,1
1379,2546,10261,38,1,0,1,2,0,2
1380,2553,8668,42,2,2,0,1,0,1
1381,2553,8659,58,2,0,2,1,0,1
1382,2555,8472,45,6,1,5,1,1,0
1383,2555,8602,55,6,2,4,1,0,1
1384,2556,9879,38,5,1,4,2,2,0
1385,2556,8658,62,3,0,3,1,0,1
1386,2558,10194,54,9,6,3,1,1,0
1387,2558,8456,46,6,2,4,2,0,2
1388,2559,9825,53,8,6,2,1,0,1
1389,2559,9879,47,5,3,2,0,0,0
1390,2561,8472,64,8,5,3,2,1,1
1391,2561,8654,36,2,1,1,2,2,0
1392,2562,8456,57,11,6,5,3,3,0
1393,2562,8559,43,7,3,4,1,1,0
1394,2563,8602,44,5,1,4,5,1,4
1395,2563,8655,56,3,0,3,3,1,2
1396,2567,10194,43,3,1,2,2,1,1
1397,2567,8528,57,6,3,3,3,1,2
1398,2571,8456,49,7,5,2,1,0,1
1399,2571,8654,51,4,2,2,0,0,0
1400,2575,8602,51,9,6,3,2,1,1
1401,2575,8658,49,0,0,0,0,0,0
1402,2578,10194,53,12,5,7,1,1,0
1403,2578,8483,47,3,3,0,2,1,1
1404,2580,8650,54,6,4,2,3,3,0
1405,2580,9879,46,8,2,6,3,2,1
1406,2581,8559,52,8,4,4,3,0,3
1407,2581,8472,48,5,3,2,2,0,2
1408,2583,8655,56,4,3,1,2,2,0
1409,2583,8654,44,1,1,0,0,0,0
1410,2584,10261,54,4,3,1,1,1,0
1411,2584,8658,46,5,2,3,1,1,0
1412,2585,8602,46,1,1,0,1,1,0
1413,2585,8659,54,11,2,9,2,2,0
1414,2586,8586,53,11,7,4,1,1,0
1415,2586,8483,47,2,0,2,0,0,0
1416,2587,10252,37,9,5,4,1,0,1
1417,2587,8528,63,9,4,5,0,0,0
1418,2592,8658,44,2,2,0,1,0,1
1419,2592,8668,56,16,6,10,0,0,0
1420,2594,8528,54,5,2,3,1,1,0
1421,2594,8602,46,4,3,1,1,0,1
1422,2595,10194,51,7,3,4,2,1,1
1423,2595,8655,49,8,2,6,1,1,0
1424,2598,8483,51,4,1,3,2,1,1
1425,2598,8650,49,8,2,6,2,0,2
1426,2600,8559,44,5,3,2,3,2,1
1427,2600,8654,56,6,4,2,0,0,0
1428,2601,8602,35,3,1,2,4,4,0
1429,2601,8668,65,5,4,1,2,0,2
1430,2605,8658,61,6,4,2,4,1,3
1431,2605,8655,39,5,2,3,0,0,0
1432,2608,8528,55,10,5,5,1,1,0
1433,2608,8455,45,3,1,2,2,1,1
1434,2609,8650,57,7,6,1,2,0,2
1435,2609,8602,43,2,0,2,0,0,0
1436,2610,8483,52,2,2,0,2,1,1
1437,2610,8472,48,11,2,9,2,0,2
1438,2616,9879,54,2,1,1,4,2,2
1439,2616,10194,46,11,4,7,1,0,1
1440,2617,8528,42,5,3,2,3,1,2
1441,2617,9825,58,7,3,4,1,0,1
1442,2619,8650,54,10,3,7,1,1,0
1443,2619,8559,46,6,0,6,1,1,0
1444,2620,8472,52,6,4,2,3,3,0
1445,2620,8655,48,4,1,3,0,0,0
1446,2624,9825,52,10,4,6,4,2,2
1447,2624,8658,48,1,1,0,1,1,0
1448,2625,8659,52,8,5,3,3,3,0
1449,2625,10260,48,1,0,1,2,2,0
1450,2626,10194,38,3,2,1,3,3,0
1451,2626,8668,62,6,3,3,0,0,0
1452,2631,8602,45,2,2,0,3,2,1
1453,2631,8455,55,9,6,3,0,0,0
1454,2633,8483,59,11,5,6,2,2,0
1455,2633,8658,41,5,2,3,2,0,2
1456,2634,10252,57,5,3,2,2,0,2
1457,2634,8472,43,5,1,4,0,0,0
1458,2636,10261,61,4,3,1,3,1,2
1459,2636,8654,39,5,1,4,0,0,0
1460,2637,8655,52,4,3,1,2,0,2
1461,2637,8650,48,4,1,3,4,0,4
1462,2640,10261,55,2,2,0,2,1,1
1463,2640,8472,45,6,4,2,2,1,1
1464,2642,9825,56,10,5,5,1,1,0
1465,2642,8654,44,5,3,2,1,1,0
1466,2643,8456,52,10,5,5,1,1,0
1467,2643,8602,48,5,4,1,1,0,1
1468,2645,8659,55,9,3,6,1,1,0
1469,2645,8483,45,0,0,0,1,1,0
1470,2647,9879,51,5,2,3,1,0,1
1471,2647,8528,49,3,2,1,0,0,0
1472,2648,8655,36,4,3,1,2,2,0
1473,2648,8455,64,8,1,7,1,1,0
1474,2651,10252,42,7,5,2,1,1,0
1475,2651,8456,58,10,4,6,0,0,0
1476,2652,8654,42,4,2,2,1,1,0
1477,2652,8668,58,5,2,3,2,1,1
1478,2653,8586,44,7,4,3,2,0,2
1479,2653,10261,56,5,1,4,1,0,1
1480,2655,8659,48,14,5,9,1,1,0
1481,2655,8655,52,9,5,4,1,0,1
1482,2658,8483,46,9,6,3,1,1,0
1483,2658,8472,54,5,0,5,2,0,2
1484,2660,9825,55,5,1,4,2,2,0
1485,2660,8668,45,6,3,3,1,1,0
1486,2663,8559,47,6,4,2,1,1,0
1487,2663,8602,53,5,2,3,2,0,2
1488,2664,8659,45,7,3,4,2,1,1
1489,2664,8528,55,4,2,2,0,0,0
1490,2665,8483,31,10,3,7,3,1,2
1491,2665,8654,69,7,6,1,3,1,2
1492,2672,8668,53,12,7,5,3,1,2
1493,2672,8483,47,6,4,2,0,0,0
1494,2676,8472,49,6,3,3,2,2,0
1495,2676,10194,51,4,2,2,4,0,4
1496,2678,8455,51,5,1,4,2,1,1
1497,2678,8650,49,3,1,2,2,1,1
1498,2680,9825,54,8,4,4,2,1,1
1499,2680,8602,46,1,0,1,0,0,0
1500,2682,8472,48,8,2,6,4,1,3
1501,2682,8586,52,4,1,3,1,1,0
1502,2683,10261,48,7,2,5,3,2,1
1503,2683,8655,52,2,1,1,1,0,1
1504,2689,9825,45,8,3,5,1,1,0
1505,2689,8586,55,8,2,6,1,0,1
1506,2691,10252,62,8,6,2,3,1,2
1507,2691,8655,38,1,0,1,2,0,2
1508,2692,8668,58,9,3,6,2,1,1
1509,2692,8472,42,7,2,5,1,0,1
1510,2693,8559,48,9,5,4,1,1,0
1511,2693,10261,52,5,4,1,1,1,0
1512,2699,8472,55,5,3,2,2,1,1
1513,2699,9825,45,9,4,5,0,0,0
1514,2702,8668,39,7,1,6,4,1,3
1515,2702,10261,61,8,2,6,2,0,2
1516,2703,8456,45,3,1,2,2,1,1
1517,2703,8528,55,4,1,3,1,0,1
1518,2710,8650,55,9,2,7,1,1,0
1519,2710,8659,45,6,2,4,1,0,1
1520,2711,8472,40,6,1,5,1,0,1
1521,2711,8456,60,7,3,4,1,0,1
1522,2714,10261,61,10,4,6,1,0,1
1523,2714,8602,39,2,2,0,0,0,0
1524,2715,9825,51,9,4,5,1,1,0
1525,2715,8655,49,12,8,4,2,1,1
1526,2716,8559,53,9,7,2,2,1,1
1527,2716,8658,47,3,1,2,0,0,0
1528,2718,8455,65,8,3,5,2,1,1
1529,2718,10194,35,4,2,2,1,0,1
1530,2724,8655,44,6,1,5,3,0,3
1531,2724,8483,56,5,1,4,0,0,0
1532,2726,10261,53,9,3,6,1,1,0
1533,2726,10194,47,1,0,1,1,1,0
1534,2727,8528,59,15,5,10,1,1,0
1535,2727,8658,41,5,3,2,2,1,1
1536,2728,8456,47,2,2,0,2,1,1
1537,2728,8455,53,9,4,5,0,0,0
1538,2731,8668,56,7,4,3,3,3,0
1539,2731,10252,44,4,3,1,0,0,0
1540,2732,10261,55,8,6,2,4,0,4
1541,2732,8602,45,11,5,6,0,0,0
1542,2735,8658,46,5,3,2,3,1,2
1543,2735,8559,54,13,6,7,1,0,1
1544,2737,8455,69,13,6,7,1,1,0
1545,2737,10194,31,5,1,4,2,1,1
1546,2740,8650,54,7,3,4,3,0,3
1547,2740,8456,46,4,2,2,1,0,1
1548,2741,8659,47,4,1,3,3,1,2
1549,2741,8472,53,1,0,1,3,0,3
1550,2742,8586,59,8,3,5,4,0,4
1551,2742,10194,41,6,2,4,0,0,0
1552,2744,8602,45,7,3,4,2,1,1
1553,2744,8668,55,3,2,1,0,0,0
1554,2746,8559,58,7,4,3,3,2,1
1555,2746,8654,42,6,2,4,0,0,0
1556,2749,8483,60,5,0,5,2,1,1
1557,2749,8528,40,3,0,3,3,1,2
1558,2752,8668,56,6,3,3,1,0,1
1559,2752,8655,44,3,1,2,0,0,0
1560,2755,8559,52,7,6,1,2,1,1
1561,2755,9879,48,3,3,0,3,1,2
1562,2761,8472,52,3,1,2,2,1,1
1563,2761,8528,48,7,3,4,1,0,1
1564,2762,8586,56,11,5,6,3,2,1
1565,2762,8659,44,3,0,3,1,0,1
1566,2763,10252,42,3,1,2,2,2,0
1567,2763,10194,58,3,2,1,0,0,0
1568,2764,9879,49,7,3,4,2,1,1
1569,2764,8602,51,2,0,2,1,1,0
1570,2767,10261,40,7,4,3,2,1,1
1571,2767,8483,60,6,5,1,1,0,1
1572,2769,10260,36,7,2,5,1,1,0
1573,2769,9825,64,2,0,2,2,1,1
1574,2772,8456,60,12,5,7,1,1,0
1575,2772,8654,40,3,1,2,4,2,2
1576,2773,8655,51,9,4,5,4,2,2
1577,2773,8559,49,1,1,0,2,1,1
1578,2777,8668,52,4,1,3,1,1,0
1579,2777,8528,48,10,1,9,0,0,0
1580,2780,8483,45,6,4,2,1,0,1
1581,2780,8586,55,12,5,7,0,0,0
1582,2781,8655,46,4,2,2,5,1,4
1583,2781,8654,54,9,6,3,1,0,1
1584,2783,8668,53,4,1,3,4,2,2
1585,2783,8456,47,3,1,2,0,0,0
1586,2784,10261,57,12,7,5,3,1,2
1587,2784,8658,43,1,0,1,0,0,0
1588,2787,8559,46,7,4,3,2,0,2
1589,2787,8472,54,4,2,2,2,0,2
1590,2794,9879,42,13,6,7,1,1,0
1591,2794,8658,58,2,1,1,2,1,1
1592,2799,10260,49,7,4,3,4,1,3
1593,2799,8483,51,7,1,6,2,1,1
1594,2801,8654,61,11,9,2,2,2,0
1595,2801,8472,39,9,6,3,1,0,1
1596,2804,10261,63,8,6,2,2,0,2
1597,2804,8659,37,5,3,2,1,0,1
1598,2806,9825,61,5,3,2,2,0,2
1599,2806,9879,39,2,0,2,1,0,1
1600,2807,8559,34,9,6,3,1,1,0
1601,2807,8456,66,8,5,3,1,0,1
1602,2809,9825,60,13,6,7,1,0,1
1603,2809,8559,40,8,5,3,0,0,0
1604,2810,8654,48,4,2,2,3,1,2
1605,2810,8455,52,9,5,4,2,0,2
1606,2813,8456,55,11,5,6,1,1,0
1607,2813,8655,45,2,1,1,1,1,0
1608,2819,10260,51,5,1,4,2,1,1
1609,2819,8650,49,0,0,0,2,1,1
1610,2820,9825,46,5,2,3,2,1,1
1611,2820,8472,54,8,3,5,1,0,1
1612,2822,10252,54,8,6,2,2,2,0
1613,2822,8559,46,7,1,6,1,0,1
1614,2827,8528,43,2,2,0,3,2,1
1615,2827,8456,57,4,0,4,0,0,0
1616,2829,9825,58,16,6,10,3,2,1
1617,2829,8659,42,5,2,3,3,2,1
1618,2832,10261,58,9,4,5,1,1,0
1619,2832,10194,42,3,1,2,1,1,0
1620,2842,8654,43,6,2,4,1,0,1
1621,2842,9879,57,5,2,3,1,0,1
1622,2844,8668,54,6,4,2,2,1,1
1623,2844,8658,46,3,0,3,0,0,0
1624,2846,10194,44,11,9,2,3,0,3
1625,2846,8655,56,4,3,1,0,0,0
1626,2850,9825,61,15,7,8,1,1,0
1627,2850,8658,39,4,3,1,1,0,1
1628,2852,8668,54,5,5,0,1,1,0
1629,2852,8650,46,12,2,10,1,0,1
1630,2857,10194,55,3,1,2,1,0,1
1631,2857,8559,45,3,1,2,0,0,0
1632,2859,8650,70,4,3,1,1,1,0
1633,2859,8655,30,0,0,0,3,1,2
1634,2861,8668,52,3,1,2,4,2,2
1635,2861,8586,48,6,2,4,0,0,0
1636,2862,8654,53,1,1,0,1,0,1
1637,2862,10261,47,7,2,5,0,0,0
1638,2864,8483,40,10,5,5,1,0,1
1639,2864,8658,60,6,4,2,1,0,1
1640,2865,8659,54,6,5,1,3,2,1
1641,2865,9879,46,2,0,2,1,0,1
1642,2872,8456,46,13,7,6,1,1,0
1643,2872,10003,54,3,0,3,2,0,2
1644,2874,10172,48,8,4,4,1,0,1
1645,2874,8559,52,9,1,8,0,0,0
1646,2875,8455,51,10,0,10,2,2,0
1647,2875,10194,49,3,0,3,0,0,0
1648,2877,8659,41,7,2,5,2,2,0
1649,2877,10260,59,4,2,2,1,0,1
1650,2881,8456,52,5,4,1,1,0,1
1651,2881,8602,48,4,1,3,2,0,2
1652,2882,8655,53,2,2,0,3,2,1
1653,2882,9850,47,3,1,2,0,0,0
1654,2885,10003,61,8,3,5,1,1,0
1655,2885,8559,39,3,3,0,2,1,1
1656,2888,9879,54,2,2,0,1,0,1
1657,2888,8528,46,9,4,5,1,0,1
1658,2889,9825,69,5,2,3,3,1,2
1659,2889,8659,31,4,0,4,2,0,2
1660,2890,9850,44,8,4,4,1,1,0
1661,2890,10252,56,6,4,2,0,0,0
1662,2891,8455,53,6,1,5,1,1,0
1663,2891,8655,47,9,1,8,1,0,1
1664,2897,10172,46,8,4,4,2,1,1
1665,2897,8456,54,5,3,2,1,0,1
1666,2899,8455,47,6,2,4,2,1,1
1667,2899,8650,53,1,1,0,0,0,0
1668,2901,8456,70,7,6,1,2,1,1
1669,2901,10261,30,3,2,1,0,0,0
1670,2904,9879,49,7,3,4,2,1,1
1671,2904,8472,51,7,3,4,0,0,0
1672,2906,10252,36,3,1,2,3,2,1
1673,2906,8586,64,5,1,4,1,0,1
1674,2907,8659,49,6,2,4,1,1,0
1675,2907,8559,51,6,5,1,3,2,1
1676,2914,10172,43,5,3,2,2,2,0
1677,2914,9850,57,8,5,3,1,0,1
1678,2916,8528,47,1,1,0,1,0,1
1679,2916,8472,53,9,8,1,1,0,1
1680,2918,8586,52,12,5,7,7,3,4
1681,2918,8659,48,5,2,3,1,1,0
1682,2920,8655,53,6,6,0,4,1,3
1683,2920,10003,47,3,1,2,2,0,2
1684,2921,10194,46,3,2,1,2,1,1
1685,2921,8668,54,5,1,4,1,1,0
1686,2922,9879,43,12,7,5,2,1,1
1687,2922,8650,57,7,4,3,1,1,0
1688,2923,8456,66,4,1,3,2,0,2
1689,2923,9850,34,2,0,2,0,0,0
1690,2924,10261,47,10,4,6,1,1,0
1691,2924,8455,53,10,4,6,2,0,2
1692,2926,8586,58,13,6,7,1,0,1
1693,2926,8559,42,7,4,3,2,0,2
1694,2928,8472,56,12,9,3,2,2,0
1695,2928,8602,44,10,4,6,3,1,2
1696,2931,8456,43,2,1,1,2,1,1
1697,2931,8455,57,8,4,4,1,0,1
1698,2934,10261,45,5,2,3,2,1,1
1699,2934,9850,55,7,5,2,0,0,0
1700,2935,10194,44,3,2,1,2,0,2
1701,2935,8586,56,14,6,8,1,0,1
1702,2937,10003,61,4,3,1,1,0,1
1703,2937,9879,39,7,1,6,2,0,2
1704,2940,8659,51,6,2,4,2,1,1
1705,2940,8655,49,11,4,7,3,0,3
1706,2941,8668,58,17,6,11,5,4,1
1707,2941,9850,42,0,0,0,0,0,0
1708,2943,8456,48,9,4,5,5,1,4
1709,2943,9825,52,10,6,4,1,1,0
1710,2944,10261,62,6,2,4,3,1,2
1711,2944,10003,38,0,0,0,0,0,0
1712,2949,10172,60,9,3,6,2,2,0
1713,2949,8472,40,7,2,5,2,0,2
1714,2950,8586,61,9,4,5,4,2,2
1715,2950,8455,39,8,2,6,0,0,0
1716,2952,8602,56,7,3,4,1,1,0
1717,2952,9850,44,12,7,5,1,1,0
1718,2953,10252,59,3,3,0,1,1,0
1719,2953,9825,41,5,2,3,2,1,1
1720,2954,8559,59,2,2,0,1,0,1
1721,2954,8655,41,5,0,5,0,0,0
1722,2957,8456,68,14,6,8,2,1,1
1723,2957,10194,32,1,0,1,1,0,1
1724,2958,8659,46,4,2,2,1,1,0
1725,2958,10261,54,9,1,8,1,0,1
1726,2959,8602,32,3,3,0,2,1,1
1727,2959,9825,68,14,5,9,0,0,0
1728,2961,9879,40,5,3,2,1,0,1
1729,2961,8455,60,16,4,12,2,0,2
1730,2962,8650,58,11,3,8,1,1,0
1731,2962,8655,42,2,1,1,0,0,0
1732,2964,9850,45,3,3,0,1,0,1
1733,2964,8586,55,8,4,4,1,0,1
1734,2966,8668,42,2,2,0,1,0,1
1735,2966,8472,58,8,5,3,1,0,1
1736,2967,10172,41,5,3,2,5,3,2
1737,2967,10003,59,3,1,2,0,0,0
1738,2968,8456,53,8,4,4,3,2,1
1739,2968,8659,47,2,2,0,0,0,0
1740,2969,10172,38,5,2,3,1,0,1
1741,2969,9825,62,10,4,6,1,0,1
1742,2971,8455,60,4,3,1,3,1,2
1743,2971,10252,40,6,3,3,1,0,1
1744,2972,8650,55,5,4,1,1,1,0
1745,2972,10261,45,1,0,1,1,0,1
1746,2978,8668,54,7,3,4,2,2,0
1747,2978,8659,46,1,1,0,1,0,1
1748,2979,8650,53,5,3,2,3,2,1
1749,2979,9825,47,5,4,1,3,1,2
1750,2980,10252,63,3,2,1,2,1,1
1751,2980,8655,37,3,1,2,1,1,0
1752,2985,10194,44,8,5,3,2,0,2
1753,2985,9850,56,6,3,3,3,0,3
1754,2986,8472,51,5,3,2,1,1,0
1755,2986,10261,49,3,2,1,1,0,1
1756,2988,8602,55,5,2,3,2,1,1
1757,2988,9879,45,4,2,2,0,0,0
1758,2990,8655,53,7,5,2,2,1,1
1759,2990,10194,47,1,1,0,2,1,1
1760,2991,8559,47,7,4,3,1,1,0
1761,2991,8668,53,4,3,1,2,1,1
1762,2993,8650,49,8,4,4,2,1,1
1763,2993,8456,51,5,4,1,0,0,0
1764,2995,9850,55,5,2,3,1,1,0
1765,2995,10172,45,5,1,4,2,0,2
1766,2999,10252,47,8,3,5,1,1,0
1767,2999,8668,53,5,1,4,1,0,1
1768,3000,8655,42,8,5,3,4,0,4
1769,3000,9879,58,8,1,7,0,0,0
1770,3001,8455,59,9,6,3,4,1,3
1771,3001,8472,41,3,2,1,0,0,0
1772,3002,10194,36,1,1,0,3,1,2
1773,3002,8650,64,7,2,5,0,0,0
1774,3006,8602,46,3,2,1,2,1,1
1775,3006,8586,54,11,6,5,1,1,0
1776,3007,8659,54,10,7,3,3,2,1
1777,3007,9850,46,6,1,5,0,0,0
1778,3017,10003,60,9,4,5,4,1,3
1779,3017,8472,40,5,0,5,1,0,1
1780,3020,10260,63,10,2,8,2,1,1
1781,3020,10194,37,4,1,3,0,0,0
1782,3022,10003,66,3,3,0,1,1,0
1783,3022,8455,34,8,5,3,0,0,0
1784,3023,8586,59,9,6,3,6,2,4
1785,3023,8528,41,4,0,4,1,0,1
1786,3025,10172,53,2,1,1,1,1,0
1787,3025,10252,47,15,4,11,1,1,0
1788,3026,8655,61,8,5,3,1,0,1
1789,3026,10261,39,2,1,1,2,0,2
1790,3028,8659,40,9,5,4,1,0,1
1791,3028,9879,60,6,4,2,0,0,0
1792,3029,9825,54,2,1,1,1,1,0
1793,3029,8655,46,3,1,2,0,0,0
1794,3030,10260,56,9,5,4,2,1,1
1795,3030,8455,44,6,1,5,0,0,0
1796,3031,8586,42,5,4,1,6,4,2
1797,3031,8650,58,13,4,9,1,0,1
1798,3032,8456,58,7,4,3,3,2,1
1799,3032,9879,42,6,1,5,0,0,0
1800,3033,10261,52,6,3,3,1,1,0
1801,3033,10252,48,8,5,3,1,1,0
1802,3034,8559,38,6,3,3,2,1,1
1803,3034,9850,62,8,4,4,2,1,1
1804,3035,10172,53,7,2,5,4,4,0
1805,3035,8602,47,4,0,4,4,2,2
1806,3037,10003,60,7,2,5,2,1,1
1807,3037,8659,40,11,5,6,0,0,0
1808,3040,8655,52,3,3,0,3,1,2
1809,3040,10172,48,13,5,8,3,2,1
1810,3041,8528,59,4,2,2,1,1,0
1811,3041,8559,41,4,0,4,1,0,1
1812,3042,8668,41,6,2,4,1,0,1
1813,3042,8455,59,8,7,1,0,0,0
1814,3044,8650,42,4,1,3,2,1,1
1815,3044,10260,58,4,3,1,4,3,1
1816,3045,9825,51,8,4,4,1,0,1
1817,3045,8472,49,4,0,4,0,0,0
1818,3046,10003,48,7,3,4,4,2,2
1819,3046,9850,52,6,3,3,0,0,0
1820,3047,10261,47,6,3,3,3,1,2
1821,3047,8586,53,4,3,1,2,0,2
1822,3048,8659,57,11,8,3,1,1,0
1823,3048,8602,43,7,3,4,0,0,0
1824,3052,8456,67,12,8,4,2,1,1
1825,3052,8655,33,4,1,3,0,0,0
1826,3053,8602,56,7,4,3,3,2,1
1827,3053,10261,44,7,4,3,2,2,0
1828,3057,8659,62,10,5,5,2,1,1
1829,3057,8472,38,6,1,5,3,2,1
1830,3058,10252,56,4,3,1,1,1,0
1831,3058,8528,44,5,1,4,0,0,0
1832,3064,10172,49,9,4,5,2,1,1
1833,3064,8668,51,3,3,0,2,0,2
1834,3069,9825,56,9,2,7,1,1,0
1835,3069,10261,44,3,1,2,1,1,0
1836,3070,10252,62,6,3,3,4,2,2
1837,3070,9879,38,4,1,3,0,0,0
1838,3071,8559,54,6,4,2,2,0,2
1839,3071,10172,46,8,4,4,0,0,0
1840,3075,9850,47,7,3,4,1,1,0
1841,3075,8528,53,6,4,2,1,0,1
1842,3078,8655,47,7,4,3,5,2,3
1843,3078,8602,53,7,1,6,2,1,1
1844,3079,8559,56,8,4,4,2,2,0
1845,3079,10252,44,5,4,1,1,0,1
1846,3081,9825,57,7,3,4,1,1,0
1847,3081,8668,43,3,0,3,3,1,2
1848,3086,8586,55,16,7,9,2,1,1
1849,3086,10194,45,2,0,2,2,0,2
1850,3087,8528,58,10,3,7,3,2,1
1851,3087,8659,42,2,2,0,0,0,0
1852,3088,10260,56,10,3,7,3,2,1
1853,3088,8602,44,3,1,2,0,0,0
1854,3099,9825,56,10,7,3,3,0,3
1855,3099,10252,44,1,0,1,0,0,0
1856,3105,10194,47,4,2,2,4,2,2
1857,3105,8456,53,7,2,5,1,0,1
1858,3106,8472,52,5,3,2,2,0,2
1859,3106,10172,48,5,4,1,0,0,0
1860,3111,8668,57,7,2,5,3,2,1
1861,3111,8659,43,4,3,1,1,1,0
1862,3112,9879,61,8,4,4,1,1,0
1863,3112,9850,39,6,2,4,1,0,1
1864,3113,8472,45,2,1,1,1,1,0
1865,3113,8456,55,11,3,8,0,0,0
1866,3115,9825,53,7,2,5,4,0,4
1867,3115,10172,47,6,3,3,0,0,0
1868,3118,8602,59,12,8,4,6,3,3
1869,3118,8559,41,9,2,7,0,0,0
1870,3122,8650,52,4,2,2,2,2,0
1871,3122,10252,48,2,1,1,2,2,0
1872,3123,10260,70,15,7,8,2,2,0
1873,3123,10172,30,3,2,1,1,0,1
1874,3124,8668,61,6,3,3,3,2,1
1875,3124,9850,39,9,1,8,1,0,1
1876,3125,10194,60,5,5,0,4,1,3
1877,3125,8602,40,10,4,6,1,0,1
1878,3127,10003,80,9,4,5,3,1,2
1879,3127,10261,20,2,2,0,1,1,0
1880,3128,8659,49,5,3,2,2,1,1
1881,3128,8655,51,12,5,7,1,1,0
1882,3129,10252,51,4,2,2,3,1,2
1883,3129,10194,49,3,3,0,1,0,1
1884,3131,8668,55,10,4,6,1,1,0
1885,3131,8472,45,1,0,1,0,0,0
1886,3133,8456,58,10,5,5,1,0,1
1887,3133,8659,42,2,1,1,0,0,0
1888,3135,10003,64,6,3,3,1,1,0
1889,3135,10172,36,6,2,4,1,0,1
1890,3136,8586,55,9,5,4,4,1,3
1891,3136,9850,45,5,3,2,0,0,0
1892,3138,9825,77,10,3,7,1,1,0
1893,3138,8602,23,5,0,5,0,0,0
1894,3140,8559,43,6,3,3,2,2,0
1895,3140,8586,57,5,3,2,0,0,0
1896,3141,8455,52,6,1,5,1,1,0
1897,3141,10261,48,3,3,0,1,0,1
1898,3142,9879,47,5,1,4,3,2,1
1899,3142,8650,53,5,3,2,1,0,1
1900,3144,8456,47,9,1,8,1,1,0
1901,3144,9850,53,9,6,3,0,0,0
1902,3149,9825,52,5,2,3,1,1,0
1903,3149,8455,48,3,1,2,1,0,1
1904,3152,10003,59,10,5,5,1,0,1
1905,3152,8559,41,3,3,0,0,0,0
1906,3153,9879,48,6,3,3,1,0,1
1907,3153,8528,52,3,2,1,1,0,1
1908,3154,8650,61,19,7,12,1,1,0
1909,3154,8659,39,5,4,1,1,0,1
1910,3157,8586,53,11,6,5,1,1,0
1911,3157,10172,47,4,2,2,2,0,2
1912,3158,8602,52,3,1,2,1,0,1
1913,3158,8456,48,7,4,3,0,0,0
1914,3159,8455,68,11,7,4,2,1,1
1915,3159,10172,32,5,3,2,5,3,2
1916,3162,8650,62,6,2,4,3,0,3
1917,3162,9850,38,2,0,2,1,0,1
1918,3163,9825,63,9,3,6,3,0,3
1919,3163,10194,37,1,0,1,0,0,0
1920,3164,8559,49,7,4,3,5,1,4
1921,3164,8472,51,4,3,1,0,0,0
1922,3165,10003,57,6,4,2,2,0,2
1923,3165,8602,43,5,5,0,1,0,1
1924,3166,8586,65,7,5,2,2,2,0
1925,3166,8655,35,0,0,0,2,0,2
1926,3167,10252,48,7,3,4,2,1,1
1927,3167,8659,52,10,4,6,1,1,0
1928,3169,9850,48,2,1,1,1,1,0
1929,3169,9825,52,9,1,8,1,0,1
1930,3170,8586,60,9,3,6,1,1,0
1931,3170,10252,40,2,2,0,0,0,0
1932,3171,8528,70,7,3,4,1,1,0
1933,3171,8655,30,4,0,4,1,0,1
1934,3174,8650,57,9,6,3,3,1,2
1935,3174,8455,43,2,1,1,0,0,0
1936,3177,10172,56,11,5,6,2,1,1
1937,3177,10194,44,1,0,1,0,0,0
1938,3180,10261,40,8,1,7,1,1,0
1939,3180,8668,60,6,2,4,5,0,5
1940,3181,8456,76,26,6,20,1,0,1
1941,3181,10172,24,1,1,0,0,0,0
1942,3184,8472,47,4,3,1,1,1,0
1943,3184,10260,53,9,3,6,1,1,0
1944,3186,8586,48,7,4,3,1,0,1
1945,3186,9879,52,6,2,4,2,0,2
1946,3187,9825,58,6,5,1,3,3,0
1947,3187,8659,42,7,1,6,1,1,0
1948,3188,8528,48,5,1,4,1,1,0
1949,3188,8602,52,5,3,2,1,1,0
1950,3189,9825,58,7,4,3,2,0,2
1951,3189,10003,42,6,4,2,0,0,0
1952,3191,8668,61,8,3,5,3,0,3
1953,3191,10252,39,2,1,1,0,0,0
1954,3192,8655,52,5,2,3,1,1,0
1955,3192,9879,48,8,1,7,0,0,0
1956,3193,8456,64,6,3,3,1,1,0
1957,3193,8528,36,7,3,4,1,1,0
1958,3198,8602,46,6,5,1,3,2,1
1959,3198,8586,54,4,4,0,0,0,0
1960,3199,10261,55,10,4,6,2,2,0
1961,3199,10252,45,2,1,1,1,1,0
1962,3200,9825,60,8,3,5,1,1,0
1963,3200,8655,40,3,0,3,3,0,3
1964,3201,9850,60,3,3,0,2,1,1
1965,3201,8559,40,5,2,3,1,0,1
1966,3202,8668,46,6,5,1,4,3,1
1967,3202,8528,54,2,0,2,4,0,4
1968,3203,8456,62,9,4,5,3,2,1
1969,3203,9879,38,8,4,4,1,0,1
1970,3206,10003,64,3,2,1,3,2,1
1971,3206,8659,36,13,5,8,1,0,1
1972,3208,10172,58,9,8,1,2,1,1
1973,3208,8602,42,3,0,3,1,0,1
1974,3209,8559,37,2,1,1,2,1,1
1975,3209,9825,63,13,4,9,0,0,0
1976,3210,8455,60,5,3,2,1,0,1
1977,3210,10003,40,2,0,2,0,0,0
1978,3212,8456,63,8,2,6,4,2,2
1979,3212,8668,37,4,0,4,0,0,0
1980,3213,10261,65,5,3,2,1,0,1
1981,3213,8655,35,1,1,0,0,0,0
1982,3216,10260,56,7,3,4,1,0,1
1983,3216,10194,44,8,5,3,0,0,0
1984,3217,8659,37,4,2,2,1,1,0
1985,3217,9879,63,6,5,1,0,0,0
1986,3220,8456,66,6,4,2,1,0,1
1987,3220,8655,34,3,1,2,0,0,0
1988,3223,10172,42,10,5,5,1,1,0
1989,3223,9879,58,8,5,3,1,0,1
1990,3225,8659,49,3,2,1,2,1,1
1991,3225,8472,51,6,5,1,2,0,2
1992,3228,8602,52,14,5,9,1,0,1
1993,3228,10261,48,4,2,2,0,0,0
1994,3230,8668,45,3,2,1,1,1,0
1995,3230,8455,55,2,0,2,3,2,1
1996,3232,10252,48,5,3,2,1,1,0
1997,3232,8456,52,5,3,2,4,3,1
1998,3239,10194,48,2,0,2,1,1,0
1999,3239,9825,52,1,0,1,2,2,0
2000,3241,8655,56,7,5,2,2,0,2
2001,3241,8586,44,5,3,2,1,0,1
2002,3243,8668,22,4,1,3,3,1,2
2003,3243,9879,78,6,4,2,0,0,0
2004,3247,8455,48,5,1,4,3,2,1
2005,3247,10172,52,4,1,3,4,1,3
2006,3249,8472,46,3,3,0,3,3,0
2007,3249,9825,54,11,4,7,0,0,0
2008,3250,10260,47,9,6,3,1,1,0
2009,3250,8668,53,7,5,2,0,0,0
2010,3255,10194,42,5,2,3,3,2,1
2011,3255,9798,58,3,0,3,0,0,0
2012,3256,8650,59,7,4,3,3,1,2
2013,3256,8659,41,3,0,3,0,0,0
2014,3257,10252,53,5,2,3,1,1,0
2015,3257,8654,47,4,2,2,2,1,1
2016,3258,8528,57,4,3,1,2,1,1
2017,3258,8455,43,2,0,2,2,1,1
2018,3260,8650,55,11,4,7,2,1,1
2019,3260,10261,45,2,0,2,1,0,1
2020,3261,10260,46,6,3,3,1,1,0
2021,3261,9825,54,1,0,1,1,0,1
2022,3262,9850,48,11,6,5,2,1,1
2023,3262,10194,52,3,1,2,3,0,3
2024,3263,10172,49,10,4,6,3,1,2
2025,3263,9798,51,4,1,3,2,0,2
2026,3264,8472,52,3,1,2,3,1,2
2027,3264,10252,48,4,3,1,0,0,0
2028,3265,8455,54,7,3,4,4,2,2
2029,3265,10003,46,7,2,5,1,0,1
2030,3268,8456,52,11,4,7,1,1,0
2031,3268,8654,48,0,0,0,1,0,1
2032,3271,8455,44,3,1,2,2,2,0
2033,3271,8650,56,5,1,4,2,0,2
2034,3272,8472,35,2,2,0,1,1,0
2035,3272,8668,65,9,4,5,1,0,1
2036,3275,9850,42,3,1,2,4,4,0
2037,3275,9798,58,2,1,1,1,0,1
2038,3277,10194,52,6,4,2,2,1,1
2039,3277,10172,48,4,1,3,2,0,2
2040,3279,8586,42,4,2,2,2,2,0
2041,3279,9825,58,5,3,2,1,0,1
2042,3280,8472,51,4,1,3,2,1,1
2043,3280,9879,49,9,3,6,2,0,2
2044,3281,8650,53,7,4,3,2,2,0
2045,3281,8528,47,3,2,1,1,0,1
2046,3282,10252,38,8,5,3,3,2,1
2047,3282,8456,62,8,7,1,3,1,2
2048,3283,10261,54,13,5,8,1,0,1
2049,3283,10003,46,6,4,2,0,0,0
2050,3285,8466,42,6,3,3,3,1,2
2051,3285,10172,58,4,4,0,2,0,2
2052,3287,8455,47,10,5,5,1,0,1
2053,3287,8659,53,4,1,3,0,0,0
2054,3288,10194,49,5,2,3,2,1,1
2055,3288,8654,51,8,3,5,1,1,0
2056,3289,10252,45,5,3,2,1,0,1
2057,3289,9825,55,6,3,3,0,0,0
2058,3290,8456,55,6,4,2,2,1,1
2059,3290,8455,45,1,1,0,2,0,2
2060,3291,8668,56,8,3,5,3,0,3
2061,3291,9850,44,5,0,5,0,0,0
2062,3293,8466,56,8,5,3,4,1,3
2063,3293,10261,44,3,0,3,1,0,1
2064,3294,10194,52,4,2,2,1,0,1
2065,3294,9879,48,4,1,3,2,0,2
2066,3298,8528,49,9,4,5,2,0,2
2067,3298,9798,51,9,4,5,1,0,1
2068,3299,9798,51,7,2,5,2,1,1
2069,3299,10252,49,10,5,5,1,1,0
2070,3301,9850,48,9,3,6,2,1,1
2071,3301,8466,52,6,1,5,1,0,1
2072,3302,10261,49,6,1,5,5,1,4
2073,3302,10194,51,3,1,2,0,0,0
2074,3304,10003,71,4,1,3,1,0,1
2075,3304,8659,29,0,0,0,2,0,2
2076,3308,8668,44,8,3,5,3,1,2
2077,3308,9825,56,9,1,8,3,2,1
2078,3309,10003,47,7,4,3,2,1,1
2079,3309,9825,53,9,2,7,0,0,0
2080,3310,9879,42,2,1,1,3,2,1
2081,3310,8586,58,2,1,1,0,0,0
2082,3311,8650,69,13,7,6,2,1,1
2083,3311,8466,31,5,1,4,1,0,1
2084,3312,8456,59,6,3,3,3,1,2
2085,3312,8668,41,4,2,2,2,1,1
2086,3313,8528,40,3,2,1,1,1,0
2087,3313,10261,60,7,4,3,0,0,0
2088,3314,9850,58,2,1,1,2,1,1
2089,3314,8472,42,6,1,5,1,1,0
2090,3318,8455,52,7,2,5,4,3,1
2091,3318,8654,48,8,2,6,0,0,0
2092,3322,9879,58,6,3,3,3,1,2
2093,3322,10261,42,11,5,6,2,1,1
2094,3326,9850,44,8,5,3,1,0,1
2095,3326,10003,56,2,1,1,0,0,0
2096,3330,10252,41,3,1,2,1,0,1
2097,3330,8650,59,16,5,11,0,0,0
2098,3332,10261,43,6,4,2,1,1,0
2099,3332,8456,57,6,3,3,3,1,2
2100,3333,8528,54,5,3,2,2,1,1
2101,3333,9850,46,9,5,4,2,1,1
2102,3336,8668,49,4,3,1,4,1,3
2103,3336,10194,51,8,2,6,2,2,0
2104,3337,8586,60,13,9,4,2,1,1
2105,3337,10003,40,0,0,0,0,0,0
2106,3340,8650,60,5,2,3,1,1,0
2107,3340,9879,40,5,1,4,1,0,1
2108,3341,8456,52,9,4,5,1,0,1
2109,3341,9798,48,1,0,1,1,0,1
2110,3342,10172,45,5,2,3,2,1,1
2111,3342,10261,55,6,0,6,2,1,1
2112,3343,8472,45,5,4,1,2,1,1
2113,3343,8466,55,6,3,3,3,1,2
2114,3348,9825,49,7,5,2,2,1,1
2115,3348,8528,51,6,1,5,0,0,0
2116,3352,8466,55,3,2,1,2,1,1
2117,3352,9879,45,0,0,0,0,0,0
2118,3355,10172,56,9,3,6,1,1,0
2119,3355,8659,44,4,1,3,0,0,0
2120,3356,10003,82,3,0,3,1,0,1
2121,3356,9798,18,1,0,1,0,0,0
2122,3357,8650,51,9,4,5,1,1,0
2123,3357,10194,49,6,3,3,2,0,2
2124,3362,9879,30,7,2,5,4,2,2
2125,3362,10260,70,7,4,3,0,0,0
2126,3363,9850,55,4,4,0,2,2,0
2127,3363,10172,45,2,0,2,1,0,1
2128,3368,8586,65,11,4,7,3,2,1
2129,3368,8659,35,7,0,7,1,0,1
2130,3370,10252,42,4,2,2,1,0,1
2131,3370,8528,58,3,0,3,0,0,0
2132,3374,8456,58,7,2,5,2,1,1
2133,3374,9850,42,4,0,4,1,0,1
2134,3375,8650,67,8,6,2,1,0,1
2135,3375,10172,33,7,3,4,0,0,0
2136,3376,8654,61,7,3,4,3,2,1
2137,3376,9798,39,0,0,0,2,1,1
2138,3380,8472,43,6,6,0,3,1,2
2139,3380,8650,57,14,7,7,1,0,1
2140,3381,8456,64,5,3,2,1,0,1
2141,3381,10194,36,1,0,1,3,0,3
2142,3382,8668,52,12,8,4,2,2,0
2143,3382,10261,48,10,0,10,2,1,1
2144,3384,10252,32,5,3,2,1,0,1
2145,3384,10003,68,11,4,7,1,0,1
2146,3386,9879,48,3,1,2,1,1,0
2147,3386,8659,52,7,0,7,0,0,0
2148,3392,8528,35,8,3,5,3,3,0
2149,3392,9879,65,4,2,2,0,0,0
2150,3394,10261,47,3,3,0,2,1,1
2151,3394,9850,53,3,1,2,0,0,0
2152,3395,8586,61,9,3,6,1,1,0
2153,3395,10172,39,2,2,0,0,0,0
2154,3396,8659,55,3,1,2,1,1,0
2155,3396,9798,45,5,1,4,1,1,0
2156,3397,10194,52,4,3,1,6,2,4
2157,3397,8455,48,6,3,3,1,1,0
2158,3398,8472,55,8,3,5,2,2,0
2159,3398,8654,45,4,1,3,0,0,0
2160,3400,9850,39,2,2,0,1,1,0
2161,3400,8650,61,8,6,2,0,0,0
2162,3405,8586,51,16,6,10,3,1,2
2163,3405,10260,49,3,1,2,0,0,0
2164,3406,8659,47,7,4,3,1,0,1
2165,3406,10252,53,5,3,2,0,0,0
2166,3407,8654,65,14,4,10,2,0,2
2167,3407,10172,35,4,1,3,1,0,1
2168,3408,8528,51,9,4,5,1,1,0
2169,3408,8472,49,7,3,4,1,0,1
2170,3409,8650,48,4,3,1,2,1,1
2171,3409,9825,52,7,4,3,3,1,2
2172,3410,10261,64,5,3,2,1,1,0
2173,3410,10252,36,8,3,5,2,0,2
2174,3414,8455,63,4,1,3,2,1,1
2175,3414,9798,37,0,0,0,0,0,0
2176,3416,10003,53,8,4,4,1,1,0
2177,3416,8472,47,1,0,1,3,1,2
2178,3417,8668,61,6,2,4,2,1,1
2179,3417,8659,39,3,1,2,1,0,1
2180,3420,8668,67,8,3,5,3,1,2
2181,3420,10252,33,0,0,0,1,0,1
2182,3421,9879,48,9,2,7,2,1,1
2183,3421,10260,52,8,5,3,1,1,0
2184,3423,10261,55,11,8,3,1,1,0
2185,3423,8455,45,6,2,4,0,0,0
2186,3424,9850,49,9,1,8,3,1,2
2187,3424,10172,51,5,0,5,2,1,1
2188,3425,8472,45,6,3,3,1,0,1
2189,3425,9798,55,3,1,2,0,0,0
2190,3426,8659,40,3,2,1,4,2,2
2191,3426,8586,60,9,2,7,2,0,2
2192,3428,8466,44,12,4,8,3,2,1
2193,3428,8528,56,2,2,0,1,1,0
2194,3429,10252,48,3,2,1,3,3,0
2195,3429,8654,52,8,1,7,4,2,2
2196,3430,8528,48,4,1,3,5,1,4
2197,3430,8455,52,8,6,2,0,0,0
2198,3431,8650,53,14,5,9,3,1,2
2199,3431,8659,47,2,0,2,1,0,1
2200,3435,10194,61,10,7,3,1,1,0
2201,3435,9798,39,3,0,3,1,1,0
2202,3438,10261,51,5,1,4,1,1,0
2203,3438,8586,49,7,1,6,1,0,1
2204,3439,9825,49,13,7,6,1,0,1
2205,3439,10252,51,4,4,0,0,0,0
2206,3441,8650,53,8,6,2,1,0,1
2207,3441,10003,47,3,2,1,2,0,2
2208,3442,8456,54,7,6,1,1,1,0
2209,3442,8455,46,4,0,4,1,0,1
2210,3443,8466,45,3,2,1,1,1,0
2211,3443,10261,55,4,3,1,4,0,4
2212,3445,10260,55,7,2,5,3,2,1
2213,3445,10172,45,5,2,3,0,0,0
2214,3446,8528,54,7,3,4,2,1,1
2215,3446,9798,46,1,0,1,1,0,1
2216,3447,8472,40,4,2,2,1,0,1
2217,3447,8659,60,3,1,2,1,0,1
2218,3448,8654,56,8,4,4,4,2,2
2219,3448,8586,44,12,4,8,3,0,3
2220,3450,8455,60,19,10,9,2,0,2
2221,3450,8659,40,5,1,4,2,0,2
2222,3453,10172,37,3,1,2,1,0,1
2223,3453,8466,63,11,5,6,0,0,0
2224,3458,8528,59,9,6,3,3,1,2
2225,3458,8650,41,3,2,1,0,0,0
2226,3461,8586,53,7,4,3,2,2,0
2227,3461,8650,47,3,3,0,2,0,2
2228,3462,8528,42,9,5,4,2,2,0
2229,3462,8456,58,5,2,3,2,1,1
2230,3464,8466,54,8,4,4,1,1,0
2231,3464,9850,46,4,4,0,0,0,0
2232,3465,10172,47,5,4,1,5,3,2
2233,3465,8472,53,2,0,2,1,0,1
2234,3468,8654,47,2,2,0,4,0,4
2235,3468,10260,53,8,1,7,1,0,1
2236,3469,8455,56,9,4,5,3,2,1
2237,3469,9798,44,3,1,2,2,1,1
2238,3470,9825,56,5,2,3,2,2,0
2239,3470,8650,44,7,2,5,1,0,1
2240,3472,10261,58,7,3,4,2,1,1
2241,3472,10252,42,8,3,5,1,0,1
2242,3475,8586,53,6,2,4,1,1,0
2243,3475,9850,47,4,2,2,4,2,2
2244,3478,8528,63,7,3,4,1,0,1
2245,3478,10194,37,9,4,5,0,0,0
2246,3479,10172,47,7,6,1,1,1,0
2247,3479,10252,53,5,1,4,1,0,1
2248,3480,8455,67,11,5,6,5,2,3
2249,3480,8654,33,9,2,7,0,0,0
2250,3481,8668,58,4,3,1,2,0,2
2251,3481,8456,42,13,3,10,2,0,2
2252,3482,10260,59,6,4,2,1,0,1
2253,3482,9798,41,3,0,3,0,0,0
2254,3487,8586,56,5,1,4,4,2,2
2255,3487,9879,44,0,0,0,1,0,1
2256,3490,8650,53,12,9,3,2,1,1
2257,3490,10252,47,6,3,3,0,0,0
2258,3493,8456,59,10,4,6,2,2,0
2259,3493,10261,41,1,0,1,5,2,3
2260,3496,8586,38,3,2,1,2,0,2
2261,3496,10003,62,4,3,1,0,0,0
2262,3497,8659,58,10,4,6,1,1,0
2263,3497,8654,42,5,2,3,1,1,0
2264,3498,9850,51,5,2,3,2,1,1
2265,3498,8528,49,4,1,3,0,0,0
2266,3499,8455,57,7,5,2,2,0,2
2267,3499,8472,43,2,2,0,0,0,0
2268,3502,10261,52,6,1,5,1,1,0
2269,3502,9879,48,3,2,1,0,0,0
2270,3503,10003,65,9,4,5,1,1,0
2271,3503,9850,35,4,1,3,3,0,3
2272,3506,10194,47,6,3,3,1,1,0
2273,3506,10252,53,5,3,2,0,0,0
2274,3509,9825,52,6,2,4,3,2,1
2275,3509,9850,48,4,0,4,3,0,3
2276,3511,8586,44,5,2,3,1,1,0
2277,3511,8455,56,6,4,2,0,0,0
2278,3516,8466,61,13,6,7,2,2,0
2279,3516,8654,39,4,3,1,2,1,1
2280,3519,9825,69,6,5,1,5,2,3
2281,3519,9879,31,6,3,3,1,1,0
2282,3521,10252,46,7,3,4,2,2,0
2283,3521,10260,54,3,0,3,1,0,1
2284,3523,10172,53,8,4,4,2,2,0
2285,3523,10194,47,7,5,2,2,0,2
2286,3524,8472,51,4,3,1,3,2,1
2287,3524,8668,49,7,3,4,0,0,0
2288,3529,9825,53,9,4,5,1,1,0
2289,3529,10260,47,5,2,3,3,0,3
2290,3530,8472,37,5,3,2,4,1,3
2291,3530,10252,63,6,3,3,0,0,0
2292,3531,8455,58,17,9,8,2,1,1
2293,3531,10003,42,6,2,4,2,1,1
2294,3532,8668,60,10,5,5,3,1,2
2295,3532,9879,40,5,4,1,0,0,0
2296,3535,9798,53,6,4,2,2,1,1
2297,3535,10172,47,5,0,5,0,0,0
2298,3536,8659,49,6,5,1,5,3,2
2299,3536,8466,51,4,3,1,1,0,1
2300,3537,10194,52,5,4,1,4,1,3
2301,3537,9850,48,1,0,1,3,2,1
2302,3540,8650,47,7,1,6,2,1,1
2303,3540,8668,53,2,0,2,1,0,1
2304,3542,9850,56,5,5,0,1,0,1
2305,3542,10252,44,5,2,3,1,0,1
2306,3544,10194,40,6,2,4,2,2,0
2307,3544,8472,60,5,1,4,0,0,0
2308,3547,8659,46,10,4,6,1,1,0
2309,3547,8528,54,5,4,1,4,0,4
2310,3548,8654,44,6,2,4,1,0,1
2311,3548,10261,56,6,4,2,1,0,1
2312,3550,8455,58,9,6,3,2,1,1
2313,3550,10252,42,7,3,4,3,1,2
2314,3551,8668,60,11,4,7,2,1,1
2315,3551,8654,40,2,1,1,1,1,0
2316,3552,8650,53,8,3,5,2,1,1
2317,3552,9879,47,6,2,4,0,0,0
2318,3553,10260,72,5,4,1,1,0,1
2319,3553,10003,28,3,0,3,0,0,0
2320,3554,9850,52,5,3,2,2,2,0
2321,3554,8659,48,6,1,5,1,1,0
2322,3559,8455,40,11,2,9,4,1,3
2323,3559,8668,60,8,3,5,1,0,1
2324,3560,8650,47,19,9,10,6,2,4
2325,3560,10172,53,4,3,1,3,1,2
2326,3561,9850,45,6,5,1,1,1,0
2327,3561,8456,55,3,1,2,1,0,1
2328,3565,8586,66,21,7,14,1,1,0
2329,3565,8472,34,5,3,2,1,1,0
2330,3567,9798,46,4,2,2,2,1,1
2331,3567,8654,54,6,2,4,1,1,0
2332,3568,10252,55,4,4,0,5,2,3
2333,3568,8528,45,8,3,5,1,0,1
2334,3569,8466,37,6,3,3,3,3,0
2335,3569,9825,63,10,5,5,1,0,1
2336,3573,10260,51,6,4,2,2,0,2
2337,3573,8528,49,4,0,4,1,0,1
2338,3575,8455,48,9,5,4,1,0,1
2339,3575,10172,52,7,2,5,0,0,0
2340,3576,8586,55,8,5,3,1,1,0
2341,3576,9798,45,1,0,1,0,0,0
2342,3577,10194,39,3,2,1,3,2,1
2343,3577,8456,61,9,3,6,2,2,0
2344,3578,8650,54,8,4,4,1,1,0
2345,3578,8472,46,3,0,3,2,2,0
2346,3579,8455,49,10,6,4,1,1,0
2347,3579,10194,51,3,2,1,6,2,4
2348,3580,8650,65,7,4,3,1,1,0
2349,3580,10260,35,4,2,2,1,1,0
2350,3581,9825,52,5,4,1,1,1,0
2351,3581,8456,48,9,5,4,2,2,0
2352,3583,8466,51,3,1,2,6,0,6
2353,3583,10252,49,3,0,3,0,0,0
2354,3584,8668,47,15,11,4,1,0,1
2355,3584,10003,53,7,1,6,0,0,0
2356,3585,10172,46,5,3,2,1,0,1
2357,3585,8586,54,11,1,10,0,0,0
2358,3590,8659,51,5,2,3,3,1,2
2359,3590,10252,49,6,2,4,3,2,1
2360,3594,8650,57,7,2,5,2,0,2
2361,3594,9850,43,7,4,3,3,0,3
2362,3596,9798,47,2,2,0,1,1,0
2363,3596,10261,53,1,0,1,0,0,0
2364,3598,8528,47,4,4,0,1,1,0
2365,3598,8472,53,2,1,1,2,1,1
2366,3601,8472,38,6,3,3,1,0,1
2367,3601,8456,62,10,2,8,0,0,0
2368,3604,10003,57,12,4,8,1,1,0
2369,3604,9798,43,11,4,7,1,1,0
2370,3608,8668,52,10,5,5,1,0,1
2371,3608,8528,48,2,1,1,1,0,1
2372,3610,9798,45,8,3,5,3,1,2
2373,3610,8650,55,6,2,4,2,1,1
2374,3611,10194,39,4,4,0,1,0,1
2375,3611,10260,61,5,3,2,0,0,0
2376,3618,8654,43,5,2,3,2,2,0
2377,3618,8466,57,3,1,2,1,0,1
2378,3621,10260,42,5,3,2,2,1,1
2379,3621,8455,58,9,6,3,0,0,0
2380,3626,8586,52,2,1,1,2,1,1
2381,3626,8466,48,5,0,5,0,0,0
2382,3627,10194,51,8,3,5,4,2,2
2383,3627,8472,49,2,1,1,1,0,1
2384,3628,8528,52,13,6,7,2,0,2
2385,3628,8654,48,6,4,2,0,0,0
2386,3629,9825,54,9,4,5,2,1,1
2387,3629,10252,46,3,1,2,1,1,0
2388,3631,9826,45,4,1,3,4,3,1
2389,3631,8586,55,6,2,4,4,1,3
2390,3632,8650,58,14,7,7,1,1,0
2391,3632,10194,42,6,2,4,2,0,2
2392,3633,8456,59,11,5,6,2,0,2
2393,3633,10261,41,2,1,1,0,0,0
2394,3634,8668,56,6,2,4,3,2,1
2395,3634,9850,44,3,2,1,1,0,1
2396,3635,9879,46,4,3,1,1,0,1
2397,3635,8472,54,8,4,4,0,0,0
2398,3636,10260,47,4,3,1,2,2,0
2399,3636,10003,53,6,3,3,2,1,1
2400,3637,8466,63,5,4,1,4,2,2
2401,3637,8659,37,7,2,5,2,1,1
2402,3641,8586,58,12,7,5,2,2,0
2403,3641,8668,42,6,1,5,2,1,1
2404,3644,9850,30,4,3,1,3,2,1
2405,3644,8456,70,13,4,9,1,1,0
2406,3645,10261,43,10,4,6,2,2,0
2407,3645,8455,57,9,5,4,5,4,1
2408,3646,10194,35,4,1,3,1,1,0
2409,3646,8466,65,3,0,3,0,0,0
2410,3647,9826,48,6,1,5,5,3,2
2411,3647,8659,52,3,1,2,0,0,0
2412,3649,10252,42,8,3,5,2,1,1
2413,3649,8344,58,3,2,1,2,0,2
2414,3651,8668,71,4,2,2,1,1,0
2415,3651,9826,29,3,1,2,0,0,0
2416,3653,10260,45,1,1,0,1,0,1
2417,3653,9825,55,5,1,4,1,0,1
2418,3654,8654,57,8,6,2,5,1,4
2419,3654,9850,43,2,0,2,2,1,1
2420,3656,8456,54,10,2,8,2,0,2
2421,3656,8472,46,2,1,1,0,0,0
2422,3657,10003,66,12,7,5,2,1,1
2423,3657,10194,34,1,0,1,2,0,2
2424,3658,10261,33,5,4,1,3,0,3
2425,3658,8586,67,19,6,13,0,0,0
2426,3660,10260,55,5,3,2,1,1,0
2427,3660,8344,45,3,1,2,1,0,1
2428,3664,8456,40,5,5,0,1,1,0
2429,3664,8586,60,6,3,3,0,0,0
2430,3665,9850,46,7,3,4,3,2,1
2431,3665,10261,54,6,3,3,0,0,0
2432,3667,10252,54,9,5,4,1,1,0
2433,3667,8659,46,2,1,1,1,0,1
2434,3668,8455,55,12,4,8,2,2,0
2435,3668,8654,45,4,2,2,0,0,0
2436,3671,8455,51,9,6,3,3,2,1
2437,3671,8466,49,4,2,2,1,0,1
2438,3672,8668,52,14,6,8,2,0,2
2439,3672,10194,48,4,1,3,0,0,0
2440,3673,8667,37,5,2,3,5,4,1
2441,3673,8650,63,6,3,3,1,0,1
2442,3674,8456,43,3,3,0,2,2,0
2443,3674,10003,57,5,4,1,2,2,0
2444,3679,9825,70,10,5,5,1,0,1
2445,3679,8667,30,4,2,2,0,0,0
2446,3680,9850,38,6,4,2,1,1,0
2447,3680,8650,62,15,7,8,1,0,1
2448,3684,8472,46,6,4,2,1,1,0
2449,3684,8455,54,7,2,5,1,0,1
2450,3685,10003,75,5,3,2,2,0,2
2451,3685,10261,25,10,6,4,0,0,0
2452,3689,9825,37,7,4,3,4,2,2
2453,3689,8668,63,4,1,3,1,0,1
2454,3691,9879,51,12,5,7,4,1,3
2455,3691,10252,49,6,2,4,0,0,0
2456,3692,8650,65,20,7,13,4,3,1
2457,3692,8654,35,6,4,2,1,0,1
2458,3693,10260,48,6,3,3,4,2,2
2459,3693,10261,52,2,2,0,0,0,0
2460,3695,8455,55,5,3,2,1,0,1
2461,3695,10194,45,2,2,0,0,0,0
2462,3696,8586,58,13,6,7,1,0,1
2463,3696,8472,42,6,2,4,0,0,0
2464,3698,8659,62,14,3,11,1,1,0
2465,3698,9850,38,1,1,0,1,0,1
2466,3700,8344,62,7,4,3,1,1,0
2467,3700,8659,38,5,1,4,3,2,1
2468,3701,8455,75,9,2,7,1,0,1
2469,3701,9826,25,6,2,4,0,0,0
2470,3702,8668,65,10,7,3,4,2,2
2471,3702,9879,35,4,1,3,1,0,1
2472,3704,8456,56,6,3,3,3,1,2
2473,3704,9825,44,4,1,3,0,0,0
2474,3705,8466,64,7,3,4,2,2,0
2475,3705,10261,36,7,2,5,0,0,0
2476,3706,9850,38,8,4,4,1,1,0
2477,3706,10003,62,5,2,3,1,0,1
2478,3710,9826,30,6,4,2,1,1,0
2479,3710,10261,70,4,1,3,0,0,0
2480,3711,9879,46,8,6,2,4,0,4
2481,3711,8456,54,11,6,5,0,0,0
2482,3712,8650,76,11,7,4,1,1,0
2483,3712,8344,24,6,2,4,0,0,0
2484,3715,10194,57,4,3,1,2,1,1
2485,3715,10252,43,8,4,4,1,0,1
2486,3716,8472,55,8,4,4,4,0,4
2487,3716,9850,45,9,6,3,0,0,0
2488,3719,9826,34,7,2,5,3,1,2
2489,3719,10252,66,5,2,3,1,0,1
2490,3722,8668,54,16,2,14,2,1,1
2491,3722,8472,46,5,3,2,0,0,0
2492,3723,8667,38,5,1,4,1,0,1
2493,3723,10260,62,5,3,2,0,0,0
2494,3724,8456,58,12,5,7,1,1,0
2495,3724,8650,42,8,3,5,2,0,2
2496,3725,10261,48,8,3,5,1,1,0
2497,3725,10194,52,4,4,0,1,0,1
2498,3729,10003,73,8,4,4,2,0,2
2499,3729,10252,27,3,1,2,1,0,1
2500,3731,8650,38,8,3,5,2,1,1
2501,3731,8455,62,5,2,3,0,0,0
2502,3733,9879,49,4,1,3,4,1,3
2503,3733,8667,51,13,6,7,2,0,2
2504,3734,8456,73,13,11,2,1,1,0
2505,3734,9826,27,4,1,3,0,0,0
2506,3735,9825,53,5,3,2,3,2,1
2507,3735,10261,47,6,4,2,6,2,4
2508,3738,8659,59,16,8,8,6,4,2
2509,3738,8654,41,6,3,3,0,0,0
2510,3740,8344,34,4,3,1,3,1,2
2511,3740,8456,66,5,2,3,2,1,1
2512,3743,9850,51,6,1,5,3,3,0
2513,3743,8667,49,1,1,0,0,0,0
2514,3744,8455,42,6,2,4,1,0,1
2515,3744,10260,58,7,1,6,0,0,0
2516,3745,8654,45,3,1,2,2,2,0
2517,3745,10261,55,3,0,3,0,0,0
2518,3746,8466,57,9,2,7,2,2,0
2519,3746,8472,43,3,0,3,3,1,2
2520,3748,8586,51,9,6,3,2,2,0
2521,3748,10003,49,5,3,2,0,0,0
2522,3750,9850,60,4,2,2,1,1,0
2523,3750,9826,40,6,2,4,1,0,1
2524,3755,10194,40,5,4,1,1,0,1
2525,3755,8668,60,8,1,7,0,0,0
2526,3757,10003,46,6,3,3,2,0,2
2527,3757,8456,54,5,1,4,2,0,2
2528,3758,8659,33,5,2,3,1,1,0
2529,3758,10261,67,6,3,3,4,2,2
2530,3759,9825,72,4,1,3,1,0,1
2531,3759,10252,28,6,1,5,0,0,0
2532,3760,8654,43,2,2,0,2,1,1
2533,3760,8344,57,10,2,8,1,0,1
2534,3761,9850,32,7,4,3,2,0,2
2535,3761,8668,68,7,4,3,1,0,1
2536,3762,9879,52,5,2,3,3,1,2
2537,3762,8472,48,3,2,1,0,0,0
2538,3763,8667,34,5,4,1,5,2,3
2539,3763,8455,66,7,4,3,0,0,0
2540,3765,8456,45,6,1,5,4,1,3
2541,3765,10261,55,7,2,5,0,0,0
2542,3767,10194,43,8,3,5,1,1,0
2543,3767,8650,57,5,1,4,0,0,0
2544,3768,8586,63,3,3,0,2,1,1
2545,3768,9826,37,3,3,0,1,1,0
2546,3769,9825,53,12,5,7,1,1,0
2547,3769,9879,47,6,2,4,3,1,2
2548,3770,10260,54,5,4,1,1,0,1
2549,3770,8455,46,4,2,2,0,0,0
2550,3771,10194,56,8,5,3,4,2,2
2551,3771,9826,44,6,2,4,1,0,1
2552,3772,10252,51,4,3,1,3,1,2
2553,3772,8650,49,5,1,4,1,0,1
2554,3773,8456,66,7,4,3,1,1,0
2555,3773,8344,34,6,1,5,0,0,0
2556,3775,8466,69,14,8,6,1,0,1
2557,3775,8472,31,9,1,8,0,0,0
2558,3778,10261,53,10,6,4,1,0,1
2559,3778,8654,47,4,3,1,0,0,0
2560,3779,8659,52,3,1,2,4,4,0
2561,3779,10252,48,4,2,2,3,1,2
2562,3780,8667,62,6,3,3,1,1,0
2563,3780,9826,38,3,2,1,1,0,1
2564,3781,8650,43,8,6,2,1,1,0
2565,3781,8668,57,15,6,9,2,1,1
2566,3783,10261,59,12,9,3,2,2,0
2567,3783,9850,41,4,1,3,0,0,0
2568,3784,8466,57,10,3,7,3,2,1
2569,3784,9825,43,2,1,1,0,0,0
2570,3785,8472,47,8,2,6,3,2,1
2571,3785,10194,53,8,3,5,2,0,2
2572,3786,10003,62,7,3,4,3,1,2
2573,3786,9879,38,7,6,1,2,1,1
2574,3787,8654,30,1,1,0,1,0,1
2575,3787,8455,70,19,6,13,0,0,0
2576,3788,8586,40,2,1,1,2,2,0
2577,3788,8456,60,8,3,5,0,0,0
2578,3789,9825,75,5,3,2,2,1,1
2579,3789,9826,25,4,1,3,0,0,0
2580,3790,8344,57,6,3,3,4,1,3
2581,3790,9850,43,7,1,6,0,0,0
2582,3792,9879,34,4,4,0,4,2,2
2583,3792,8466,66,6,2,4,1,1,0
2584,3793,8586,66,8,3,5,1,1,0
2585,3793,8667,34,3,0,3,0,0,0
2586,3794,8455,33,7,5,2,1,1,0
2587,3794,8456,67,8,3,5,0,0,0
2588,3795,10261,49,15,5,10,4,4,0
2589,3795,8472,51,5,3,2,0,0,0
2590,3797,8650,51,6,1,5,2,1,1
2591,3797,8659,49,5,1,4,3,2,1
2592,3798,10003,55,7,2,5,1,1,0
2593,3798,8654,45,2,2,0,0,0,0
2594,3799,8659,67,10,2,8,3,1,2
2595,3799,9826,33,4,2,2,0,0,0
2596,3800,10252,60,4,3,1,1,1,0
2597,3800,8654,40,5,4,1,1,1,0
2598,3802,8650,45,8,2,6,3,1,2
2599,3802,9825,55,6,0,6,0,0,0
2600,3805,10194,48,1,1,0,2,1,1
2601,3805,8466,52,7,3,4,2,0,2
2602,3809,10260,49,2,1,1,2,1,1
2603,3809,9825,51,11,6,5,0,0,0
2604,3811,8466,65,9,3,6,2,2,0
2605,3811,8667,35,5,3,2,1,1,0
2606,3812,10194,34,3,3,0,1,1,0
2607,3812,10003,66,7,2,5,0,0,0
2608,3813,8455,67,6,1,5,1,1,0
2609,3813,8659,33,2,0,2,1,0,1
2610,3814,9850,43,7,4,3,2,1,1
2611,3814,8654,57,7,4,3,0,0,0
2612,3816,9879,35,5,2,3,3,1,2
2613,3816,8650,65,6,3,3,1,0,1
2614,3818,8586,58,6,2,4,2,1,1
2615,3818,10261,42,8,3,5,2,2,0
2616,3819,9825,74,6,4,2,2,0,2
2617,3819,8472,26,2,0,2,0,0,0
2618,3820,8344,61,13,9,4,1,0,1
2619,3820,8667,39,2,1,1,0,0,0
2620,3821,8455,46,14,8,6,4,2,2
2621,3821,8668,54,7,5,2,1,0,1
2622,3826,9850,47,7,3,4,2,2,0
2623,3826,8586,53,4,1,3,3,1,2
2624,3827,8659,59,11,2,9,1,1,0
2625,3827,9879,41,2,1,1,1,1,0
2626,3828,8654,34,2,2,0,2,1,1
2627,3828,8466,66,6,0,6,3,0,3
2628,3830,8668,77,5,3,2,2,0,2
2629,3830,8654,23,1,0,1,2,0,2
2630,3832,10261,51,7,2,5,1,1,0
2631,3832,8667,49,5,3,2,0,0,0
2632,3834,8466,60,7,2,5,3,2,1
2633,3834,8650,40,3,1,2,1,0,1
2634,3836,8472,56,4,2,2,2,0,2
2635,3836,8659,44,8,3,5,1,0,1
2636,3837,9826,16,4,1,3,1,1,0
2637,3837,10003,84,4,2,2,1,0,1
2638,3838,8586,63,8,4,4,2,1,1
2639,3838,8344,37,5,2,3,3,2,1
2640,3841,8586,55,3,2,1,3,1,2
2641,3841,8455,45,2,0,2,1,0,1
2642,3842,8466,68,6,5,1,2,1,1
2643,3842,9826,32,3,2,1,0,0,0
2644,3843,8650,66,7,1,6,1,1,0
2645,3843,8472,34,5,2,3,2,0,2
2646,3844,8456,71,9,4,5,3,0,3
2647,3844,10252,29,1,0,1,0,0,0
2648,3852,9826,55,6,3,3,1,1,0
2649,3852,8472,45,7,6,1,1,0,1
2650,3857,10003,59,7,2,5,4,1,3
2651,3857,8659,41,5,3,2,1,0,1
2652,3858,10194,59,5,5,0,2,1,1
2653,3858,8654,41,3,3,0,0,0,0
2654,3859,8659,33,7,2,5,1,1,0
2655,3859,10003,67,7,4,3,4,1,3
2656,3860,8455,63,7,4,3,2,1,1
2657,3860,10252,37,5,3,2,1,1,0
2658,3861,8668,65,12,6,6,1,1,0
2659,3861,8344,35,5,3,2,1,0,1
2660,3863,8667,48,7,2,5,2,1,1
2661,3863,8456,52,1,0,1,2,1,1
2662,3865,8466,65,4,2,2,2,0,2
2663,3865,9850,35,2,1,1,2,0,2
2664,3868,8586,62,8,3,5,3,1,2
2665,3868,9825,38,2,1,1,1,0,1
2666,3870,8344,29,3,2,1,1,1,0
2667,3870,8650,71,6,4,2,2,0,2
2668,3871,9825,45,8,4,4,2,1,1
2669,3871,8455,55,9,6,3,1,0,1
2670,3872,10003,58,11,5,6,2,0,2
2671,3872,8668,42,3,0,3,0,0,0
2672,3873,8667,46,3,2,1,0,0,0
2673,3873,8659,54,7,3,4,0,0,0
2674,3875,10261,72,10,7,3,2,1,1
2675,3875,9826,28,3,2,1,1,0,1
2676,3876,9850,63,7,4,3,1,0,1
2677,3876,8472,37,6,2,4,0,0,0
2678,3877,8586,47,4,3,1,1,1,0
2679,3877,8466,53,4,3,1,2,1,1
2680,3878,10260,51,5,4,1,2,1,1
2681,3878,8654,49,5,4,1,1,0,1
2682,3879,8456,59,8,2,6,2,1,1
2683,3879,9825,41,3,0,3,0,0,0
2684,3880,8455,67,11,4,7,1,0,1
2685,3880,9826,33,5,2,3,1,0,1
2686,3881,8668,59,9,3,6,2,1,1
2687,3881,9879,41,12,6,6,2,1,1
2688,3883,10260,59,4,1,3,2,1,1
2689,3883,10252,41,2,1,1,1,0,1
2690,3885,10194,57,8,2,6,4,1,3
2691,3885,8667,43,4,1,3,0,0,0
2692,3886,8472,62,10,2,8,1,1,0
2693,3886,8654,38,5,1,4,0,0,0
2694,3889,10252,54,4,1,3,1,0,1
2695,3889,9879,46,10,4,6,0,0,0
2696,3890,9826,32,7,3,4,1,1,0
2697,3890,8344,68,6,3,3,2,1,1
2698,3891,8455,55,8,7,1,1,0,1
2699,3891,10194,45,3,1,2,0,0,0
2700,3895,10261,51,6,3,3,1,1,0
2701,3895,10260,49,0,0,0,3,1,2
2702,3896,8659,30,5,4,1,2,0,2
2703,3896,9850,70,4,4,0,0,0,0
2704,3898,8654,43,2,2,0,1,0,1
2705,3898,8650,57,7,1,6,1,0,1
2706,3899,8654,36,3,3,0,2,2,0
2707,3899,9825,64,6,4,2,1,0,1
2708,3900,10252,56,5,2,3,2,1,1
2709,3900,9826,44,3,1,2,0,0,0
2710,3902,8650,55,1,1,0,2,0,2
2711,3902,8456,45,6,3,3,1,0,1
2712,3903,10260,62,9,1,8,1,1,0
2713,3903,8667,38,1,0,1,1,0,1
2714,3905,10261,43,7,4,3,2,2,0
2715,3905,10194,57,2,0,2,0,0,0
2716,3906,8668,58,9,5,4,2,1,1
2717,3906,8472,42,14,5,9,1,0,1
2718,3907,10003,49,5,4,1,1,1,0
2719,3907,8455,51,8,3,5,2,0,2
2720,3908,8659,33,2,2,0,1,1,0
2721,3908,8586,67,9,3,6,2,1,1
2722,3909,8466,72,4,4,0,1,0,1
2723,3909,10252,28,4,0,4,0,0,0
2724,3910,8344,45,5,4,1,2,2,0
2725,3910,10194,55,6,2,4,1,1,0
2726,3911,8455,60,23,12,11,1,1,0
2727,3911,8472,40,1,1,0,1,0,1
2728,3912,10260,66,7,2,5,1,0,1
2729,3912,8668,34,8,4,4,0,0,0
2730,3913,8667,41,6,3,3,3,2,1
2731,3913,9825,59,5,3,2,0,0,0
2732,3916,8650,67,4,2,2,3,0,3
2733,3916,9850,33,7,4,3,0,0,0
2734,3917,9879,42,4,2,2,1,1,0
2735,3917,8586,58,4,3,1,1,1,0
2736,3918,8654,67,7,4,3,1,1,0
2737,3918,9826,33,8,4,4,2,2,0
2738,3920,9826,43,2,1,1,1,0,1
2739,3920,8456,57,5,1,4,0,0,0
2740,3922,8455,30,7,4,3,1,0,1
2741,3922,8650,70,18,6,12,0,0,0
2742,3923,10260,70,12,7,5,1,1,0
2743,3923,9850,30,4,0,4,1,0,1
2744,3927,10252,55,3,3,0,4,2,2
2745,3927,10003,45,5,1,4,0,0,0
2746,3928,8654,56,6,5,1,2,1,1
2747,3928,8659,44,10,3,7,1,1,0
2748,3929,8659,33,2,2,0,2,0,2
2749,3929,9825,67,5,4,1,0,0,0
2750,3930,8667,51,5,2,3,1,1,0
2751,3930,10252,49,5,3,2,0,0,0
2752,3931,8455,66,13,7,6,1,1,0
2753,3931,9850,34,2,0,2,2,2,0
2754,3933,8456,46,7,4,3,3,2,1
2755,3933,8668,54,1,0,1,0,0,0
2756,3934,10260,61,4,2,2,1,1,0
2757,3934,8472,39,1,0,1,1,0,1
2758,3935,10261,60,10,5,5,1,1,0
2759,3935,8344,40,5,1,4,4,2,2
2760,3938,8654,47,9,3,6,1,1,0
2761,3938,8586,53,6,3,3,2,1,1
2762,3939,8455,62,12,5,7,1,1,0
2763,3939,8344,38,5,3,2,0,0,0
2764,3940,9879,70,6,4,2,1,1,0
2765,3940,9826,30,7,4,3,0,0,0
2766,3943,8456,77,14,6,8,2,0,2
2767,3943,8654,23,0,0,0,1,0,1
2768,3947,8586,57,8,8,0,2,0,2
2769,3947,10252,43,2,1,1,0,0,0
2770,3950,8668,48,4,2,2,2,1,1
2771,3950,8455,52,8,3,5,1,1,0
2772,3951,8659,35,5,3,2,4,3,1
2773,3951,9879,65,2,0,2,2,0,2
2774,3953,10260,59,10,2,8,1,1,0
2775,3953,9826,41,0,0,0,3,1,2
2776,3956,8472,31,6,2,4,5,2,3
2777,3956,9825,69,9,8,1,1,0,1
2778,3957,10003,37,9,6,3,1,0,1
2779,3957,8650,63,5,3,2,1,0,1
2780,3961,9879,37,2,1,1,2,1,1
2781,3961,8455,63,12,5,7,0,0,0
2782,3963,8650,57,8,5,3,1,1,0
2783,3963,8466,43,8,1,7,1,1,0
2784,3964,8456,55,3,2,1,2,2,0
2785,3964,10260,45,3,0,3,2,0,2
2786,3965,10261,59,5,4,1,3,2,1
2787,3965,8667,41,7,5,2,0,0,0
2788,3966,10252,37,3,2,1,1,1,0
2789,3966,9850,63,3,0,3,1,1,0
2790,3969,8456,66,9,3,6,2,1,1
2791,3969,10252,34,1,0,1,1,0,1
2792,3973,10260,61,10,7,3,1,1,0
2793,3973,8659,39,2,0,2,1,0,1
2794,3975,9850,51,4,3,1,1,1,0
2795,3975,10194,49,3,0,3,0,0,0
2796,3976,8650,47,7,1,6,2,1,1
2797,3976,8472,53,10,6,4,2,1,1
2798,3977,9825,40,3,1,2,3,0,3
2799,3977,10003,60,3,0,3,1,0,1
2800,3978,8586,47,3,2,1,1,0,1
2801,3978,8455,53,7,2,5,0,0,0
2802,3981,10252,59,8,4,4,2,2,0
2803,3981,8667,41,2,1,1,3,1,2
2804,3983,8456,57,6,2,4,1,1,0
2805,3983,8668,43,4,1,3,2,0,2
2806,3984,8455,52,12,3,9,2,1,1
2807,3984,9850,48,7,4,3,0,0,0
2808,3985,10003,48,9,6,3,2,2,0
2809,3985,8466,52,5,5,0,1,1,0
2810,3986,10260,65,5,3,2,2,1,1
2811,3986,8472,35,4,3,1,0,0,0
2812,3987,8586,58,7,1,6,3,2,1
2813,3987,8654,42,5,0,5,1,0,1
2814,3988,8659,41,4,2,2,1,0,1
2815,3988,9825,59,4,2,2,0,0,0
2816,3989,9825,57,8,4,4,2,1,1
2817,3989,9850,43,6,4,2,0,0,0
2818,3990,8586,69,7,3,4,3,1,2
2819,3990,10252,31,7,3,4,1,0,1
2820,3991,8455,77,9,4,5,3,2,1
2821,3991,8344,23,6,1,5,1,0,1
2822,3993,8667,31,2,2,0,1,1,0
2823,3993,8668,69,7,5,2,3,1,2
2824,3994,8466,48,9,4,5,3,3,0
2825,3994,10260,52,6,3,3,1,0,1
2826,3995,10261,46,4,4,0,1,1,0
2827,3995,8650,54,6,3,3,0,0,0
2828,3997,10003,64,8,4,4,3,1,2
2829,3997,8472,36,3,1,2,2,0,2
2830,3998,8456,67,11,5,6,2,1,1
2831,3998,8654,33,0,0,0,3,1,2
2832,3999,8668,56,10,8,2,1,1,0
2833,3999,10252,44,9,4,5,1,1,0
2834,4000,8455,42,3,2,1,2,0,2
2835,4000,8456,58,9,4,5,0,0,0
2836,4001,9826,29,6,3,3,1,1,0
2837,4001,9825,71,4,2,2,0,0,0
2838,4004,8344,37,7,4,3,2,1,1
2839,4004,9850,63,17,10,7,2,2,0
2840,4006,10261,52,7,2,5,2,0,2
2841,4006,8472,48,5,1,4,0,0,0
2842,4007,8586,65,7,5,2,3,2,1
2843,4007,8667,35,7,6,1,1,0,1
2844,4008,8654,35,7,4,3,2,2,0
2845,4008,10003,65,8,3,5,2,0,2
2846,4009,9825,74,7,4,3,1,1,0
2847,4009,9826,26,3,1,2,1,0,1
2848,4012,8650,59,4,2,2,4,1,3
2849,4012,8466,41,5,2,3,0,0,0
2850,4014,8456,56,7,4,3,1,1,0
2851,4014,10261,44,5,0,5,1,1,0
2852,4015,10172,49,11,5,6,1,1,0
2853,4015,8667,51,5,0,5,0,0,0
2854,4017,8659,65,4,3,1,2,2,0
2855,4017,8472,35,0,0,0,0,0,0
2856,4021,10172,39,5,1,4,2,2,0
2857,4021,8455,61,9,4,5,2,0,2
2858,4022,8472,53,5,4,1,3,0,3
2859,4022,9826,47,8,0,8,2,0,2
2860,4023,8668,70,7,5,2,2,1,1
2861,4023,10003,30,4,3,1,0,0,0
2862,4024,8667,44,3,2,1,1,1,0
2863,4024,8466,56,3,1,2,1,1,0
2864,4029,8667,39,2,2,0,3,1,2
2865,4029,8191,61,10,7,3,5,3,2
2866,4030,8650,57,7,3,4,1,1,0
2867,4030,8455,43,9,7,2,1,1,0
2868,4031,10260,73,9,5,4,3,2,1
2869,4031,9826,27,2,0,2,0,0,0
2870,4032,8456,61,13,5,8,3,2,1
2871,4032,10172,39,10,5,5,1,1,0
2872,4033,8466,64,8,4,4,2,1,1
2873,4033,8197,36,1,0,1,0,0,0
2874,4034,8668,56,8,6,2,1,0,1
2875,4034,8472,44,5,3,2,2,0,2
2876,4036,8586,58,6,4,2,1,0,1
2877,4036,10194,42,5,3,2,1,0,1
2878,4037,8659,55,4,4,0,1,1,0
2879,4037,10261,45,1,0,1,0,0,0
2880,4038,8654,60,14,7,7,1,0,1
2881,4038,10252,40,6,5,1,0,0,0
2882,4039,9825,55,13,6,7,1,1,0
2883,4039,10260,45,1,0,1,0,0,0
2884,4040,10252,35,4,3,1,2,1,1
2885,4040,8466,65,9,4,5,0,0,0
2886,4041,8455,74,12,9,3,1,0,1
2887,4041,8659,26,1,1,0,0,0,0
2888,4043,8668,63,5,4,1,2,1,1
2889,4043,8654,37,6,2,4,0,0,0
2890,4044,8586,64,12,6,6,1,1,0
2891,4044,8667,36,2,2,0,0,0,0
2892,4045,8197,42,6,2,4,2,1,1
2893,4045,8472,58,8,3,5,0,0,0
2894,4046,8456,61,11,4,7,2,0,2
2895,4046,10003,39,3,0,3,0,0,0
2896,4047,10261,51,10,5,5,5,4,1
2897,4047,10172,49,9,5,4,0,0,0
2898,4048,8191,32,2,1,1,2,2,0
2899,4048,10194,68,6,4,2,2,0,2
2900,4049,8191,49,7,4,3,5,1,4
2901,4049,10252,51,14,10,4,0,0,0
2902,4050,10194,51,10,2,8,1,1,0
2903,4050,8650,49,7,0,7,1,1,0
2904,4051,10260,76,5,3,2,1,1,0
2905,4051,8667,24,3,1,2,0,0,0
2906,4053,8456,55,4,2,2,3,1,2
2907,4053,8466,45,8,2,6,1,1,0
2908,4054,8472,35,9,4,5,2,0,2
2909,4054,8455,65,15,6,9,0,0,0
2910,4055,10003,64,5,2,3,2,2,0
2911,4055,9826,36,5,2,3,2,1,1
2912,4056,8668,57,6,3,3,1,0,1
2913,4056,8586,43,6,3,3,0,0,0
2914,4058,8654,48,5,2,3,3,2,1
2915,4058,10261,52,1,0,1,1,1,0
2916,4059,9825,54,10,3,7,2,2,0
2917,4059,8466,46,3,1,2,0,0,0
2918,4060,8191,49,4,2,2,3,2,1
2919,4060,10261,51,5,2,3,0,0,0
2920,4061,8650,55,4,3,1,2,1,1
2921,4061,8197,45,11,3,8,1,0,1
2922,4062,10260,61,1,1,0,2,2,0
2923,4062,10194,39,3,0,3,2,1,1
2924,4063,10003,52,11,7,4,1,0,1
2925,4063,10172,48,2,1,1,0,0,0
2926,4064,9826,36,11,9,2,1,1,0
2927,4064,10252,64,2,1,1,1,0,1
2928,4065,8659,45,12,4,8,1,0,1
2929,4065,8654,55,10,8,2,1,0,1
2930,4066,8586,55,4,2,2,1,1,0
2931,4066,8455,45,6,4,2,2,0,2
2932,4067,8667,35,3,2,1,2,2,0
2933,4067,8668,65,7,5,2,1,0,1
2934,4068,8472,31,7,3,4,3,2,1
2935,4068,8456,69,1,0,1,1,1,0
2936,4069,8197,28,4,2,2,3,1,2
2937,4069,10252,72,8,2,6,2,1,1
2938,4070,8659,59,3,1,2,4,1,3
2939,4070,8667,41,4,1,3,1,1,0
2940,4072,8456,57,16,8,8,2,2,0
2941,4072,8668,43,6,1,5,0,0,0
2942,4073,8455,58,11,5,6,1,1,0
2943,4073,10261,42,3,2,1,2,1,1
2944,4074,10172,59,9,6,3,2,2,0
2945,4074,8191,41,5,3,2,1,0,1
2946,4075,8466,52,5,2,3,1,0,1
2947,4075,10260,48,0,0,0,3,0,3
2948,4076,9825,53,7,3,4,2,1,1
2949,4076,10194,47,3,2,1,1,1,0
2950,4077,9826,33,8,4,4,5,3,2
2951,4077,8586,67,5,3,2,0,0,0
2952,4078,8654,62,9,6,3,2,1,1
2953,4078,10003,38,5,1,4,0,0,0
2954,4079,10261,41,8,4,4,1,1,0
2955,4079,9825,59,3,0,3,0,0,0
2956,4080,8191,44,4,2,2,1,1,0
2957,4080,8466,56,4,1,3,2,1,1
2958,4081,8667,39,1,1,0,2,1,1
2959,4081,8455,61,6,0,6,0,0,0
2960,4082,10194,57,4,2,2,1,0,1
2961,4082,9826,43,5,1,4,0,0,0
2962,4083,10172,37,6,2,4,1,1,0
2963,4083,8668,63,7,3,4,3,0,3
2964,4085,8650,45,11,5,6,2,1,1
2965,4085,10260,55,5,0,5,1,1,0
2966,4086,8654,44,12,6,6,3,0,3
2967,4086,8472,56,8,2,6,0,0,0
2968,4087,10003,52,7,2,5,1,1,0
2969,4087,8586,48,3,0,3,1,0,1
2970,4089,10260,64,11,4,7,2,1,1
2971,4089,10252,36,6,1,5,1,0,1
2972,4090,10003,45,4,1,3,1,0,1
2973,4090,8667,55,6,2,4,0,0,0
2974,4091,8650,64,12,3,9,1,1,0
2975,4091,9825,36,4,1,3,0,0,0
2976,4092,9826,31,1,1,0,3,1,2
2977,4092,8456,69,3,1,2,1,0,1
2978,4093,10261,48,9,3,6,2,1,1
2979,4093,8472,52,4,3,1,1,0,1
2980,4094,8659,53,6,4,2,1,1,0
2981,4094,10172,47,8,2,6,1,0,1
2982,4095,8668,55,7,1,6,1,0,1
2983,4095,8466,45,3,1,2,0,0,0
2984,4096,10194,45,6,2,4,1,1,0
2985,4096,8455,55,9,0,9,0,0,0
2986,4097,8586,69,10,3,7,2,1,1
2987,4097,8191,31,5,0,5,0,0,0
2988,4098,8654,54,4,4,0,2,1,1
2989,4098,8197,46,8,3,5,0,0,0
2990,4099,9825,69,5,3,2,1,0,1
2991,4099,10172,31,6,0,6,0,0,0
2992,4100,8191,52,4,2,2,2,1,1
2993,4100,8650,48,6,3,3,0,0,0
2994,4101,8455,73,11,6,5,3,1,2
2995,4101,8654,27,0,0,0,2,1,1
2996,4102,9826,45,7,5,2,3,1,2
2997,4102,8466,55,4,1,3,0,0,0
2998,4105,10261,32,4,3,1,1,0,1
2999,4105,10260,68,2,1,1,0,0,0
3000,4106,8667,54,5,2,3,1,1,0
3001,4106,8472,46,5,1,4,1,1,0
3002,4108,8456,56,2,2,0,3,3,0
3003,4108,8659,44,9,2,7,1,0,1
3004,4109,10252,62,6,2,4,3,1,2
3005,4109,8472,38,7,2,5,0,0,0
3006,4110,8667,62,11,4,7,3,3,0
3007,4110,8197,38,1,1,0,0,0,0
3008,4111,8650,47,10,6,4,4,4,0
3009,4111,10003,53,4,1,3,0,0,0
3010,4113,10261,56,9,4,5,1,0,1
3011,4113,8668,44,1,1,0,0,0,0
3012,4114,10172,51,8,4,4,2,2,0
3013,4114,9826,49,4,1,3,0,0,0
3014,4115,8455,58,5,1,4,2,2,0
3015,4115,8466,42,1,1,0,1,0,1
3016,4116,10194,56,7,4,3,5,2,3
3017,4116,8659,44,6,4,2,5,2,3
3018,4117,8586,46,7,3,4,3,1,2
3019,4117,10260,54,7,6,1,3,1,2
3020,4118,9825,45,14,4,10,1,1,0
3021,4118,8654,55,7,4,3,0,0,0
3022,4119,10252,43,4,3,1,3,2,1
3023,4119,10261,57,4,2,2,0,0,0
3024,4120,8455,55,14,3,11,3,1,2
3025,4120,8197,45,5,2,3,0,0,0
3026,4121,9826,39,7,3,4,1,1,0
3027,4121,8654,61,7,6,1,3,1,2
3028,4122,9825,46,4,2,2,1,0,1
3029,4122,8668,54,2,1,1,0,0,0
3030,4123,8667,45,5,4,1,3,2,1
3031,4123,10194,55,4,0,4,2,2,0
3032,4124,8650,47,6,3,3,3,1,2
3033,4124,8456,53,1,1,0,1,0,1
3034,4125,8466,61,3,2,1,3,2,1
3035,4125,8659,39,3,0,3,0,0,0
3036,4126,8472,46,4,2,2,2,1,1
3037,4126,10260,54,4,0,4,1,0,1
3038,4127,10003,62,6,4,2,1,1,0
3039,4127,8191,38,7,1,6,1,0,1
3040,4129,10252,73,7,5,2,1,1,0
3041,4129,9826,27,2,0,2,2,2,0
3042,4130,8668,59,5,2,3,4,3,1
3043,4130,8667,41,9,5,4,4,1,3
3044,4131,8197,37,5,1,4,1,0,1
3045,4131,8650,63,7,1,6,0,0,0
3046,4132,8456,67,18,8,10,4,3,1
3047,4132,8472,33,2,1,1,1,0,1
3048,4135,9825,59,7,5,2,2,1,1
3049,4135,8466,41,5,3,2,1,1,0
3050,4136,10194,35,4,1,3,2,1,1
3051,4136,10260,65,2,0,2,1,0,1
3052,4137,8586,48,4,2,2,1,1,0
3053,4137,8455,52,7,2,5,0,0,0
3054,4138,8659,57,4,2,2,3,2,1
3055,4138,8654,43,3,2,1,1,1,0
3056,4139,9825,53,4,3,1,3,1,2
3057,4139,10194,47,2,1,1,1,0,1
3058,4140,8191,49,5,1,4,1,1,0
3059,4140,10172,51,8,2,6,0,0,0
3060,4141,10261,36,6,4,2,2,1,1
3061,4141,8455,64,4,1,3,0,0,0
3062,4142,8586,62,4,1,3,2,1,1
3063,4142,9826,38,12,2,10,4,2,2
3064,4143,8668,39,7,4,3,1,0,1
3065,4143,8456,61,7,4,3,0,0,0
3066,4144,10252,59,5,1,4,4,0,4
3067,4144,8197,41,5,0,5,1,0,1
3068,4145,10260,58,1,1,0,1,1,0
3069,4145,8466,42,1,0,1,1,0,1
3070,4146,8650,52,7,2,5,1,1,0
3071,4146,8472,48,2,0,2,0,0,0
3072,4147,10003,59,11,6,5,1,1,0
3073,4147,8654,41,7,1,6,0,0,0
3074,4148,8667,52,5,3,2,2,1,1
3075,4148,8659,48,3,2,1,0,0,0
3076,4149,10252,45,5,2,3,1,1,0
3077,4149,8650,55,7,2,5,0,0,0
3078,4151,8668,72,9,5,4,1,1,0
3079,4151,8659,28,2,1,1,1,1,0
3080,4153,9825,35,2,1,1,3,1,2
3081,4153,8456,65,6,0,6,1,0,1
3082,4155,10260,66,9,4,5,1,1,0
3083,4155,10172,34,7,4,3,2,0,2
3084,4156,10003,47,3,2,1,1,0,1
3085,4156,8455,53,7,3,4,1,0,1
3086,4157,8472,37,4,1,3,2,0,2
3087,4157,8586,63,14,5,9,1,0,1
3088,4159,10252,52,4,2,2,3,2,1
3089,4159,9825,48,3,1,2,0,0,0
3090,4160,8456,53,4,2,2,3,1,2
3091,4160,8455,47,1,1,0,2,0,2
3092,4161,9826,51,7,5,2,2,1,1
3093,4161,8668,49,5,1,4,3,1,2
3094,4162,8667,51,9,3,6,2,1,1
3095,4162,10261,49,3,2,1,0,0,0
3096,4163,8650,67,10,6,4,2,1,1
3097,4163,8654,33,4,3,1,2,1,1
3098,4164,10260,76,7,3,4,1,1,0
3099,4164,8197,24,0,0,0,1,1,0
3100,4165,8466,67,10,2,8,3,3,0
3101,4165,10003,33,2,0,2,1,0,1
3102,4166,10194,57,2,1,1,3,2,1
3103,4166,10172,43,5,1,4,0,0,0
3104,4167,8472,52,4,2,2,3,1,2
3105,4167,8191,48,4,1,3,1,0,1
3106,4168,8586,65,6,4,2,1,0,1
3107,4168,8659,35,7,4,3,1,0,1
3108,4169,8455,48,5,3,2,2,1,1
3109,4169,10252,52,1,0,1,1,1,0
3110,4170,8191,55,7,2,5,1,1,0
3111,4170,8659,45,4,2,2,0,0,0
3112,4172,9826,40,6,2,4,1,1,0
3113,4172,8197,60,12,6,6,0,0,0
3114,4173,8667,29,3,2,1,1,1,0
3115,4173,8456,71,10,4,6,1,1,0
3116,4174,10261,38,3,3,0,2,1,1
3117,4174,10194,62,4,1,3,1,0,1
3118,4177,8586,63,10,4,6,1,0,1
3119,4177,9825,37,4,0,4,0,0,0
3120,4179,8197,47,5,1,4,2,2,0
3121,4179,9825,53,10,8,2,0,0,0
3122,4181,10260,57,4,1,3,6,2,4
3123,4181,8191,43,3,2,1,1,1,0
3124,4182,8466,62,11,2,9,1,1,0
3125,4182,8654,38,4,3,1,4,1,3
3126,4184,8650,48,8,6,2,2,1,1
3127,4184,8586,52,8,4,4,0,0,0
3128,4187,8456,52,4,1,3,1,1,0
3129,4187,10194,48,3,3,0,2,0,2
3130,4188,10172,53,7,4,3,6,5,1
3131,4188,8472,47,8,1,7,1,1,0
3132,4189,10194,48,6,4,2,4,2,2
3133,4189,10252,52,2,1,1,2,1,1
3134,4191,9826,46,9,2,7,2,0,2
3135,4191,9825,54,7,3,4,0,0,0
3136,4192,8197,42,7,5,2,3,1,2
3137,4192,8668,58,5,2,3,0,0,0
3138,4193,8667,45,4,2,2,1,0,1
3139,4193,10172,55,3,2,1,2,0,2
3140,4194,10261,43,2,1,1,4,4,0
3141,4194,8456,57,4,1,3,1,0,1
3142,4195,8466,58,13,7,6,1,1,0
3143,4195,8650,42,2,0,2,0,0,0
3144,4196,8659,39,2,2,0,1,1,0
3145,4196,8472,61,6,2,4,3,1,2
3146,4197,10003,41,5,2,3,2,2,0
3147,4197,10260,59,7,2,5,0,0,0
3148,4199,8668,55,5,1,4,5,2,3
3149,4199,9825,45,7,4,3,1,0,1
3150,4200,8191,44,7,4,3,2,1,1
3151,4200,10003,56,3,1,2,0,0,0
3152,4201,8455,60,5,4,1,6,5,1
3153,4201,8197,40,2,2,0,1,0,1
3154,4202,8650,43,3,3,0,2,1,1
3155,4202,8456,57,0,0,0,2,0,2
3156,4203,8472,27,2,2,0,5,2,3
3157,4203,10260,73,11,4,7,1,0,1
3158,4204,10252,47,6,3,3,1,0,1
3159,4204,10261,53,5,1,4,0,0,0
3160,4205,10172,33,11,7,4,3,2,1
3161,4205,8586,67,6,3,3,2,0,2
3162,4206,10194,54,10,8,2,1,1,0
3163,4206,8667,46,2,0,2,0,0,0
3164,4207,8659,37,3,3,0,4,3,1
3165,4207,8466,63,3,1,2,0,0,0
3166,4208,9826,39,4,4,0,4,2,2
3167,4208,8654,61,5,0,5,0,0,0
3168,4209,10252,56,7,3,4,1,0,1
3169,4209,8659,44,1,1,0,0,0,0
3170,4210,8667,44,7,3,4,3,1,2
3171,4210,8472,56,3,0,3,1,1,0
3172,4212,8466,68,7,3,4,2,1,1
3173,4212,9826,32,7,2,5,0,0,0
3174,4213,8654,40,12,2,10,2,2,0
3175,4213,8455,60,7,2,5,1,1,0
3176,4214,8650,65,11,6,5,2,1,1
3177,4214,8191,35,4,2,2,3,1,2
3178,4215,8456,73,13,8,5,3,2,1
3179,4215,8197,27,4,2,2,5,1,4
3180,4216,10260,68,5,2,3,1,0,1
3181,4216,10261,32,2,0,2,1,0,1
3182,4217,10194,44,4,2,2,2,0,2
3183,4217,8668,56,7,3,4,2,0,2
3184,4218,8586,60,10,8,2,2,1,1
3185,4218,10003,40,4,0,4,2,1,1
3186,4219,9825,74,8,6,2,3,2,1
3187,4219,8654,26,2,1,1,1,1,0
3188,4220,8456,70,12,4,8,1,0,1
3189,4220,8191,30,2,1,1,1,0,1
3190,4221,8455,56,9,1,8,3,1,2
3191,4221,8466,44,6,4,2,0,0,0
3192,4222,10172,49,4,0,4,2,0,2
3193,4222,9826,51,2,0,2,0,0,0
3194,4223,10261,49,8,5,3,5,3,2
3195,4223,8668,51,9,4,5,1,1,0
3196,4224,8667,47,6,3,3,1,0,1
3197,4224,8197,53,8,2,6,1,0,1
3198,4225,10260,59,2,1,1,2,2,0
3199,4225,8586,41,2,0,2,2,1,1
3200,4226,10252,57,5,3,2,2,0,2
3201,4226,8472,43,4,0,4,1,0,1
3202,4227,8650,40,6,2,4,1,1,0
3203,4227,10003,60,8,5,3,0,0,0
3204,4228,8659,49,9,3,6,4,2,2
3205,4228,10194,51,4,1,3,0,0,0
3206,4229,10252,56,2,1,1,2,1,1
3207,4229,8667,44,2,0,2,0,0,0
3208,4230,8191,42,4,3,1,2,0,2
3209,4230,10260,58,4,1,3,0,0,0
3210,4231,8668,58,10,4,6,2,1,1
3211,4231,8455,42,5,2,3,2,1,1
3212,4234,9826,31,5,1,4,2,1,1
3213,4234,10261,69,4,2,2,2,1,1
3214,4235,10172,46,5,3,2,1,1,0
3215,4235,8472,54,8,2,6,0,0,0
3216,4236,10003,64,6,2,4,1,1,0
3217,4236,8659,36,7,1,6,1,0,1
3218,4237,8650,49,6,2,4,2,1,1
3219,4237,8586,51,3,1,2,2,1,1
3220,4238,8654,35,2,2,0,3,0,3
3221,4238,8466,65,9,2,7,1,0,1
3222,4239,10003,61,8,4,4,2,1,1
3223,4239,10252,39,7,3,4,1,0,1
3224,4240,8667,48,9,6,3,3,1,2
3225,4240,8455,52,4,0,4,0,0,0
3226,4241,10260,61,3,2,1,5,3,2
3227,4241,8650,39,2,1,1,2,1,1
3228,4242,8456,80,20,12,8,3,0,3
3229,4242,8659,20,0,0,0,2,0,2
3230,4244,8668,53,3,3,0,3,1,2
3231,4244,10172,47,4,2,2,5,2,3
3232,4245,8191,38,4,4,0,1,1,0
3233,4245,8466,62,8,3,5,2,1,1
3234,4246,9826,47,3,1,2,2,1,1
3235,4246,10194,53,6,1,5,2,0,2
3236,4247,8197,27,3,2,1,2,1,1
3237,4247,8586,73,2,1,1,0,0,0
3238,4248,8472,43,4,2,2,1,1,0
3239,4248,8654,57,8,2,6,0,0,0
3240,4249,9825,60,6,2,4,2,1,1
3241,4249,8650,40,4,1,3,0,0,0
3242,4250,8191,40,9,4,5,2,2,0
3243,4250,8586,60,5,3,2,2,0,2
3244,4251,8455,61,11,5,6,2,1,1
3245,4251,10194,39,2,0,2,1,0,1
3246,4252,8456,73,10,5,5,2,1,1
3247,4252,9826,27,1,1,0,0,0,0
3248,4253,8466,54,5,3,2,2,1,1
3249,4253,8668,46,5,5,0,2,0,2
3250,4254,8654,54,8,5,3,4,3,1
3251,4254,8197,46,6,2,4,2,0,2
3252,4255,10260,72,8,7,1,1,1,0
3253,4255,10252,28,2,2,0,0,0,0
3254,4256,8472,65,10,6,4,3,1,2
3255,4256,10261,35,4,1,3,2,0,2
3256,4260,8650,59,9,5,4,1,0,1
3257,4260,10261,41,4,2,2,2,0,2
3258,4261,8456,42,4,3,1,1,1,0
3259,4261,10260,58,6,1,5,5,3,2
3260,4262,10172,38,10,3,7,1,0,1
3261,4262,8455,62,3,2,1,0,0,0
3262,4264,9826,48,8,5,3,2,1,1
3263,4264,8472,52,3,1,2,0,0,0
3264,4265,10003,51,3,2,1,3,1,2
3265,4265,8668,49,8,4,4,0,0,0
3266,4266,10252,42,3,1,2,2,1,1
3267,4266,8586,58,5,3,2,2,1,1
3268,4271,8455,33,4,2,2,1,1,0
3269,4271,10260,67,5,0,5,3,1,2
3270,4272,9826,67,6,3,3,5,2,3
3271,4272,8659,33,2,0,2,3,1,2
3272,4274,8650,65,12,5,7,3,0,3
3273,4274,8667,35,5,4,1,1,0,1
3274,4276,8456,65,11,4,7,2,2,0
3275,4276,8654,35,7,4,3,0,0,0
3276,4277,10261,35,7,3,4,3,0,3
3277,4277,8586,65,7,2,5,0,0,0
3278,4278,10194,51,4,2,2,3,2,1
3279,4278,8466,49,8,2,6,1,0,1
3280,4279,8455,37,4,3,1,2,1,1
3281,4279,9825,63,4,2,2,3,0,3
3282,4280,8191,49,11,5,6,1,1,0
3283,4280,8197,51,4,2,2,0,0,0
3284,4281,9826,44,4,3,1,2,0,2
3285,4281,8667,56,7,4,3,0,0,0
3286,4282,10260,61,12,6,6,1,0,1
3287,4282,8668,39,5,3,2,0,0,0
3288,4283,8456,42,6,3,3,1,1,0
3289,4283,10252,58,4,2,2,1,1,0
3290,4284,10003,52,3,2,1,1,0,1
3291,4284,10261,48,1,0,1,0,0,0
3292,4285,10172,54,9,2,7,1,0,1
3293,4285,8654,46,3,2,1,0,0,0
3294,4286,8466,40,4,2,2,4,3,1
3295,4286,8586,60,3,1,2,0,0,0
3296,4287,10194,70,14,7,7,2,2,0
3297,4287,8472,30,6,0,6,3,2,1
3298,4288,8650,77,13,3,10,3,3,0
3299,4288,8659,23,4,0,4,2,2,0
3300,4291,9825,67,13,5,8,1,1,0
3301,4291,8667,33,2,1,1,2,0,2
3302,4292,8197,42,7,2,5,3,2,1
3303,4292,10261,58,5,2,3,1,1,0
3304,4293,8650,66,10,4,6,2,1,1
3305,4293,10172,34,3,1,2,3,1,2
3306,4294,8659,22,3,2,1,3,2,1
3307,4294,10260,78,15,5,10,3,0,3
3308,4295,8472,45,6,5,1,1,1,0
3309,4295,8466,55,3,1,2,5,3,2
3310,4298,8191,39,4,2,2,1,1,0
3311,4298,8654,61,14,3,11,1,1,0
3312,4300,10252,64,6,5,1,1,0,1
3313,4300,8654,36,3,1,2,0,0,0
3314,4301,8650,44,5,3,2,1,1,0
3315,4301,8455,56,4,3,1,1,1,0
3316,4302,10260,65,7,4,3,2,1,1
3317,4302,9826,35,5,1,4,0,0,0
3318,4304,8667,44,13,2,11,4,2,2
3319,4304,8191,56,2,1,1,0,0,0
3320,4305,8466,71,5,3,2,1,0,1
3321,4305,8197,29,3,2,1,0,0,0
3322,4306,8456,65,9,3,6,1,1,0
3323,4306,10172,35,4,1,3,1,0,1
3324,4309,8191,41,6,5,1,2,2,0
3325,4309,10194,59,5,2,3,0,0,0
3326,4310,8650,64,8,4,4,3,2,1
3327,4310,9826,36,5,1,4,0,0,0
3328,4311,10260,62,7,4,3,1,1,0
3329,4311,9825,38,4,0,4,1,1,0
3330,4312,10172,48,3,1,2,2,2,0
3331,4312,10261,52,17,7,10,0,0,0
3332,4313,8466,40,9,7,2,2,1,1
3333,4313,10252,60,4,1,3,1,1,0
3334,4314,8472,54,7,4,3,1,1,0
3335,4314,8197,46,4,2,2,0,0,0
3336,4315,10003,53,7,2,5,2,1,1
3337,4315,8456,47,11,3,8,1,0,1
3338,4316,8667,35,4,1,3,2,1,1
3339,4316,8586,65,2,0,2,3,2,1
3340,4317,8659,41,3,2,1,1,1,0
3341,4317,8455,59,7,4,3,1,0,1
3342,4318,8668,58,8,2,6,1,1,0
3343,4318,8654,42,7,5,2,0,0,0
3344,4319,9825,67,11,9,2,2,2,0
3345,4319,8659,33,7,1,6,1,0,1
3346,4320,8191,38,4,3,1,3,1,2
3347,4320,10252,62,7,4,3,2,1,1
3348,4321,8455,63,12,6,6,1,1,0
3349,4321,8472,37,9,3,6,1,0,1
3350,4324,8667,34,8,2,6,2,2,0
3351,4324,10260,66,4,2,2,0,0,0
3352,4325,8197,40,3,2,1,2,1,1
3353,4325,10172,60,6,2,4,1,0,1
3354,4326,8466,41,8,3,5,3,2,1
3355,4326,8456,59,7,5,2,0,0,0
3356,4328,10194,44,5,4,1,2,0,2
3357,4328,8650,56,8,1,7,1,0,1
3358,4329,9825,48,4,2,2,4,1,3
3359,4329,8456,52,8,3,5,1,1,0
3360,4330,8455,48,13,7,6,1,0,1
3361,4330,10003,52,3,2,1,0,0,0
3362,4331,9826,43,3,2,1,5,3,2
3363,4331,8191,57,7,3,4,1,0,1
3364,4332,8654,56,11,6,5,5,1,4
3365,4332,8667,44,6,2,4,0,0,0
3366,4333,10252,28,2,2,0,2,2,0
3367,4333,8650,72,6,1,5,0,0,0
3368,4334,10260,67,8,2,6,1,1,0
3369,4334,10172,33,4,1,3,0,0,0
3370,4335,8466,46,3,1,2,3,2,1
3371,4335,10261,54,4,2,2,0,0,0
3372,4336,10194,65,9,2,7,2,1,1
3373,4336,8197,35,0,0,0,0,0,0
3374,4337,8586,71,10,8,2,1,0,1
3375,4337,8472,29,3,1,2,0,0,0
3376,4338,8659,46,8,4,4,2,1,1
3377,4338,8668,54,4,1,3,1,1,0
3378,4339,10252,35,4,3,1,1,0,1
3379,4339,9825,65,4,3,1,0,0,0
3380,4340,8191,41,5,3,2,3,1,2
3381,4340,8472,59,7,4,3,0,0,0
3382,4341,9826,25,4,3,1,1,1,0
3383,4341,8668,75,6,2,4,0,0,0
3384,4342,10260,55,5,3,2,1,1,0
3385,4342,8197,45,2,0,2,1,1,0
3386,4343,8456,60,6,2,4,3,1,2
3387,4343,8455,40,3,1,2,0,0,0
3388,4344,10261,64,12,6,6,3,1,2
3389,4344,8667,36,2,1,1,0,0,0
3390,4345,10172,58,9,4,5,1,1,0
3391,4345,10194,42,3,1,2,1,1,0
3392,4348,8654,45,8,7,1,1,0,1
3393,4348,8650,55,7,1,6,0,0,0
3394,4349,9825,66,15,8,7,2,0,2
3395,4349,8586,34,6,5,1,1,0,1
3396,4350,8455,60,8,4,4,1,0,1
3397,4350,10252,40,2,1,1,0,0,0
3398,4351,8197,64,4,1,3,1,0,1
3399,4351,9826,36,7,5,2,2,0,2
3400,4352,8456,63,7,3,4,2,0,2
3401,4352,8667,37,4,1,3,1,0,1
3402,4353,8650,51,14,11,3,2,1,1
3403,4353,8668,49,6,3,3,0,0,0
3404,4354,10260,63,3,2,1,1,1,0
3405,4354,8654,37,1,0,1,3,0,3
3406,4355,8466,55,7,3,4,3,1,2
3407,4355,10172,45,0,0,0,3,2,1
3408,4356,10261,60,4,3,1,3,2,1
3409,4356,10194,40,6,1,5,3,2,1
3410,4357,8472,36,5,4,1,1,1,0
3411,4357,10003,64,1,0,1,3,1,2
3412,4358,8191,33,7,3,4,3,2,1
3413,4358,8659,67,10,7,3,3,1,2
3414,4360,8455,52,3,2,1,2,0,2
3415,4360,9825,48,3,0,3,2,0,2
3416,4361,8667,61,7,3,4,1,0,1
3417,4361,9826,39,5,1,4,0,0,0
3418,4364,10260,51,4,3,1,2,2,0
3419,4364,8668,49,6,1,5,1,0,1
3420,4366,10003,58,4,2,2,3,1,2
3421,4366,10261,42,3,0,3,0,0,0
3422,4367,8586,49,5,4,1,4,0,4
3423,4367,8466,51,5,3,2,2,0,2
3424,4368,8654,52,5,2,3,3,2,1
3425,4368,10172,48,5,1,4,0,0,0
3426,4369,8667,31,3,1,2,1,1,0
3427,4369,9825,69,13,6,7,0,0,0
3428,4370,8191,46,2,1,1,3,1,2
3429,4370,8654,54,2,0,2,0,0,0
3430,4371,9826,25,3,2,1,1,0,1
3431,4371,8455,75,5,3,2,0,0,0
3432,4372,8668,65,10,6,4,2,0,2
3433,4372,10252,35,6,2,4,1,0,1
3434,4373,8586,37,12,6,6,2,1,1
3435,4373,8456,63,11,4,7,2,1,1
3436,4375,10172,47,9,4,5,2,0,2
3437,4375,8650,53,6,1,5,0,0,0
3438,4376,8472,56,3,1,2,3,2,1
3439,4376,8466,44,4,0,4,0,0,0
3440,4377,10003,60,7,3,4,1,1,0
3441,4377,10194,40,6,5,1,0,0,0
3442,4378,8659,41,2,1,1,2,0,2
3443,4378,10260,59,11,4,7,0,0,0
3444,4382,10252,59,10,7,3,1,0,1
3445,4382,10172,41,3,1,2,1,0,1
3446,4383,8466,67,5,5,0,3,1,2
3447,4383,10194,33,2,2,0,0,0,0
3448,4384,9825,62,5,1,4,2,1,1
3449,4384,8472,38,4,0,4,0,0,0
3450,4387,9826,31,7,5,2,2,2,0
3451,4387,8659,69,7,2,5,0,0,0
3452,4388,8456,67,9,4,5,1,0,1
3453,4388,8654,33,4,2,2,1,0,1
3454,4389,9825,56,15,6,9,2,0,2
3455,4389,8654,44,5,3,2,2,0,2
3456,4392,9817,34,6,3,3,3,1,2
3457,4392,8668,66,4,3,1,1,0,1
3458,4393,8472,57,5,3,2,2,2,0
3459,4393,8197,43,8,5,3,0,0,0
3460,4394,8586,49,6,3,3,3,3,0
3461,4394,10260,51,6,5,1,0,0,0
3462,4396,9826,37,6,4,2,1,1,0
3463,4396,9850,63,7,2,5,1,0,1
3464,4400,10252,48,4,2,2,1,1,0
3465,4400,10003,52,3,0,3,2,0,2
3466,4401,8586,56,7,2,5,6,2,4
3467,4401,8678,44,4,2,2,0,0,0
3468,4402,8197,51,5,4,1,3,1,2
3469,4402,9826,49,5,2,3,1,0,1
3470,4404,8456,42,3,1,2,5,3,2
3471,4404,10260,58,1,0,1,1,0,1
3472,4406,9817,30,7,3,4,1,1,0
3473,4406,10194,70,2,2,0,0,0,0
3474,4407,10261,67,13,8,5,2,0,2
3475,4407,8472,33,4,2,2,1,0,1
3476,4408,8455,63,5,3,2,2,0,2
3477,4408,8654,37,6,3,3,2,0,2
3478,4409,8650,64,8,4,4,1,1,0
3479,4409,8455,36,5,0,5,2,1,1
3480,4410,9826,39,9,6,3,1,0,1
3481,4410,10260,61,3,1,2,0,0,0
3482,4411,8668,75,4,4,0,4,2,2
3483,4411,8472,25,11,4,7,0,0,0
3484,4412,8456,70,8,5,3,3,2,1
3485,4412,9850,30,4,2,2,2,1,1
3486,4414,8466,68,3,3,0,1,1,0
3487,4414,8678,32,6,1,5,1,1,0
3488,4415,9825,46,3,2,1,1,1,0
3489,4415,10003,54,7,3,4,2,0,2
3490,4416,10252,33,6,2,4,1,1,0
3491,4416,8586,67,8,1,7,2,0,2
3492,4418,8197,57,5,5,0,3,3,0
3493,4418,8659,43,7,1,6,2,0,2
3494,4421,8678,65,12,8,4,1,1,0
3495,4421,10261,35,0,0,0,0,0,0
3496,4424,10260,76,5,3,2,3,2,1
3497,4424,8659,24,1,1,0,1,0,1
3498,4425,9850,29,4,1,3,2,1,1
3499,4425,10003,71,1,1,0,2,2,0
3500,4428,8668,53,7,6,1,2,2,0
3501,4428,8654,47,6,1,5,1,0,1
3502,4429,9850,40,3,2,1,2,1,1
3503,4429,8455,60,11,6,5,2,0,2
3504,4430,9826,64,10,3,7,1,1,0
3505,4430,8472,36,5,1,4,0,0,0
3506,4431,8668,65,9,3,6,3,2,1
3507,4431,10252,35,8,1,7,0,0,0
3508,4432,8456,62,5,1,4,1,0,1
3509,4432,8650,38,9,2,7,0,0,0
3510,4435,10003,41,7,4,3,1,0,1
3511,4435,8678,59,6,3,3,0,0,0
3512,4437,10260,62,6,1,5,1,0,1
3513,4437,9817,38,7,0,7,2,0,2
3514,4438,9825,65,6,1,5,5,0,5
3515,4438,8659,35,1,1,0,0,0,0
3516,4439,10252,68,6,6,0,2,1,1
3517,4439,9817,32,9,5,4,2,0,2
3518,4440,8678,48,12,3,9,1,0,1
3519,4440,8668,52,5,2,3,1,0,1
3520,4441,10261,44,3,2,1,1,0,1
3521,4441,9826,56,7,2,5,0,0,0
3522,4442,10260,68,6,4,2,1,1,0
3523,4442,8197,32,3,1,2,0,0,0
3524,4443,8650,57,6,2,4,1,1,0
3525,4443,10003,43,2,0,2,2,0,2
3526,4445,9825,66,3,1,2,1,0,1
3527,4445,9850,34,2,1,1,1,0,1
3528,4447,8586,59,7,5,2,1,1,0
3529,4447,8455,41,1,0,1,1,1,0
3530,4448,8654,60,8,3,5,1,1,0
3531,4448,8659,40,5,0,5,1,0,1
3532,4449,8472,28,5,1,4,3,2,1
3533,4449,9825,72,8,1,7,3,3,0
3534,4450,8455,60,11,6,5,4,2,2
3535,4450,8678,40,7,5,2,3,0,3
3536,4452,8654,39,5,2,3,2,2,0
3537,4452,10260,61,7,3,4,0,0,0
3538,4454,8466,60,7,4,3,2,1,1
3539,4454,10252,40,2,1,1,0,0,0
3540,4455,8456,61,4,2,2,3,1,2
3541,4455,10194,39,2,0,2,2,1,1
3542,4457,9817,57,8,2,6,1,1,0
3543,4457,9850,43,2,0,2,0,0,0
3544,4458,8659,39,6,2,4,1,1,0
3545,4458,8586,61,6,1,5,1,0,1
3546,4459,10252,41,7,2,5,1,1,0
3547,4459,9825,59,4,2,2,1,0,1
3548,4460,8678,40,4,3,1,2,2,0
3549,4460,10260,60,6,3,3,1,0,1
3550,4461,8466,54,7,4,3,3,2,1
3551,4461,9826,46,10,3,7,0,0,0
3552,4462,8197,39,4,3,1,3,2,1
3553,4462,8455,61,8,1,7,2,0,2
3554,4463,8650,66,15,6,9,2,1,1
3555,4463,8659,34,2,2,0,2,1,1
3556,4465,8668,57,4,1,3,1,1,0
3557,4465,9850,43,1,0,1,0,0,0
3558,4466,9817,58,8,4,4,2,2,0
3559,4466,8472,42,2,0,2,0,0,0
3560,4468,8654,44,21,8,13,1,1,0
3561,4468,10194,56,4,0,4,0,0,0
3562,4469,8456,60,10,3,7,1,1,0
3563,4469,9825,40,3,0,3,1,0,1
3564,4471,8668,68,8,3,5,3,3,0
3565,4471,8197,32,1,0,1,4,0,4
3566,4473,10261,51,4,2,2,3,2,1
3567,4473,10252,49,6,2,4,0,0,0
3568,4474,8466,48,10,4,6,2,1,1
3569,4474,8586,52,6,2,4,1,0,1
3570,4475,10194,53,11,2,9,4,2,2
3571,4475,9826,47,4,0,4,0,0,0
3572,4477,8650,64,8,2,6,4,2,2
3573,4477,9817,36,3,2,1,0,0,0
3574,4478,8678,73,7,3,4,4,3,1
3575,4478,8659,27,3,0,3,0,0,0
3576,4480,9826,46,4,1,3,1,1,0
3577,4480,8678,54,8,3,5,0,0,0
3578,4481,8455,66,8,3,5,1,0,1
3579,4481,9817,34,8,3,5,1,0,1
3580,4482,8650,65,13,12,1,1,0,1
3581,4482,8197,35,3,1,2,0,0,0
3582,4483,8472,46,4,2,2,4,2,2
3583,4483,8456,54,8,4,4,2,0,2
3584,4485,8466,38,5,1,4,2,1,1
3585,4485,9825,62,5,3,2,2,0,2
3586,4486,10260,53,8,4,4,2,1,1
3587,4486,10194,47,4,3,1,2,2,0
3588,4487,10003,63,1,1,0,2,1,1
3589,4487,8659,37,4,1,3,1,0,1
3590,4488,9850,49,4,3,1,1,0,1
3591,4488,8586,51,9,4,5,0,0,0
3592,4492,8456,63,12,6,6,4,2,2
3593,4492,8197,37,5,2,3,2,2,0
3594,4493,8455,32,3,1,2,1,1,0
3595,4493,10260,68,6,3,3,2,1,1
3596,4494,10252,47,4,2,2,3,2,1
3597,4494,9850,53,3,1,2,1,0,1
3598,4495,8650,66,8,5,3,1,1,0
3599,4495,8472,34,3,1,2,0,0,0
3600,4496,9817,44,5,2,3,3,0,3
3601,4496,8586,56,3,0,3,0,0,0
3602,4497,8659,54,15,10,5,1,1,0
3603,4497,10261,46,4,2,2,1,1,0
3604,4498,8654,52,4,1,3,3,2,1
3605,4498,8466,48,5,3,2,4,2,2
3606,4499,10260,56,3,1,2,1,1,0
3607,4499,10252,44,2,0,2,1,0,1
3608,4501,8650,61,4,2,2,3,1,2
3609,4501,8678,39,5,0,5,0,0,0
3610,4502,8456,48,9,4,5,1,0,1
3611,4502,8455,52,7,2,5,1,0,1
3612,4507,9817,62,10,4,6,2,1,1
3613,4507,8659,38,1,1,0,2,0,2
3614,4510,9826,39,5,2,3,1,1,0
3615,4510,8455,61,5,2,3,0,0,0
3616,4511,8586,66,11,7,4,3,1,2
3617,4511,8668,34,8,1,7,0,0,0
3618,4512,8678,59,4,1,3,3,1,2
3619,4512,8197,41,6,1,5,0,0,0
3620,4513,10260,56,10,6,4,4,1,3
3621,4513,10003,44,5,2,3,0,0,0
3622,4514,8466,58,5,5,0,1,1,0
3623,4514,9850,42,3,0,3,2,0,2
3624,4516,9817,46,3,1,2,5,3,2
3625,4516,8456,54,6,3,3,2,1,1
3626,4517,10194,58,9,8,1,4,2,2
3627,4517,8659,42,6,1,5,1,1,0
3628,4518,8654,39,6,1,5,4,2,2
3629,4518,8650,61,12,6,6,0,0,0
3630,4520,8654,48,3,2,1,3,2,1
3631,4520,8678,52,7,3,4,2,0,2
3632,4521,10003,61,6,2,4,4,2,2
3633,4521,8472,39,2,1,1,0,0,0
3634,4522,8650,53,11,4,7,3,2,1
3635,4522,9825,47,4,2,2,3,2,1
3636,4523,8659,37,5,2,3,2,1,1
3637,4523,8455,63,6,3,3,0,0,0
3638,4524,8668,49,4,2,2,3,1,2
3639,4524,8456,51,12,2,10,2,0,2
3640,4525,10260,46,3,1,2,1,0,1
3641,4525,10261,54,6,1,5,0,0,0
3642,4527,10194,55,5,3,2,2,2,0
3643,4527,9850,45,1,1,0,2,0,2
3644,4528,8586,66,12,6,6,2,1,1
3645,4528,8197,34,5,1,4,1,1,0
3646,4529,8197,44,6,4,2,1,1,0
3647,4529,10252,56,8,3,5,1,1,0
3648,4530,8678,53,6,1,5,1,0,1
3649,4530,9850,47,7,3,4,1,0,1
3650,4531,8668,49,5,3,2,4,2,2
3651,4531,8455,51,10,2,8,2,1,1
3652,4535,8466,62,5,4,1,1,0,1
3653,4535,8659,38,2,1,1,1,0,1
3654,4536,10194,46,8,2,6,3,2,1
3655,4536,9825,54,6,2,4,1,0,1
3656,4537,9817,33,5,3,2,2,1,1
3657,4537,10003,67,3,2,1,3,1,2
3658,4542,8197,47,4,3,1,3,2,1
3659,4542,10194,53,4,2,2,0,0,0
3660,4543,10260,56,3,2,1,2,2,0
3661,4543,8466,44,1,0,1,1,0,1
3662,4546,10261,43,2,2,0,1,1,0
3663,4546,9817,57,4,3,1,2,0,2
3664,4547,8659,37,1,1,0,4,2,2
3665,4547,10252,63,8,4,4,1,0,1
3666,4548,8456,52,12,1,11,2,1,1
3667,4548,8654,48,2,1,1,0,0,0
3668,4550,8197,43,7,6,1,2,1,1
3669,4550,8650,57,9,5,4,2,1,1
3670,4551,8586,61,6,6,0,1,0,1
3671,4551,9850,39,3,1,2,0,0,0
3672,4552,8472,41,6,2,4,2,2,0
3673,4552,8456,59,2,1,1,3,1,2
3674,4554,10252,35,2,1,1,1,1,0
3675,4554,8654,65,3,1,2,2,1,1
3676,4557,8659,44,7,2,5,5,2,3
3677,4557,10003,56,8,3,5,0,0,0
3678,4558,8668,64,6,2,4,3,1,2
3679,4558,10261,36,4,0,4,1,0,1
3680,4559,9850,41,8,2,6,1,0,1
3681,4559,10252,59,1,0,1,1,0,1
3682,4560,9825,57,6,3,3,3,2,1
3683,4560,8678,43,11,5,6,0,0,0
3684,4561,10260,61,12,7,5,4,1,3
3685,4561,8455,39,10,3,7,0,0,0
3686,4562,8650,82,6,3,3,5,2,3
3687,4562,8472,18,1,0,1,1,0,1
3688,4563,8197,28,5,3,2,4,1,3
3689,4563,8456,72,8,3,5,1,0,1
3690,4564,10261,77,11,6,5,1,1,0
3691,4564,8659,23,1,1,0,2,0,2
3692,4566,10194,66,7,2,5,1,1,0
3693,4566,8668,34,6,0,6,1,1,0
3694,4567,10003,61,8,2,6,2,1,1
3695,4567,9826,39,2,0,2,2,0,2
3696,4569,8197,33,3,2,1,1,1,0
3697,4569,9825,67,10,1,9,1,1,0
3698,4570,8650,60,3,2,1,2,1,1
3699,4570,10252,40,3,1,2,2,2,0
3700,4571,10194,35,3,3,0,1,1,0
3701,4571,8678,65,5,2,3,1,0,1
3702,4572,10261,54,5,4,1,2,0,2
3703,4572,8455,46,8,5,3,1,0,1
3704,4574,8668,75,17,9,8,2,0,2
3705,4574,8659,25,1,0,1,0,0,0
3706,4575,8456,36,6,1,5,1,0,1
3707,4575,8586,64,1,1,0,0,0,0
3708,4576,8654,48,5,1,4,1,1,0
3709,4576,9850,52,3,0,3,0,0,0
3710,4577,8472,30,9,2,7,1,0,1
3711,4577,10260,70,8,3,5,2,0,2
3712,4578,8466,46,10,6,4,2,1,1
3713,4578,10003,54,6,2,4,0,0,0
3714,4580,8650,62,21,11,10,1,0,1
3715,4580,8668,38,1,1,0,0,0,0
3716,4581,9825,54,6,3,3,3,2,1
3717,4581,10260,46,3,1,2,1,1,0
3718,4582,10261,44,2,1,1,3,0,3
3719,4582,8456,56,5,0,5,1,0,1
3720,4583,8455,64,5,2,3,1,0,1
3721,4583,8466,36,4,1,3,0,0,0
3722,4585,10003,41,6,3,3,1,1,0
3723,4585,8586,59,15,7,8,0,0,0
3724,4587,8659,47,3,2,1,2,2,0
3725,4587,9826,53,5,2,3,1,0,1
3726,4588,8472,36,6,1,5,1,0,1
3727,4588,8654,64,2,1,1,1,0,1
3728,4590,10252,40,7,5,2,1,0,1
3729,4590,8668,60,4,2,2,1,0,1
3730,4592,8197,59,11,6,5,2,2,0
3731,4592,8659,41,0,0,0,1,1,0
3732,4593,8455,56,5,4,1,2,2,0
3733,4593,9850,44,3,0,3,1,0,1
3734,4594,9826,39,7,3,4,2,1,1
3735,4594,8472,61,8,5,3,3,1,2
3736,4595,8586,63,3,1,2,1,0,1
3737,4595,8654,37,7,5,2,0,0,0
3738,4596,8650,54,5,2,3,2,1,1
3739,4596,8456,46,2,1,1,5,2,3
3740,4597,9817,36,5,4,1,3,1,2
3741,4597,10260,64,7,1,6,0,0,0
3742,4598,10261,36,4,3,1,2,1,1
3743,4598,10194,64,2,1,1,2,0,2
3744,4600,9826,37,8,3,5,2,1,1
3745,4600,8650,63,8,2,6,1,0,1
3746,4602,8456,77,7,5,2,1,1,0
3747,4602,10252,23,2,1,1,4,1,3
3748,4603,8678,55,10,3,7,1,0,1
3749,4603,10261,45,7,2,5,0,0,0
3750,4604,8466,58,9,4,5,2,1,1
3751,4604,8472,42,3,0,3,3,0,3
3752,4605,9850,42,6,2,4,2,1,1
3753,4605,10003,58,5,0,5,2,1,1
3754,4609,8650,37,8,5,3,3,3,0
3755,4609,9825,63,10,2,8,0,0,0
3756,4611,8456,55,10,7,3,2,1,1
3757,4611,8668,45,4,1,3,1,1,0
3758,4612,8586,73,8,4,4,1,1,0
3759,4612,8197,27,5,3,2,3,1,2
3760,4613,10260,62,16,9,7,2,0,2
3761,4613,10261,38,3,3,0,0,0,0
3762,4614,9850,40,10,3,7,1,1,0
3763,4614,10194,60,2,0,2,1,1,0
3764,4615,8472,38,6,3,3,1,1,0
3765,4615,10003,62,12,3,9,6,1,5
3766,4616,9817,52,6,1,5,2,2,0
3767,4616,8466,48,7,2,5,2,1,1
3768,4617,8455,63,3,2,1,1,1,0
3769,4617,8659,37,6,0,6,3,2,1
3770,4618,8678,52,4,3,1,3,2,1
3771,4618,8654,48,5,1,4,0,0,0
3772,4619,9825,72,7,2,5,2,1,1
3773,4619,8659,28,2,0,2,0,0,0
3774,4620,8586,57,8,6,2,3,0,3
3775,4620,10252,43,6,2,4,0,0,0
3776,4621,8678,42,5,3,2,1,0,1
3777,4621,10003,58,3,0,3,0,0,0
3778,4622,10261,44,4,2,2,1,1,0
3779,4622,8197,56,3,0,3,1,0,1
3780,4623,8650,54,17,9,8,1,0,1
3781,4623,8455,46,9,4,5,0,0,0
3782,4624,10260,53,12,7,5,2,1,1
3783,4624,9826,47,4,1,3,2,1,1
3784,4625,8456,61,11,6,5,3,2,1
3785,4625,9850,39,0,0,0,2,2,0
3786,4626,10194,62,5,2,3,4,2,2
3787,4626,8466,38,5,3,2,2,1,1
3788,4627,8472,43,8,5,3,3,3,0
3789,4627,8668,57,9,0,9,0,0,0
3790,4628,8654,49,7,3,4,2,0,2
3791,4628,9817,51,3,3,0,0,0,0
3792,4629,8455,55,6,2,4,2,1,1
3793,4629,8654,45,5,1,4,1,0,1
3794,4630,9826,48,8,4,4,1,0,1
3795,4630,8197,52,4,2,2,0,0,0
3796,4631,9825,55,4,2,2,1,1,0
3797,4631,8668,45,5,3,2,3,2,1
3798,4632,8456,54,6,3,3,2,1,1
3799,4632,10260,46,4,1,3,2,0,2
3800,4633,8472,47,5,3,2,1,0,1
3801,4633,10261,53,9,1,8,0,0,0
3802,4634,8650,51,12,8,4,2,1,1
3803,4634,8466,49,4,2,2,0,0,0
3804,4636,8586,69,6,3,3,1,0,1
3805,4636,8678,31,0,0,0,0,0,0
3806,4637,9817,49,3,1,2,5,2,3
3807,4637,10194,51,5,2,3,1,0,1
3808,4639,9825,68,10,7,3,1,0,1
3809,4639,9817,32,3,1,2,0,0,0
3810,4640,10252,44,9,6,3,2,1,1
3811,4640,8455,56,4,1,3,0,0,0
3812,4641,8456,55,4,2,2,2,0,2
3813,4641,8678,45,5,2,3,0,0,0
3814,4642,8197,54,6,1,5,1,0,1
3815,4642,8466,46,4,2,2,0,0,0
3816,4643,8650,48,10,6,4,2,0,2
3817,4643,8586,52,7,3,4,1,0,1
3818,4644,8668,51,7,2,5,1,1,0
3819,4644,10260,49,5,3,2,0,0,0
3820,4645,9850,44,3,3,0,1,1,0
3821,4645,10261,56,6,0,6,2,0,2
3822,4646,10003,49,5,2,3,3,1,2
3823,4646,10194,51,4,2,2,2,0,2
3824,4647,8659,53,1,1,0,1,1,0
3825,4647,8472,47,9,4,5,1,0,1
3826,4648,9826,38,4,1,3,2,1,1
3827,4648,8654,62,8,5,3,0,0,0
3828,4649,8678,61,4,3,1,1,0,1
3829,4649,10252,39,0,0,0,3,0,3
3830,4650,9850,44,6,2,4,3,3,0
3831,4650,9826,56,5,2,3,0,0,0
3832,4651,10194,49,2,1,1,1,0,1
3833,4651,8650,51,5,2,3,0,0,0
3834,4652,8456,60,5,1,4,2,2,0
3835,4652,8659,40,3,1,2,1,0,1
3836,4653,8466,54,7,4,3,1,0,1
3837,4653,10261,46,3,1,2,0,0,0
3838,4655,8455,54,5,2,3,1,1,0
3839,4655,10003,46,8,4,4,1,0,1
3840,4656,10260,57,2,1,1,2,1,1
3841,4656,8586,43,7,1,6,0,0,0
3842,4657,9817,38,6,3,3,1,0,1
3843,4657,8668,62,7,2,5,0,0,0
3844,4658,8654,47,11,6,5,2,1,1
3845,4658,9825,53,4,3,1,0,0,0
3846,4659,9825,72,9,2,7,1,0,1
3847,4659,9826,28,2,1,1,3,0,3
3848,4661,8455,52,7,3,4,3,1,2
3849,4661,8456,48,6,3,3,2,0,2
3850,4662,8668,55,4,1,3,2,1,1
3851,4662,8466,45,5,2,3,0,0,0
3852,4663,8654,54,4,2,2,1,0,1
3853,4663,8197,46,0,0,0,0,0,0
3854,4664,10260,65,4,2,2,2,0,2
3855,4664,10252,35,2,1,1,0,0,0
3856,4665,10261,43,4,3,1,2,0,2
3857,4665,10003,57,4,0,4,0,0,0
3858,4666,9850,47,10,6,4,2,2,0
3859,4666,8472,53,0,0,0,0,0,0
3860,4667,8586,45,5,3,2,1,1,0
3861,4667,10194,55,3,2,1,0,0,0
3862,4668,9817,39,5,2,3,2,1,1
3863,4668,8659,61,6,4,2,1,1,0
3864,4669,10252,46,9,4,5,1,1,0
3865,4669,8466,54,6,2,4,1,1,0
3866,4670,8455,54,4,3,1,2,1,1
3867,4670,8678,46,5,3,2,3,0,3
3868,4671,9826,52,10,4,6,3,2,1
3869,4671,8668,48,7,5,2,1,0,1
3870,4672,10003,61,5,2,3,3,1,2
3871,4672,8197,39,8,3,5,0,0,0
3872,4673,8650,66,7,1,6,5,2,3
3873,4673,10261,34,1,0,1,1,1,0
3874,4674,10194,39,3,1,2,2,2,0
3875,4674,8456,61,4,1,3,0,0,0
3876,4675,9817,41,8,2,6,1,1,0
3877,4675,9850,59,9,5,4,1,1,0
3878,4676,9825,75,14,9,5,2,0,2
3879,4676,8472,25,5,2,3,1,0,1
3880,4677,8586,72,7,6,1,2,2,0
3881,4677,8659,28,6,3,3,0,0,0
3882,4678,8654,41,6,3,3,2,1,1
3883,4678,10260,59,1,0,1,1,0,1
3884,4679,9850,31,6,3,3,2,1,1
3885,4679,9825,69,7,3,4,3,1,2
3886,4680,8586,51,6,3,3,2,1,1
3887,4680,8455,49,5,1,4,3,0,3
3888,4681,8668,63,4,1,3,3,1,2
3889,4681,8678,37,6,2,4,1,0,1
3890,4682,10260,70,17,9,8,1,1,0
3891,4682,8197,30,4,0,4,2,1,1
3892,4683,10261,48,6,2,4,2,1,1
3893,4683,9826,52,4,3,1,3,1,2
3894,4684,8466,49,4,1,3,4,1,3
3895,4684,8456,51,4,2,2,1,0,1
3896,4685,8472,48,6,3,3,1,0,1
3897,4685,10194,52,4,2,2,0,0,0
3898,4686,10003,54,9,6,3,2,1,1
3899,4686,8650,46,5,3,2,0,0,0
3900,4687,9817,64,8,4,4,1,1,0
3901,4687,10252,36,1,0,1,0,0,0
3902,4688,8659,47,7,5,2,4,2,2
3903,4688,8654,53,1,1,0,0,0,0
3904,4689,10261,44,7,3,4,3,3,0
3905,4689,10252,56,0,0,0,1,0,1
3906,4690,8678,61,6,2,4,4,1,3
3907,4690,8659,39,4,2,2,0,0,0
3908,4691,9826,61,6,4,2,3,2,1
3909,4691,10194,39,3,2,1,3,2,1
3910,4692,8197,39,15,4,11,2,2,0
3911,4692,8668,61,4,1,3,1,0,1
3912,4693,8650,71,9,4,5,3,1,2
3913,4693,9817,29,3,1,2,2,0,2
3914,4694,8456,64,2,1,1,3,1,2
3915,4694,9825,36,1,0,1,0,0,0
3916,4695,9850,38,6,4,2,1,1,0
3917,4695,10260,62,8,7,1,2,1,1
3918,4696,8472,31,7,3,4,2,1,1
3919,4696,8455,69,7,2,5,1,0,1
3920,4697,8586,69,9,4,5,1,1,0
3921,4697,8466,31,3,1,2,1,1,0
3922,4698,8654,60,12,5,7,6,3,3
3923,4698,10003,40,6,2,4,2,1,1
3924,4699,9825,58,7,4,3,4,1,3
3925,4699,10252,42,4,1,3,0,0,0
3926,4700,8455,58,11,9,2,2,2,0
3927,4700,8197,42,10,3,7,4,2,2
3928,4701,8668,52,9,6,3,2,0,2
3929,4701,9850,48,4,3,1,1,0,1
3930,4702,10260,65,5,1,4,2,1,1
3931,4702,8678,35,5,2,3,2,0,2
3932,4703,8586,60,8,4,4,1,1,0
3933,4703,10261,40,11,8,3,2,0,2
3934,4704,9826,49,5,4,1,4,3,1
3935,4704,8466,51,4,3,1,1,1,0
3936,4705,8654,62,10,2,8,1,1,0
3937,4705,10194,38,3,0,3,1,1,0
3938,4706,8456,44,5,4,1,1,0,1
3939,4706,10003,56,1,1,0,0,0,0
3940,4707,9817,45,6,5,1,2,0,2
3941,4707,8472,55,2,1,1,1,0,1
3942,4708,8650,68,3,3,0,1,0,1
3943,4708,8659,32,5,1,4,0,0,0
3944,4709,10252,63,10,4,6,1,1,0
3945,4709,8472,37,2,0,2,5,2,3
3946,4710,8678,59,1,1,0,2,0,2
3947,4710,8197,41,1,0,1,0,0,0
3948,4711,8455,65,17,7,10,1,1,0
3949,4711,9826,35,4,2,2,0,0,0
3950,4713,8456,65,8,4,4,1,0,1
3951,4713,9817,35,4,1,3,1,0,1
3952,4714,9825,74,16,6,10,4,1,3
3953,4714,10261,26,0,0,0,0,0,0
3954,4716,10194,62,7,3,4,1,0,1
3955,4716,8659,38,8,5,3,0,0,0
3956,4717,10260,62,5,3,2,1,1,0
3957,4717,10003,38,3,2,1,1,0,1
3958,4718,8586,45,12,7,5,1,1,0
3959,4718,8668,55,4,2,2,0,0,0
3960,4719,9825,73,17,7,10,1,0,1
3961,4719,10194,27,5,1,4,1,0,1
3962,4720,9826,42,4,3,1,1,0,1
3963,4720,8456,58,11,6,5,0,0,0
3964,4721,8668,43,6,2,4,1,1,0
3965,4721,8455,57,5,2,3,0,0,0
3966,4723,10260,62,3,0,3,1,1,0
3967,4723,8650,38,3,0,3,0,0,0
3968,4725,8472,43,7,5,2,2,0,2
3969,4725,8586,57,8,4,4,0,0,0
3970,4727,8466,60,9,3,6,2,1,1
3971,4727,8659,40,2,0,2,0,0,0
3972,4729,8659,47,7,3,4,3,1,2
3973,4729,10252,53,9,4,5,1,1,0
3974,4730,8472,47,6,4,2,2,1,1
3975,4730,8678,53,10,4,6,1,0,1
3976,4731,9825,46,4,2,2,1,1,0
3977,4731,8455,54,16,7,9,3,0,3
3978,4732,8650,55,14,6,8,3,1,2
3979,4732,9850,45,3,0,3,3,0,3
3980,4733,8456,66,14,5,9,1,1,0
3981,4733,8654,34,2,1,1,0,0,0
3982,4734,10261,57,8,4,4,2,2,0
3983,4734,9817,43,5,4,1,0,0,0
3984,4735,8466,37,7,3,4,1,0,1
3985,4735,10260,63,1,0,1,1,0,1
3986,4737,8668,52,9,4,5,2,1,1
3987,4737,10003,48,8,3,5,2,0,2
3988,4738,8586,62,11,4,7,2,2,0
3989,4738,9826,38,8,4,4,0,0,0
3990,4739,9825,61,15,6,9,1,0,1
3991,4739,8197,39,8,3,5,0,0,0
3992,4741,10260,65,8,5,3,2,2,0
3993,4741,8472,35,7,3,4,2,0,2
3994,4743,10003,54,8,3,5,1,1,0
3995,4743,8466,46,7,2,5,2,2,0
3996,4744,10194,52,4,2,2,3,1,2
3997,4744,8678,48,8,3,5,0,0,0
3998,4745,8586,57,7,5,2,2,0,2
3999,4745,8456,43,15,8,7,0,0,0
4000,4746,9817,57,7,4,3,3,1,2
4001,4746,9826,43,8,5,3,1,0,1
4002,4747,8659,49,3,1,2,1,1,0
4003,4747,8668,51,5,2,3,1,0,1
4004,4748,9850,61,7,2,5,2,0,2
4005,4748,8654,39,8,4,4,2,0,2
4006,4749,9825,47,4,1,3,1,1,0
4007,4749,10260,53,5,1,4,0,0,0
4008,4751,9817,47,5,2,3,3,2,1
4009,4751,8678,53,8,2,6,3,0,3
4010,4752,8455,58,6,4,2,1,1,0
4011,4752,8466,42,7,2,5,2,1,1
4012,4753,9826,64,15,10,5,1,0,1
4013,4753,8659,36,4,2,2,0,0,0
4014,4754,8650,51,5,3,2,2,1,1
4015,4754,8668,49,10,3,7,5,2,3
4016,4755,8456,60,11,6,5,1,0,1
4017,4755,10261,40,4,4,0,0,0,0
4018,4757,8472,52,4,3,1,3,2,1
4019,4757,8654,48,9,1,8,1,0,1
4020,4758,8586,61,14,8,6,5,3,2
4021,4758,10003,39,6,3,3,2,1,1
4022,4761,8668,44,10,4,6,3,1,2
4023,4761,10260,56,6,4,2,2,0,2
4024,4765,10003,48,4,2,2,1,1,0
4025,4765,10194,52,2,1,1,2,1,1
4026,4767,9825,64,11,7,4,3,2,1
4027,4767,9817,36,4,1,3,2,0,2
4028,4768,8472,47,4,2,2,1,1,0
4029,4768,8659,53,4,1,3,0,0,0
4030,5952,8639,54,4,1,3,1,0,1
4031,5952,4087,46,1,0,1,0,0,0
4032,6067,9941,56,3,3,0,2,0,2
4033,6067,9853,44,8,1,7,0,0,0
4034,6076,10249,47,7,2,5,1,1,0
4035,6076,9847,53,3,1,2,2,1,1
4036,7049,9837,31,2,1,1,1,0,1
4037,7049,9847,69,3,1,2,0,0,0
4038,7050,7794,39,10,5,5,2,1,1
4039,7050,8592,61,6,4,2,1,1,0
4040,7051,4087,64,3,1,2,3,2,1
4041,7051,7819,36,4,1,3,1,0,1
4042,7054,9748,56,11,7,4,4,2,2
4043,7054,9851,44,3,0,3,1,0,1
4044,7055,9829,61,7,2,5,2,1,1
4045,7055,8689,39,2,1,1,3,2,1
4046,7057,9830,55,5,4,1,2,2,0
4047,7057,8588,45,2,2,0,3,1,2
4048,7060,9847,66,5,4,1,3,2,1
4049,7060,8588,34,5,3,2,1,0,1
4050,7061,8639,69,13,5,8,1,1,0
4051,7061,9747,31,2,1,1,0,0,0
4052,7062,9853,56,6,4,2,2,1,1
4053,7062,8689,44,2,0,2,2,2,0
4054,7065,4087,48,3,2,1,1,1,0
4055,7065,9829,52,4,0,4,2,0,2
4056,7067,9831,68,9,1,8,2,0,2
4057,7067,7794,32,2,1,1,0,0,0
4058,7068,9748,57,11,7,4,5,2,3
4059,7068,10249,43,2,1,1,3,0,3
4060,7069,8592,51,6,1,5,6,4,2
4061,7069,9748,49,6,1,5,1,0,1
4062,7072,9830,46,5,3,2,1,1,0
4063,7072,4087,54,1,0,1,2,0,2
4064,7076,8639,44,2,1,1,1,1,0
4065,7076,9851,56,4,2,2,1,0,1
4066,7077,9853,73,6,3,3,2,1,1
4067,7077,8550,27,5,2,3,1,1,0
4068,7079,9827,45,3,1,2,2,0,2
4069,7079,9941,55,2,1,1,0,0,0
4070,7080,9747,51,5,4,1,3,2,1
4071,7080,7794,49,3,0,3,0,0,0
4072,7082,8689,43,10,8,2,4,2,2
4073,7082,9847,57,6,2,4,1,1,0
4074,7084,7819,58,3,2,1,2,2,0
4075,7084,8550,42,3,2,1,0,0,0
4076,7085,9837,46,2,1,1,1,1,0
4077,7085,9829,54,5,3,2,1,1,0
4078,7086,10249,53,5,5,0,1,1,0
4079,7086,4087,47,2,0,2,2,1,1
4080,7088,9748,60,6,3,3,1,0,1
4081,7088,9831,40,3,1,2,0,0,0
4082,7089,10249,48,1,1,0,4,2,2
4083,7089,7794,52,4,4,0,0,0,0
4084,7091,9831,59,5,2,3,1,0,1
4085,7091,4087,41,1,1,0,1,0,1
4086,7092,8588,47,7,5,2,5,2,3
4087,7092,9827,53,1,0,1,0,0,0
4088,7095,8689,51,5,2,3,2,1,1
4089,7095,9851,49,4,2,2,3,1,2
4090,7096,9829,49,3,1,2,2,1,1
4091,7096,9853,51,5,2,3,1,1,0
4092,7098,8592,51,8,4,4,2,1,1
4093,7098,9847,49,11,3,8,1,1,0
4094,7099,7794,38,5,3,2,2,2,0
4095,7099,9748,62,3,0,3,1,1,0
4096,7101,4087,40,2,2,0,1,1,0
4097,7101,8639,60,3,1,2,2,1,1
4098,7102,8689,59,16,5,11,1,0,1
4099,7102,8588,41,5,4,1,0,0,0
4100,7103,9827,34,4,3,1,1,1,0
4101,7103,8592,66,11,5,6,0,0,0
4102,7105,9829,62,13,5,8,2,1,1
4103,7105,7819,38,4,3,1,1,1,0
4104,7106,9941,46,2,1,1,3,2,1
4105,7106,10249,54,5,3,2,2,0,2
4106,7107,9853,52,4,2,2,2,1,1
4107,7107,9830,48,8,5,3,1,0,1
4108,7108,9837,57,3,3,0,3,2,1
4109,7108,9831,43,6,4,2,2,0,2
4110,7109,8639,51,3,2,1,1,0,1
4111,7109,9827,49,4,1,3,0,0,0
4112,7111,9747,47,6,1,5,2,1,1
4113,7111,4087,53,1,0,1,4,1,3
4114,7112,8588,63,4,3,1,4,2,2
4115,7112,8550,37,1,0,1,0,0,0
4116,7113,9830,32,5,2,3,1,0,1
4117,7113,8592,68,3,2,1,2,0,2
4118,7114,9847,71,4,3,1,1,1,0
4119,7114,9831,29,5,2,3,4,1,3
4120,7115,9837,53,6,2,4,1,1,0
4121,7115,7794,47,2,2,0,1,0,1
4122,7116,9851,41,1,1,0,2,0,2
4123,7116,9829,59,4,0,4,0,0,0
4124,7117,9941,55,4,3,1,1,1,0
4125,7117,8689,45,3,1,2,0,0,0
4126,7118,9748,60,3,2,1,1,0,1
4127,7118,9853,40,4,0,4,0,0,0
4128,7119,7794,63,4,4,0,2,1,1
4129,7119,4087,37,2,1,1,0,0,0
4130,7120,7819,55,1,1,0,1,0,1
4131,7120,9747,45,6,1,5,0,0,0
4132,7121,8639,38,8,3,5,2,1,1
4133,7121,9847,62,7,3,4,1,0,1
4134,7122,8592,54,10,2,8,1,0,1
4135,7122,8689,46,5,1,4,0,0,0
4136,7125,9829,49,6,3,3,1,0,1
4137,7125,8588,51,8,6,2,0,0,0
4138,7126,9853,53,5,2,3,3,1,2
4139,7126,10249,47,4,1,3,1,1,0
4140,7127,9830,54,7,2,5,2,1,1
4141,7127,9941,46,2,0,2,1,1,0
4142,7129,8689,37,7,3,4,2,1,1
4143,7129,9827,63,13,6,7,1,0,1
4144,7131,9748,70,10,6,4,2,1,1
4145,7131,4087,30,0,0,0,0,0,0
4146,7133,8592,61,7,1,6,2,2,0
4147,7133,8550,39,7,5,2,1,0,1
4148,7134,9847,67,7,7,0,4,2,2
4149,7134,9830,33,1,0,1,0,0,0
4150,7135,9837,62,7,4,3,1,1,0
4151,7135,9747,38,2,1,1,0,0,0
4152,7136,10249,43,7,2,5,2,1,1
4153,7136,9851,57,6,3,3,1,0,1
4154,7137,7794,35,4,2,2,2,0,2
4155,7137,9853,65,3,2,1,1,0,1
4156,7139,9851,37,3,2,1,2,2,0
4157,7139,7794,63,6,5,1,1,0,1
4158,7140,9847,66,5,2,3,1,1,0
4159,7140,9747,34,2,1,1,1,0,1
4160,7141,9941,30,2,1,1,2,0,2
4161,7141,8639,70,4,2,2,1,0,1
4162,7142,8689,57,7,2,5,1,0,1
4163,7142,8550,43,2,1,1,1,0,1
4164,7143,7819,35,3,3,0,1,0,1
4165,7143,9748,65,10,4,6,1,0,1
4166,7144,8588,49,4,3,1,2,0,2
4167,7144,10249,51,4,1,3,2,0,2
4168,7145,9827,53,4,2,2,1,0,1
4169,7145,9830,47,1,0,1,2,0,2
4170,7146,9831,55,4,1,3,3,2,1
4171,7146,9853,45,2,0,2,0,0,0
4172,7147,9837,59,7,5,2,2,1,1
4173,7147,4087,41,5,5,0,1,0,1
4174,7151,8588,49,3,2,1,2,0,2
4175,7151,9831,51,2,1,1,0,0,0
4176,7155,9847,63,7,2,5,1,1,0
4177,7155,10249,37,1,0,1,0,0,0
4178,7158,9747,49,3,1,2,1,0,1
4179,7158,9941,51,3,0,3,1,0,1
4180,7162,8689,58,7,2,5,1,0,1
4181,7162,9831,42,4,2,2,0,0,0
4182,7163,10249,42,3,1,2,1,1,0
4183,7163,8592,58,10,5,5,0,0,0
4184,7164,8550,47,5,1,4,1,0,1
4185,7164,9830,53,2,1,1,0,0,0
4186,7166,4087,49,2,0,2,1,1,0
4187,7166,9851,51,2,1,1,2,0,2
4188,7167,9853,53,10,5,5,1,1,0
4189,7167,9837,47,3,2,1,0,0,0
4190,7169,7794,48,1,1,0,2,2,0
4191,7169,9847,52,3,1,2,1,1,0
4192,7170,9851,57,5,3,2,1,1,0
4193,7170,4087,43,4,3,1,1,0,1
4194,7174,9827,47,5,3,2,4,1,3
4195,7174,9829,53,6,3,3,1,0,1
4196,7178,9853,52,8,5,3,2,1,1
4197,7178,9837,48,12,8,4,0,0,0
4198,7179,9827,53,3,1,2,1,1,0
4199,7179,9831,47,0,0,0,2,2,0
4200,7180,7819,43,7,5,2,3,1,2
4201,7180,9837,57,6,1,5,1,0,1
4202,7181,8588,52,7,4,3,5,1,4
4203,7181,9748,48,3,2,1,0,0,0
4204,7182,8639,43,5,1,4,1,1,0
4205,7182,8689,57,9,4,5,0,0,0
4206,7183,9747,31,6,3,3,2,1,1
4207,7183,8592,69,9,3,6,0,0,0
4208,7185,9830,47,5,1,4,2,1,1
4209,7185,9829,53,5,1,4,2,0,2
4210,7186,4087,28,2,1,1,1,0,1
4211,7186,9847,72,4,3,1,0,0,0
4212,7188,9941,64,6,4,2,1,0,1
4213,7188,7794,36,2,0,2,0,0,0
4214,7189,7794,45,6,2,4,2,0,2
4215,7189,9827,55,6,0,6,1,0,1
4216,7190,9941,55,5,3,2,1,0,1
4217,7190,4087,45,4,2,2,0,0,0
4218,7192,8639,44,3,2,1,2,1,1
4219,7192,9829,56,1,0,1,1,0,1
4220,7194,9830,53,9,4,5,1,1,0
4221,7194,10249,47,4,2,2,3,2,1
4222,7196,9837,60,4,2,2,2,0,2
4223,7196,8588,40,12,3,9,1,0,1
4224,7198,9853,24,4,1,3,4,1,3
4225,7198,9847,76,4,1,3,1,0,1
4226,7199,9827,68,4,2,2,3,1,2
4227,7199,9747,32,4,3,1,0,0,0
4228,7200,7819,38,6,2,4,2,1,1
4229,7200,9853,62,2,0,2,1,0,1
4230,7201,8588,56,8,2,6,1,1,0
4231,7201,7794,44,0,0,0,2,1,1
4232,7202,8689,55,8,3,5,2,1,1
4233,7202,10249,45,2,1,1,1,0,1
4234,7203,8592,66,3,2,1,2,1,1
4235,7203,4087,34,2,0,2,0,0,0
4236,7204,8550,44,4,3,1,1,1,0
4237,7204,9831,56,1,0,1,1,0,1
4238,7205,9748,64,4,4,0,1,1,0
4239,7205,9829,36,2,1,1,1,1,0
4240,7207,9851,45,4,1,3,4,3,1
4241,7207,9847,55,3,1,2,3,1,2
4242,7208,9837,45,3,1,2,3,1,2
4243,7208,9941,55,5,3,2,3,2,1
4244,7209,7794,67,9,6,3,2,1,1
4245,7209,8550,33,5,1,4,2,0,2
4246,7210,7819,51,3,3,0,3,0,3
4247,7210,9941,49,4,0,4,0,0,0
4248,7213,9748,30,4,1,3,1,0,1
4249,7213,9847,70,8,1,7,0,0,0
4250,7214,10249,52,6,5,1,1,0,1
4251,7214,8639,48,4,1,3,0,0,0
4252,7216,8689,49,4,3,1,1,0,1
4253,7216,9837,51,5,2,3,1,0,1
4254,7218,9853,61,4,3,1,2,1,1
4255,7218,8588,39,5,4,1,0,0,0
4256,7219,9853,41,5,3,2,1,1,0
4257,7219,9827,59,6,2,4,0,0,0
4258,7220,4087,37,3,3,0,1,0,1
4259,7220,8588,63,7,3,4,0,0,0
4260,7222,8689,54,9,7,2,2,1,1
4261,7222,9748,46,7,3,4,0,0,0
4262,7223,9837,38,6,2,4,2,1,1
4263,7223,8592,62,5,3,2,2,0,2
4264,7224,9747,46,3,2,1,3,2,1
4265,7224,8550,54,4,0,4,0,0,0
4266,7225,10249,52,2,2,0,1,1,0
4267,7225,9829,48,7,3,4,1,0,1
4268,7227,9847,67,4,3,1,2,1,1
4269,7227,7819,33,5,3,2,3,0,3
4270,7229,7794,52,4,1,3,1,1,0
4271,7229,8639,48,6,3,3,1,0,1
4272,7232,9747,62,4,2,2,3,1,2
4273,7232,10249,38,9,5,4,0,0,0
4274,7233,9748,72,7,3,4,1,1,0
4275,7233,9830,28,1,1,0,1,1,0
4276,7235,9941,32,3,1,2,1,0,1
4277,7235,9847,68,2,0,2,0,0,0
4278,7236,8550,38,9,2,7,5,2,3
4279,7236,9837,62,6,5,1,1,1,0
4280,7237,9827,57,10,10,0,1,1,0
4281,7237,9851,43,4,2,2,1,0,1
4282,7238,9853,43,9,3,6,1,1,0
4283,7238,8592,57,4,1,3,1,0,1
4284,7240,8588,59,6,2,4,1,0,1
4285,7240,9851,41,3,0,3,1,0,1
4286,7243,8592,74,8,3,5,2,1,1
4287,7243,7819,26,8,4,4,1,0,1
4288,7246,9831,55,11,6,5,2,0,2
4289,7246,10249,45,5,2,3,0,0,0
4290,7247,9830,66,2,1,1,1,1,0
4291,7247,9747,34,1,0,1,0,0,0
4292,7249,9748,62,3,2,1,1,0,1
4293,7249,10249,38,6,0,6,0,0,0
4294,7253,9747,38,2,1,1,1,0,1
4295,7253,8639,62,8,3,5,1,0,1
4296,7255,9837,44,4,1,3,3,1,2
4297,7255,9830,56,3,0,3,3,3,0
4298,7258,9941,44,3,2,1,2,1,1
4299,7258,8592,56,4,1,3,0,0,0
4300,7259,9827,53,5,3,2,2,2,0
4301,7259,9847,47,3,1,2,2,0,2
4302,7262,7819,33,4,1,3,1,1,0
4303,7262,8689,67,12,4,8,1,1,0
4304,7263,8592,52,7,3,4,1,1,0
4305,7263,9748,48,6,2,4,0,0,0
4306,7264,8550,38,5,1,4,2,2,0
4307,7264,9853,62,1,0,1,0,0,0
4308,7269,7794,47,2,1,1,1,0,1
4309,7269,9941,53,5,2,3,0,0,0
4310,7271,9747,36,3,1,2,3,2,1
4311,7271,8592,64,5,5,0,1,0,1
4312,7272,8639,56,6,3,3,1,0,1
4313,7272,8689,44,1,0,1,0,0,0
4314,7274,8550,37,4,1,3,2,1,1
4315,7274,10249,63,4,1,3,2,2,0
4316,7279,7794,44,7,4,3,1,1,0
4317,7279,9747,56,5,4,1,2,0,2
4318,7280,7819,61,9,5,4,1,1,0
4319,7280,8550,39,4,0,4,2,1,1
4320,7281,4087,49,2,2,0,1,1,0
4321,7281,10249,51,4,1,3,2,2,0
4322,7286,9851,60,9,5,4,1,0,1
4323,7286,9830,40,3,1,2,1,0,1
4324,7288,9941,45,5,3,2,1,0,1
4325,7288,9827,55,8,5,3,0,0,0
4326,7290,9748,76,4,2,2,3,2,1
4327,7290,9747,24,1,0,1,0,0,0
4328,7291,8639,60,4,3,1,2,0,2
4329,7291,9837,40,3,0,3,0,0,0
4330,7294,8550,54,9,6,3,4,1,3
4331,7294,9941,46,2,1,1,0,0,0
4332,7298,4087,51,2,0,2,1,0,1
4333,7298,9831,49,2,0,2,1,0,1
4334,7302,8689,49,5,1,4,2,2,0
4335,7302,8588,51,3,2,1,0,0,0
4336,7304,9847,69,5,0,5,1,1,0
4337,7304,8550,31,2,0,2,1,0,1
4338,7312,9941,45,3,1,2,4,1,3
4339,7312,8689,55,5,3,2,0,0,0
4340,7313,9748,64,7,6,1,1,0,1
4341,7313,9853,36,7,2,5,0,0,0
4342,7319,9827,59,6,1,5,3,1,2
4343,7319,8550,41,1,0,1,0,0,0
4344,7320,9747,48,2,0,2,1,0,1
4345,7320,7819,52,2,0,2,0,0,0
4346,7323,8592,67,3,1,2,1,1,0
4347,7323,8689,33,2,1,1,1,0,1
4348,7324,9847,52,2,1,1,2,1,1
4349,7324,8639,48,5,2,3,3,3,0
4350,7326,9831,48,6,3,3,2,2,0
4351,7326,9851,52,3,0,3,1,0,1
4352,7328,9941,54,2,2,0,1,1,0
4353,7328,9830,46,2,1,1,1,0,1
4354,7329,7794,58,4,3,1,4,3,1
4355,7329,9853,42,3,1,2,1,0,1
4356,7330,9837,41,3,1,2,1,0,1
4357,7330,9747,59,3,2,1,0,0,0
4358,7332,9827,51,7,3,4,1,1,0
4359,7332,8689,49,6,1,5,1,0,1
4360,7333,4087,47,3,2,1,3,3,0
4361,7333,9748,53,4,2,2,2,0,2
4362,7335,9829,53,2,1,1,3,2,1
4363,7335,9941,47,4,3,1,4,1,3
4364,7336,10249,43,3,2,1,1,1,0
4365,7336,9851,57,1,1,0,0,0,0
4366,7337,9847,53,7,6,1,1,1,0
4367,7337,9830,47,4,3,1,0,0,0
4368,7338,9831,60,7,3,4,3,0,3
4369,7338,7819,40,8,1,7,0,0,0
4370,7339,9830,40,3,1,2,2,0,2
4371,7339,9827,60,3,3,0,0,0,0
4372,7342,10249,52,5,4,1,2,2,0
4373,7342,8588,48,2,1,1,1,0,1
4374,7344,8550,51,12,5,7,1,0,1
4375,7344,8689,49,9,6,3,2,0,2
4376,7346,7794,42,3,2,1,1,1,0
4377,7346,9851,58,7,6,1,1,0,1
4378,7347,9853,64,6,4,2,1,0,1
4379,7347,9831,36,5,0,5,1,0,1
4380,7348,8639,62,7,5,2,4,3,1
4381,7348,9941,38,8,4,4,2,1,1
4382,7350,4087,48,5,1,4,4,4,0
4383,7350,9853,52,3,1,2,1,0,1
4384,7351,9747,51,4,1,3,2,1,1
4385,7351,9941,49,10,3,7,1,1,0
4386,7355,10249,39,3,2,1,1,0,1
4387,7355,9847,61,6,3,3,0,0,0
4388,7357,9831,46,8,3,5,2,1,1
4389,7357,8588,54,3,1,2,1,1,0
4390,7358,9851,58,5,2,3,2,1,1
4391,7358,9837,42,0,0,0,0,0,0
4392,7361,8588,39,2,1,1,2,0,2
4393,7361,9830,61,9,5,4,1,0,1
4394,7363,8592,62,5,3,2,1,1,0
4395,7363,7794,38,3,0,3,1,0,1
4396,7365,9847,63,5,4,1,2,2,0
4397,7365,9837,37,4,2,2,2,1,1
4398,7367,9853,59,6,3,3,9,3,6
4399,7367,9747,41,4,2,2,1,0,1
4400,7368,9831,45,3,1,2,2,0,2
4401,7368,9941,55,4,0,4,0,0,0
4402,7370,9851,66,5,1,4,1,0,1
4403,7370,7819,34,5,0,5,0,0,0
4404,7371,9837,46,1,1,0,2,0,2
4405,7371,8588,54,3,1,2,0,0,0
4406,7373,8592,63,8,3,5,3,1,2
4407,7373,9831,37,6,1,5,1,0,1
4408,7374,9748,65,6,4,2,3,0,3
4409,7374,8550,35,3,1,2,0,0,0
4410,7378,9847,61,8,5,3,1,0,1
4411,7378,9853,39,5,2,3,1,0,1
4412,7379,7794,59,4,2,2,1,1,0
4413,7379,8588,41,0,0,0,0,0,0
4414,7382,8639,62,6,1,5,3,1,2
4415,7382,9830,38,4,3,1,0,0,0
4416,7384,8689,59,10,2,8,1,1,0
4417,7384,10249,41,5,2,3,0,0,0
4418,7385,8550,45,6,2,4,2,1,1
4419,7385,9831,55,3,2,1,2,1,1
4420,7387,9847,63,9,3,6,1,1,0
4421,7387,9851,37,6,3,3,3,1,2
4422,7388,7819,40,1,1,0,2,1,1
4423,7388,9853,60,5,1,4,0,0,0
4424,7389,4087,43,3,1,2,4,2,2
4425,7389,9827,57,0,0,0,1,1,0
4426,7390,8588,45,6,3,3,3,2,1
4427,7390,9853,55,4,3,1,1,0,1
4428,7391,10249,40,2,1,1,1,1,0
4429,7391,8639,60,6,5,1,1,0,1
4430,7392,9837,33,4,3,1,1,1,0
4431,7392,8689,67,1,1,0,0,0,0
4432,7394,8550,38,12,6,6,1,0,1
4433,7394,7794,62,3,1,2,0,0,0
4434,7396,9830,46,12,6,6,4,1,3
4435,7396,9831,54,2,0,2,1,0,1
4436,7398,9748,35,5,1,4,3,2,1
4437,7398,9847,65,4,1,3,0,0,0
4438,7400,9847,72,8,4,4,2,1,1
4439,7400,7819,28,4,1,3,1,0,1
4440,7401,4087,52,5,4,1,4,0,4
4441,7401,8588,48,5,1,4,0,0,0
4442,7403,9748,55,9,6,3,2,0,2
4443,7403,8689,45,7,2,5,1,0,1
4444,7405,8639,42,3,3,0,3,0,3
4445,7405,9831,58,3,3,0,1,0,1
4446,7407,9851,56,9,5,4,1,0,1
4447,7407,9941,44,2,1,1,1,0,1
4448,7409,9851,58,5,3,2,1,1,0
4449,7409,9827,42,7,1,6,1,0,1
4450,7410,7819,57,5,4,1,1,0,1
4451,7410,8588,43,3,2,1,0,0,0
4452,7413,8592,65,7,2,5,3,0,3
4453,7413,9853,35,4,2,2,0,0,0
4454,7415,9829,62,2,2,0,2,0,2
4455,7415,9831,38,3,2,1,0,0,0
4456,7416,9747,51,6,5,1,1,1,0
4457,7416,10249,49,5,4,1,1,0,1
4458,7417,9830,46,6,2,4,2,1,1
4459,7417,9748,54,7,3,4,3,2,1
4460,7419,7794,58,3,2,1,3,2,1
4461,7419,8689,42,6,3,3,2,2,0
4462,7420,7819,32,5,2,3,2,1,1
4463,7420,8592,68,12,7,5,0,0,0
4464,7421,8550,43,5,3,2,2,1,1
4465,7421,4087,57,0,0,0,0,0,0
4466,7423,9748,53,5,4,1,1,1,0
4467,7423,8639,47,4,1,3,1,0,1
4468,7424,9831,57,3,2,1,1,1,0
4469,7424,10249,43,1,0,1,0,0,0
4470,7426,9851,54,7,2,5,1,0,1
4471,7426,8588,46,4,1,3,0,0,0
4472,7427,9941,43,1,1,0,1,0,1
4473,7427,9853,57,6,1,5,0,0,0
4474,7428,9829,44,6,2,4,2,2,0
4475,7428,9847,56,5,3,2,1,0,1
4476,7431,9847,53,3,1,2,4,0,4
4477,7431,8639,47,9,4,5,0,0,0
4478,7433,7819,31,4,4,0,3,1,2
4479,7433,8592,69,10,4,6,2,0,2
4480,7435,9747,46,7,2,5,3,2,1
4481,7435,9830,54,6,4,2,0,0,0
4482,7436,9831,48,2,0,2,2,2,0
4483,7436,9829,52,5,0,5,1,0,1
4484,7438,10242,51,4,1,3,4,1,3
4485,7438,6391,49,1,1,0,0,0,0
4486,7440,9827,52,9,2,7,2,0,2
4487,7440,10249,48,2,0,2,0,0,0
4488,7442,8592,57,13,7,6,1,0,1
4489,7442,8689,43,2,0,2,0,0,0
4490,7443,9829,42,6,2,4,1,1,0
4491,7443,9748,58,9,2,7,1,0,1
4492,7446,9851,42,5,3,2,1,0,1
4493,7446,9831,58,3,1,2,0,0,0
4494,7447,9853,55,7,1,6,2,1,1
4495,7447,6391,45,0,0,0,4,1,3
4496,7448,8121,41,3,1,2,2,2,0
4497,7448,9941,59,11,2,9,0,0,0
4498,7455,9941,31,3,1,2,1,1,0
4499,7455,9748,69,7,5,2,0,0,0
4500,7457,9847,70,8,6,2,4,2,2
4501,7457,9853,30,6,1,5,1,1,0
4502,7458,9829,55,5,2,3,1,1,0
4503,7458,9837,45,7,2,5,2,0,2
4504,7460,6391,58,2,2,0,4,2,2
4505,7460,9827,42,2,1,1,1,0,1
4506,7461,8689,64,7,6,1,2,1,1
4507,7461,9747,36,4,1,3,1,0,1
4508,7463,9830,46,5,3,2,3,2,1
4509,7463,8592,54,6,1,5,0,0,0
4510,7464,9831,61,6,2,4,4,2,2
4511,7464,8639,39,3,0,3,0,0,0
4512,7465,9847,59,4,4,0,1,1,0
4513,7465,9851,41,2,1,1,0,0,0
4514,7466,9837,51,8,6,2,3,0,3
4515,7466,9853,49,8,5,3,0,0,0
4516,7468,10242,33,4,2,2,4,1,3
4517,7468,9748,67,14,7,7,1,0,1
4518,7469,8121,46,7,3,4,2,2,0
4519,7469,9851,54,2,1,1,3,0,3
4520,7470,9827,53,1,1,0,2,1,1
4521,7470,9829,47,5,2,3,1,1,0
4522,7471,9747,62,7,2,5,1,1,0
4523,7471,7819,38,7,0,7,0,0,0
4524,7473,8689,67,11,7,4,1,1,0
4525,7473,10242,33,8,2,6,0,0,0
4526,7474,9748,62,8,5,3,1,1,0
4527,7474,9853,38,3,1,2,3,0,3
4528,7476,10249,44,3,1,2,2,2,0
4529,7476,9830,56,2,0,2,2,1,1
4530,7479,7794,41,5,3,2,1,1,0
4531,7479,6391,59,6,1,5,3,2,1
4532,7485,9831,44,7,3,4,1,1,0
4533,7485,9748,56,4,2,2,1,0,1
4534,7487,8592,60,6,4,2,2,1,1
4535,7487,9853,40,6,4,2,1,1,0
4536,7488,8639,47,7,1,6,1,1,0
4537,7488,10242,53,4,1,3,1,0,1
4538,7491,6391,49,6,4,2,1,0,1
4539,7491,8689,51,2,1,1,2,0,2
4540,7492,10249,36,7,3,4,1,1,0
4541,7492,9748,64,4,3,1,1,0,1
4542,7493,9829,31,5,2,3,1,1,0
4543,7493,8592,69,7,3,4,0,0,0
4544,7496,9837,54,3,2,1,2,2,0
4545,7496,9851,46,5,4,1,0,0,0
4546,7497,9853,55,9,4,5,2,1,1
4547,7497,9747,45,6,2,4,0,0,0
4548,7499,9847,70,6,3,3,1,1,0
4549,7499,8121,30,3,2,1,4,1,3
4550,7500,7794,41,4,1,3,4,1,3
4551,7500,9827,59,2,1,1,0,0,0
4552,7502,8639,52,7,4,3,1,0,1
4553,7502,9853,48,2,1,1,1,0,1
4554,7503,8689,43,4,3,1,3,3,0
4555,7503,9831,57,9,3,6,1,0,1
4556,7504,7819,37,4,3,1,2,1,1
4557,7504,9829,63,5,1,4,0,0,0
4558,7505,10249,56,7,3,4,2,1,1
4559,7505,6391,44,1,1,0,0,0,0
4560,7506,9748,58,6,5,1,1,0,1
4561,7506,9830,42,5,4,1,0,0,0
4562,7507,9851,44,6,1,5,1,1,0
4563,7507,8592,56,6,2,4,3,2,1
4564,7510,9827,68,7,2,5,2,2,0
4565,7510,9747,32,2,0,2,0,0,0
4566,7513,9748,65,6,1,5,2,1,1
4567,7513,8121,35,6,2,4,1,0,1
4568,7514,8592,66,11,3,8,2,1,1
4569,7514,10249,34,0,0,0,3,3,0
4570,7515,9847,62,6,1,5,1,0,1
4571,7515,9831,38,2,2,0,0,0,0
4572,7516,9837,52,6,3,3,2,1,1
4573,7516,10242,48,6,2,4,1,1,0
4574,7518,9941,53,4,2,2,2,0,2
4575,7518,8689,47,2,1,1,0,0,0
4576,7519,9827,55,1,1,0,1,1,0
4577,7519,8121,45,4,2,2,1,1,0
4578,7520,8639,56,8,2,6,2,1,1
4579,7520,8689,44,4,2,2,4,2,2
4580,7521,8592,54,5,2,3,2,2,0
4581,7521,6391,46,3,2,1,1,0,1
4582,7522,9853,46,3,2,1,4,2,2
4583,7522,9829,54,4,1,3,1,0,1
4584,7525,9847,63,3,1,2,2,0,2
4585,7525,9748,37,3,1,2,0,0,0
4586,7526,9831,64,2,1,1,2,1,1
4587,7526,9837,36,6,2,4,1,1,0
4588,7528,10242,54,3,2,1,2,0,2
4589,7528,7794,46,2,0,2,0,0,0
4590,7530,9827,49,5,3,2,1,0,1
4591,7530,8592,51,4,2,2,2,0,2
4592,7532,6391,49,8,4,4,1,1,0
4593,7532,9748,51,4,3,1,1,0,1
4594,7533,9747,44,8,3,5,1,1,0
4595,7533,9851,56,3,2,1,1,1,0
4596,7538,10242,28,6,2,4,1,1,0
4597,7538,9829,72,8,2,6,1,0,1
4598,7546,9851,49,3,1,2,2,1,1
4599,7546,10249,51,2,1,1,1,1,0
4600,7547,9827,46,8,1,7,1,1,0
4601,7547,9853,54,3,0,3,3,1,2
4602,7548,10242,40,5,3,2,1,1,0
4603,7548,9831,60,9,4,5,1,0,1
4604,7549,7819,36,7,4,3,2,1,1
4605,7549,8121,64,4,1,3,2,2,0
4606,7550,6391,45,1,1,0,2,1,1
4607,7550,9829,55,6,2,4,1,1,0
4608,7552,8639,38,3,2,1,1,1,0
4609,7552,9831,62,3,0,3,1,0,1
4610,7553,9827,51,6,3,3,1,1,0
4611,7553,10249,49,5,0,5,0,0,0
4612,7554,8592,64,4,2,2,4,1,3
4613,7554,9747,36,1,0,1,0,0,0
4614,7556,9847,72,5,2,3,1,1,0
4615,7556,7794,28,0,0,0,0,0,0
4616,7559,9853,34,3,1,2,1,1,0
4617,7559,9748,66,13,6,7,0,0,0
4618,7560,9830,52,6,2,4,1,0,1
4619,7560,9747,48,4,1,3,0,0,0
4620,7562,8639,43,8,4,4,1,1,0
4621,7562,9827,57,4,3,1,0,0,0
4622,7564,9837,41,4,1,3,4,0,4
4623,7564,6391,59,5,1,4,0,0,0
4624,7565,8121,40,5,2,3,2,2,0
4625,7565,9831,60,7,1,6,0,0,0
4626,7573,7819,37,3,1,2,3,2,1
4627,7573,10249,63,7,3,4,1,1,0
4628,7574,9831,61,2,1,1,2,2,0
4629,7574,8689,39,5,2,3,2,2,0
4630,7575,8592,33,3,2,1,4,2,2
4631,7575,9748,67,14,2,12,2,2,0
4632,7578,9851,57,3,2,1,5,2,3
4633,7578,6391,43,2,0,2,2,0,2
4634,7579,8121,44,8,7,1,4,2,2
4635,7579,9829,56,5,2,3,0,0,0
4636,7580,9853,32,8,4,4,3,3,0
4637,7580,9847,68,6,4,2,0,0,0
4638,7582,9851,46,4,2,2,4,2,2
4639,7582,9827,54,5,3,2,0,0,0
4640,7585,8592,57,12,6,6,1,1,0
4641,7585,8639,43,5,3,2,0,0,0
4642,7587,7819,32,4,1,3,1,1,0
4643,7587,9831,68,9,3,6,1,0,1
4644,7589,7794,35,8,1,7,3,0,3
4645,7589,9829,65,4,1,3,3,0,3
4646,7590,10242,42,7,4,3,2,2,0
4647,7590,9747,58,4,3,1,4,1,3
4648,7593,10249,39,6,2,4,2,0,2
4649,7593,8592,61,1,0,1,0,0,0
4650,7595,9748,64,9,5,4,3,3,0
4651,7595,9827,36,4,2,2,0,0,0
4652,7598,9851,43,2,1,1,1,1,0
4653,7598,9853,57,6,2,4,1,0,1
4654,7602,10249,43,6,3,3,1,1,0
4655,7602,8689,57,3,0,3,0,0,0
4656,7603,6391,70,4,1,3,3,2,1
4657,7603,9747,30,0,0,0,3,0,3
4658,7608,9830,56,10,4,6,2,0,2
4659,7608,9941,44,4,3,1,0,0,0
4660,7609,6391,61,7,1,6,2,2,0
4661,7609,10242,39,0,0,0,2,0,2
4662,7612,9830,47,2,1,1,1,1,0
4663,7612,8689,53,1,1,0,1,1,0
4664,7614,9831,46,3,1,2,4,3,1
4665,7614,8592,54,5,2,3,0,0,0
4666,7615,7819,38,8,4,4,1,1,0
4667,7615,9748,62,4,1,3,2,0,2
4668,7617,7794,45,5,3,2,1,1,0
4669,7617,9837,55,6,3,3,1,1,0
4670,7618,9851,67,5,1,4,2,1,1
4671,7618,8121,33,1,1,0,1,1,0
4672,7619,10249,60,4,2,2,2,0,2
4673,7619,8121,40,2,0,2,0,0,0
4674,7622,9747,39,8,4,4,3,1,2
4675,7622,8689,61,8,5,3,2,0,2
4676,7623,8639,54,5,3,2,1,1,0
4677,7623,9748,46,3,0,3,0,0,0
4678,7631,8689,41,10,5,5,2,1,1
4679,7631,10242,59,7,2,5,0,0,0
4680,7632,9830,52,6,5,1,1,1,0
4681,7632,9829,48,2,1,1,0,0,0
4682,7634,10249,52,4,3,1,2,1,1
4683,7634,8639,48,3,0,3,3,2,1
4684,7635,9831,76,7,4,3,3,1,2
4685,7635,7794,24,5,3,2,2,1,1
4686,7636,9748,40,7,4,3,1,1,0
4687,7636,9847,60,3,2,1,1,0,1
4688,7638,9851,56,10,6,4,3,3,0
4689,7638,9941,44,4,1,3,1,0,1
4690,7640,6391,51,2,1,1,1,1,0
4691,7640,9827,49,5,3,2,2,0,2
4692,7643,8592,59,10,7,3,2,1,1
4693,7643,9941,41,10,3,7,4,0,4
4694,7644,9748,67,6,1,5,3,1,2
4695,7644,9747,33,4,1,3,2,1,1
4696,7646,7794,46,6,3,3,2,0,2
4697,7646,8689,54,2,0,2,1,0,1
4698,7648,9851,43,4,2,2,2,1,1
4699,7648,9830,57,5,0,5,0,0,0
4700,7649,9747,48,4,3,1,1,1,0
4701,7649,7794,52,5,3,2,2,1,1
4702,7651,9827,41,7,3,4,2,1,1
4703,7651,8639,59,6,1,5,2,1,1
4704,7652,9853,62,7,5,2,1,0,1
4705,7652,8689,38,6,4,2,0,0,0
4706,7653,9851,31,1,0,1,2,2,0
4707,7653,9748,69,4,0,4,2,0,2
4708,7655,9847,68,5,2,3,2,1,1
4709,7655,10249,32,3,1,2,1,0,1
4710,7657,7819,34,7,4,3,3,2,1
4711,7657,9831,66,3,2,1,2,0,2
4712,7658,9941,47,3,2,1,4,1,3
4713,7658,9829,53,4,2,2,2,1,1
4714,7659,9837,54,4,2,2,1,0,1
4715,7659,9829,46,8,2,6,0,0,0
4716,7661,10242,40,8,4,4,2,1,1
4717,7661,9847,60,7,3,4,3,0,3
4718,7663,8121,44,4,2,2,3,0,3
4719,7663,9830,56,10,7,3,0,0,0
4720,7664,6391,60,6,3,3,1,1,0
4721,7664,7819,40,5,4,1,2,1,1
4722,7665,10249,45,7,4,3,2,2,0
4723,7665,9831,55,2,2,0,0,0,0
4724,7667,9748,60,9,5,4,1,1,0
4725,7667,9851,40,4,1,3,2,1,1
4726,7670,10249,54,2,2,0,3,2,1
4727,7670,9853,46,4,1,3,0,0,0
4728,7671,9827,45,4,1,3,1,0,1
4729,7671,7794,55,4,1,3,1,0,1
4730,7672,9941,40,5,1,4,2,0,2
4731,7672,8639,60,2,1,1,0,0,0
4732,7673,6391,43,5,2,3,3,1,2
4733,7673,9831,57,4,4,0,3,1,2
4734,7678,9837,73,7,2,5,2,1,1
4735,7678,9747,27,1,0,1,0,0,0
4736,7680,10249,57,4,3,1,7,3,4
4737,7680,9747,43,3,0,3,0,0,0
4738,7682,8689,41,3,1,2,2,1,1
4739,7682,9748,59,6,4,2,0,0,0
4740,7684,6391,54,11,9,2,2,2,0
4741,7684,9853,46,3,2,1,0,0,0
4742,7685,9847,58,4,1,3,2,0,2
4743,7685,9831,42,4,1,3,0,0,0
4744,7687,9837,53,5,1,4,1,0,1
4745,7687,9851,47,3,2,1,1,0,1
4746,7688,9941,48,4,2,2,3,1,2
4747,7688,7819,52,2,0,2,1,0,1
4748,7689,8121,55,3,1,2,3,3,0
4749,7689,6391,45,1,0,1,0,0,0
4750,7690,10242,39,4,2,2,1,0,1
4751,7690,9853,61,9,4,5,0,0,0
4752,7692,9829,42,4,2,2,3,1,2
4753,7692,8639,58,2,0,2,0,0,0
4754,7694,9831,70,6,3,3,3,1,2
4755,7694,9851,30,4,0,4,1,0,1
4756,7695,8592,67,5,3,2,2,1,1
4757,7695,9827,33,4,1,3,0,0,0
4758,7696,8689,48,8,3,5,3,1,2
4759,7696,7819,52,5,3,2,1,0,1
4760,7698,9941,44,3,3,0,2,1,1
4761,7698,7794,56,1,0,1,1,1,0
4762,7699,9829,39,4,3,1,2,0,2
4763,7699,8592,61,3,0,3,1,0,1
4764,7701,9827,64,6,3,3,1,0,1
4765,7701,8121,36,1,1,0,0,0,0
4766,7702,9941,47,4,2,2,3,0,3
4767,7702,8689,53,4,3,1,0,0,0
4768,7705,9831,53,3,0,3,1,1,0
4769,7705,9748,47,3,0,3,0,0,0
4770,7707,9853,49,5,4,1,3,0,3
4771,7707,7794,51,7,4,3,0,0,0
4772,7708,9747,44,6,4,2,1,1,0
4773,7708,9851,56,7,1,6,2,0,2
4774,7709,9853,53,6,2,4,2,1,1
4775,7709,8689,47,3,0,3,1,0,1
4776,7710,9747,55,7,4,3,1,1,0
4777,7710,7819,45,7,2,5,4,4,0
4778,7712,7794,47,6,3,3,2,0,2
4779,7712,6391,53,2,1,1,1,0,1
4780,7713,8121,37,5,4,1,5,1,4
4781,7713,8639,63,4,4,0,1,0,1
4782,7714,10242,56,9,6,3,2,1,1
4783,7714,10249,44,6,3,3,0,0,0
4784,7715,9837,36,5,1,4,2,1,1
4785,7715,9831,64,4,2,2,1,0,1
4786,7716,9830,36,3,1,2,4,1,3
4787,7716,8592,64,2,2,0,0,0,0
4788,7717,9829,47,7,3,4,3,1,2
4789,7717,9851,53,5,2,3,0,0,0
4790,7719,8121,52,3,1,2,1,1,0
4791,7719,8592,48,3,0,3,3,1,2
4792,7723,8639,51,7,4,3,7,3,4
4793,7723,8689,49,4,1,3,1,1,0
4794,7724,9830,45,8,3,5,5,1,4
4795,7724,9831,55,2,1,1,0,0,0
4796,7725,6391,29,2,0,2,4,1,3
4797,7725,9748,71,0,0,0,0,0,0
4798,7726,9847,60,10,3,7,2,2,0
4799,7726,9851,40,5,1,4,1,1,0
4800,7728,9837,43,5,2,3,1,1,0
4801,7728,10249,57,4,1,3,1,0,1
4802,7729,9827,55,5,3,2,4,1,3
4803,7729,8689,45,4,3,1,1,1,0
4804,7730,9830,66,7,3,4,3,2,1
4805,7730,7819,34,3,2,1,0,0,0
4806,7731,9847,73,3,0,3,1,0,1
4807,7731,6391,27,3,0,3,1,0,1
4808,7732,8639,61,10,3,7,1,0,1
4809,7732,9747,39,4,3,1,1,0,1
4810,7733,10249,52,5,1,4,2,1,1
4811,7733,9851,48,3,1,2,0,0,0
4812,7735,9837,40,7,3,4,3,1,2
4813,7735,8592,60,11,8,3,0,0,0
4814,7737,7794,57,6,4,2,2,2,0
4815,7737,8121,43,4,2,2,1,0,1
4816,7738,9941,51,8,3,5,3,2,1
4817,7738,10242,49,2,0,2,0,0,0
4818,7739,9941,49,6,3,3,2,1,1
4819,7739,8121,51,0,0,0,2,1,1
4820,7740,9829,47,6,3,3,1,0,1
4821,7740,10249,53,4,0,4,0,0,0
4822,7741,8639,49,5,2,3,2,2,0
4823,7741,9853,51,7,3,4,2,1,1
4824,7742,9747,32,4,1,3,1,0,1
4825,7742,9831,68,3,1,2,0,0,0
4826,7743,8592,65,7,2,5,2,1,1
4827,7743,10242,35,5,2,3,2,0,2
4828,7747,9837,34,3,2,1,3,2,1
4829,7747,9748,66,3,1,2,1,0,1
4830,7748,7794,52,2,2,0,3,2,1
4831,7748,9851,48,11,6,5,0,0,0
4832,7750,9830,44,5,2,3,2,1,1
4833,7750,9827,56,7,3,4,1,0,1
4834,7751,7819,38,9,6,3,2,2,0
4835,7751,9748,62,2,1,1,0,0,0
4836,7753,8639,57,7,4,3,2,2,0
4837,7753,6391,43,6,2,4,0,0,0
4838,7754,9847,68,9,3,6,1,1,0
4839,7754,9829,32,2,1,1,0,0,0
4840,7755,8689,48,4,3,1,1,0,1
4841,7755,9837,52,7,6,1,0,0,0
4842,7756,9941,44,3,2,1,1,1,0
4843,7756,9851,56,1,0,1,0,0,0
4844,7757,9853,67,10,4,6,1,0,1
4845,7757,7794,33,1,0,1,0,0,0
4846,7758,10249,61,6,4,2,1,1,0
4847,7758,10242,39,6,3,3,1,0,1
4848,7759,9829,47,9,3,6,4,2,2
4849,7759,6391,53,9,4,5,2,1,1
4850,7760,8121,49,3,2,1,4,2,2
4851,7760,8689,51,5,1,4,3,1,2
4852,7761,9748,58,8,3,5,3,1,2
4853,7761,8639,42,4,3,1,1,0,1
4854,7766,9847,71,11,6,5,1,1,0
4855,7766,9827,29,3,0,3,2,2,0
4856,7770,9831,54,4,1,3,4,2,2
4857,7770,7794,46,3,1,2,1,0,1
4858,7771,9941,45,4,1,3,2,0,2
4859,7771,9827,55,7,2,5,0,0,0
4860,7773,6391,28,4,3,1,3,1,2
4861,7773,9747,72,3,0,3,3,0,3
4862,7774,9748,44,5,2,3,3,1,2
4863,7774,8592,56,6,3,3,2,0,2
4864,7777,8639,54,8,6,2,1,0,1
4865,7777,9851,46,3,2,1,0,0,0
4866,7779,8121,54,4,1,3,4,1,3
4867,7779,9837,46,2,1,1,0,0,0
4868,7780,9851,46,7,3,4,2,1,1
4869,7780,6391,54,3,1,2,2,2,0
4870,7781,9830,35,2,1,1,1,0,1
4871,7781,8639,65,10,8,2,1,0,1
4872,7782,7819,45,6,4,2,1,0,1
4873,7782,8689,55,3,2,1,0,0,0
4874,7783,9748,65,6,5,1,2,0,2
4875,7783,7794,35,3,2,1,0,0,0
4876,7784,9829,52,5,2,3,1,1,0
4877,7784,10249,48,6,3,3,2,0,2
4878,7786,9847,79,7,2,5,1,1,0
4879,7786,9747,21,7,5,2,1,0,1
4880,7787,9941,39,2,1,1,1,1,0
4881,7787,8592,61,3,1,2,0,0,0
4882,7790,9827,51,3,2,1,2,1,1
4883,7790,9748,49,5,2,3,4,3,1
4884,7791,7819,45,9,6,3,3,1,2
4885,7791,6391,55,4,2,2,2,0,2
4886,7796,8639,58,6,2,4,3,2,1
4887,7796,9837,42,4,2,2,0,0,0
4888,7800,7819,41,8,6,2,1,0,1
4889,7800,9853,59,5,3,2,0,0,0
4890,7801,9941,49,6,4,2,5,3,2
4891,7801,6391,51,4,0,4,1,1,0
4892,7804,9837,29,5,2,3,1,1,0
4893,7804,9748,71,7,4,3,0,0,0
4894,7805,9829,55,9,4,5,3,2,1
4895,7805,9851,45,2,1,1,1,0,1
4896,7806,8592,43,7,5,2,5,4,1
4897,7806,9847,57,8,7,1,0,0,0
4898,7807,9747,49,10,4,6,2,2,0
4899,7807,10242,51,6,3,3,0,0,0
4900,7808,9830,43,6,3,3,2,1,1
4901,7808,9831,57,6,3,3,0,0,0
4902,7819,8697,47,6,4,2,8,2,6
4903,7819,8178,53,4,2,2,1,0,1
4904,7829,9911,32,3,2,1,4,1,3
4905,7829,9789,68,2,0,2,2,0,2
4906,7831,8697,61,7,5,2,3,1,2
4907,7831,8177,39,1,0,1,1,0,1
4908,7836,9789,52,4,1,3,1,0,1
4909,7836,9790,48,2,2,0,1,0,1
4910,7848,8697,59,5,1,4,5,2,3
4911,7848,8722,41,2,2,0,0,0,0
4912,7851,9911,48,6,3,3,1,1,0
4913,7851,9904,52,3,1,2,2,0,2
4914,7855,9790,37,9,4,5,3,2,1
4915,7855,8697,63,6,3,3,0,0,0
4916,7863,8178,57,9,6,3,2,0,2
4917,7863,9823,43,4,2,2,0,0,0
4918,7872,8226,43,4,3,1,1,1,0
4919,7872,9823,57,2,0,2,2,0,2
4920,7873,10189,66,5,2,3,2,1,1
4921,7873,8177,34,2,0,2,3,0,3
4922,7890,9790,40,6,3,3,3,1,2
4923,7890,9823,60,10,2,8,2,0,2
4924,7891,8178,55,9,2,7,1,1,0
4925,7891,9789,45,4,2,2,3,1,2
4926,7893,8697,75,8,3,5,1,1,0
4927,7893,9912,25,1,0,1,2,1,1
4928,7899,9823,64,14,8,6,3,2,1
4929,7899,9789,36,3,1,2,1,0,1
4930,7909,9789,40,9,4,5,1,0,1
4931,7909,9823,60,3,2,1,0,0,0
4932,7915,9904,71,7,4,3,1,0,1
4933,7915,8398,29,5,2,3,0,0,0
4934,7926,9823,78,9,2,7,5,3,2
4935,7926,8722,22,5,3,2,0,0,0
4936,7927,9790,43,4,1,3,1,0,1
4937,7927,8178,57,4,1,3,0,0,0
4938,7945,9911,38,5,2,3,2,1,1
4939,7945,8178,62,11,7,4,1,0,1
4940,7947,10189,70,4,4,0,1,0,1
4941,7947,8722,30,3,1,2,1,0,1
4942,7954,10269,43,7,4,3,1,1,0
4943,7954,8697,57,1,1,0,2,0,2
4944,7969,9911,42,2,2,0,1,1,0
4945,7969,9788,58,10,2,8,1,1,0
4946,7971,8226,52,8,4,4,3,2,1
4947,7971,9790,48,4,0,4,0,0,0
4948,7983,10269,51,11,3,8,5,2,3
4949,7983,9790,49,4,1,3,1,0,1
4950,8010,10189,60,6,4,2,2,2,0
4951,8010,9911,40,3,1,2,3,2,1
4952,8019,8226,56,5,2,3,4,2,2
4953,8019,8721,44,7,5,2,1,1,0
4954,8023,9904,45,4,4,0,2,0,2
4955,8023,9911,55,7,1,6,0,0,0
4956,8025,8178,61,5,3,2,3,2,1
4957,8025,9912,39,3,1,2,0,0,0
4958,8051,8226,40,5,3,2,2,1,1
4959,8051,9823,60,8,4,4,0,0,0
4960,8054,8721,41,6,1,5,3,3,0
4961,8054,8697,59,8,2,6,2,1,1
4962,8070,9823,61,5,2,3,1,1,0
4963,8070,8697,39,2,1,1,1,0,1
4964,8071,8178,52,6,3,3,4,2,2
4965,8071,9904,48,0,0,0,1,0,1
4966,8074,9790,59,6,1,5,1,1,0
4967,8074,8721,41,0,0,0,2,1,1
4968,8080,9789,49,4,2,2,2,2,0
4969,8080,10269,51,7,3,4,1,1,0
4970,8084,8722,44,7,4,3,3,0,3
4971,8084,10189,56,1,0,1,0,0,0
4972,8097,9790,42,5,3,2,3,1,2
4973,8097,10189,58,3,2,1,2,1,1
4974,8098,9789,37,3,2,1,5,2,3
4975,8098,8697,63,11,3,8,1,0,1
4976,8106,9823,68,5,2,3,1,0,1
4977,8106,8721,32,5,3,2,0,0,0
4978,8107,8178,60,4,2,2,3,2,1
4979,8107,8722,40,7,3,4,1,0,1
4980,8114,9790,47,5,1,4,3,2,1
4981,8114,8226,53,7,5,2,1,0,1
4982,8125,8178,66,5,1,4,1,1,0
4983,8125,9789,34,0,0,0,4,0,4
4984,8126,8177,51,7,4,3,1,0,1
4985,8126,8721,49,5,1,4,0,0,0
4986,8127,10189,31,8,4,4,1,1,0
4987,8127,9790,69,3,2,1,1,0,1
4988,8134,8177,43,5,4,1,1,1,0
4989,8134,9789,57,10,3,7,1,0,1
4990,8136,10189,52,6,1,5,2,1,1
4991,8136,8178,48,3,2,1,2,1,1
4992,8142,10189,43,3,2,1,2,0,2
4993,8142,9823,57,4,3,1,0,0,0
4994,8143,8178,49,7,5,2,1,1,0
4995,8143,9810,51,3,3,0,0,0,0
4996,8144,8697,55,7,3,4,1,0,1
4997,8144,9789,45,6,2,4,1,0,1
4998,8151,8178,53,3,2,1,3,3,0
4999,8151,9823,47,4,2,2,0,0,0
5000,8164,9911,35,5,1,4,5,3,2
5001,8164,8722,65,2,2,0,0,0,0
5002,8169,9823,47,9,3,6,1,0,1
5003,8169,9788,53,9,8,1,0,0,0
5004,8173,8177,43,8,2,6,4,2,2
5005,8173,10189,57,6,2,4,1,0,1
5006,8179,8178,51,4,2,2,3,1,2
5007,8179,8177,49,2,2,0,0,0,0
5008,8192,10189,60,9,3,6,1,0,1
5009,8192,9905,40,2,2,0,0,0,0
5010,8196,8226,45,8,4,4,2,1,1
5011,8196,9823,55,9,3,6,0,0,0
5012,8205,9789,47,6,4,2,2,1,1
5013,8205,9790,53,4,1,3,1,0,1
5014,8206,9823,53,6,4,2,2,0,2
5015,8206,8697,47,11,6,5,0,0,0
5016,8208,8721,49,7,2,5,1,1,0
5017,8208,8722,51,4,4,0,1,0,1
5018,8214,9823,61,5,1,4,8,5,3
5019,8214,8697,39,2,0,2,0,0,0
5020,8224,8178,55,9,6,3,3,3,0
5021,8224,8358,45,3,2,1,1,1,0
5022,8225,9790,66,12,6,6,3,1,2
5023,8225,8721,34,2,2,0,0,0,0
5024,8226,9789,45,3,2,1,1,1,0
5025,8226,10269,55,2,1,1,0,0,0
5026,8232,9789,56,7,4,3,4,1,3
5027,8232,9810,44,2,2,0,1,1,0
5028,8233,8177,39,1,1,0,2,2,0
5029,8233,8697,61,9,4,5,2,1,1
5030,8245,8722,59,2,2,0,6,3,3
5031,8245,10189,41,2,0,2,0,0,0
5032,8246,8358,45,3,3,0,3,2,1
5033,8246,9810,55,5,3,2,0,0,0
5034,8250,9790,56,4,1,3,4,1,3
5035,8250,9810,44,2,0,2,4,0,4
5036,8252,8178,57,5,4,1,1,0,1
5037,8252,8697,43,4,4,0,0,0,0
5038,8259,9823,51,8,5,3,2,2,0
5039,8259,9790,49,3,2,1,4,1,3
5040,8260,8178,64,4,1,3,1,1,0
5041,8260,8722,36,1,1,0,1,0,1
5042,8270,8697,52,7,4,3,3,1,2
5043,8270,10269,48,4,1,3,1,0,1
5044,8274,9823,59,5,3,2,5,3,2
5045,8274,8722,41,3,2,1,0,0,0
5046,8275,8165,48,4,1,3,1,1,0
5047,8275,8178,52,8,1,7,1,0,1
5048,8278,8178,53,7,4,3,2,2,0
5049,8278,9790,47,3,1,2,4,0,4
5050,8285,8697,51,5,4,1,1,1,0
5051,8285,8226,49,3,1,2,1,1,0
5052,8286,9790,54,8,2,6,1,1,0
5053,8286,10189,46,8,4,4,4,3,1
5054,8287,8178,57,6,3,3,1,0,1
5055,8287,9789,43,3,0,3,1,0,1
5056,8295,9823,54,3,1,2,2,0,2
5057,8295,10269,46,7,1,6,1,0,1
5058,8296,8178,56,3,2,1,4,4,0
5059,8296,10189,44,1,0,1,0,0,0
5060,8299,9810,68,5,2,3,1,0,1
5061,8299,9911,32,0,0,0,0,0,0
5062,8311,8722,47,5,4,1,3,0,3
5063,8311,8177,53,1,0,1,0,0,0
5064,8322,8178,45,4,3,1,1,1,0
5065,8322,9823,55,2,0,2,2,1,1
5066,8325,8165,54,14,2,12,1,1,0
5067,8325,8721,46,1,0,1,4,2,2
5068,8327,10189,61,3,2,1,4,1,3
5069,8327,9904,39,2,1,1,1,0,1
5070,8329,9788,53,5,2,3,2,1,1
5071,8329,9810,47,2,0,2,0,0,0
5072,8331,9823,64,10,5,5,1,0,1
5073,8331,9904,36,1,0,1,2,0,2
5074,8339,8722,52,6,3,3,2,2,0
5075,8339,9911,48,4,2,2,2,0,2
5076,8345,10269,58,4,2,2,1,1,0
5077,8345,9911,42,3,2,1,2,0,2
5078,8354,8697,47,2,2,0,2,1,1
5079,8354,10189,53,4,0,4,1,1,0
5080,8358,8697,47,17,10,7,3,2,1
5081,8358,9790,53,5,2,3,2,1,1
5082,8359,9823,55,7,6,1,2,0,2
5083,8359,8177,45,7,3,4,0,0,0
5084,8363,9911,56,9,4,5,3,3,0
5085,8363,9904,44,3,0,3,0,0,0
5086,8364,10189,63,6,2,4,2,1,1
5087,8364,9905,37,8,5,3,0,0,0
5088,8367,9823,68,5,2,3,2,1,1
5089,8367,8721,32,6,1,5,2,0,2
5090,8369,8722,49,5,2,3,2,1,1
5091,8369,9790,51,5,3,2,0,0,0
5092,8375,9788,61,6,1,5,2,1,1
5093,8375,9905,39,2,0,2,1,0,1
5094,8376,10269,41,3,1,2,1,0,1
5095,8376,9790,59,11,2,9,2,0,2
5096,8381,8722,52,6,1,5,2,1,1
5097,8381,10189,48,0,0,0,2,0,2
5098,8386,8178,48,4,2,2,1,1,0
5099,8386,8697,52,1,1,0,0,0,0
5100,8389,8721,52,5,3,2,1,1,0
5101,8389,10189,48,5,0,5,2,0,2
5102,8394,9823,61,5,3,2,1,1,0
5103,8394,9790,39,6,3,3,0,0,0
5104,8398,8358,46,8,7,1,3,2,1
5105,8398,9788,54,3,0,3,1,1,0
5106,8401,8165,68,5,2,3,1,1,0
5107,8401,9911,32,3,2,1,3,2,1
5108,8407,10189,46,5,3,2,1,1,0
5109,8407,9810,54,4,1,3,1,0,1
5110,8412,9790,55,3,2,1,4,2,2
5111,8412,8178,45,3,1,2,0,0,0
5112,8417,9823,60,6,4,2,3,1,2
5113,8417,8358,40,1,0,1,1,1,0
5114,8421,9823,63,7,3,4,2,1,1
5115,8421,8721,37,5,1,4,0,0,0
5116,8422,8226,48,4,3,1,3,1,2
5117,8422,8697,52,5,1,4,0,0,0
5118,8427,9790,49,7,4,3,3,1,2
5119,8427,10189,51,5,3,2,0,0,0
5120,8430,9823,60,1,0,1,2,1,1
5121,8430,8358,40,1,0,1,0,0,0
5122,8433,10269,45,9,5,4,4,1,3
5123,8433,8721,55,8,5,3,0,0,0
5124,8434,9789,55,5,4,1,2,1,1
5125,8434,9905,45,4,1,3,0,0,0
5126,8435,9904,40,2,1,1,4,2,2
5127,8435,8226,60,6,4,2,0,0,0
5128,8439,10189,55,4,2,2,1,1,0
5129,8439,8152,45,0,0,0,3,0,3
5130,8440,8178,60,10,8,2,2,1,1
5131,8440,8350,40,6,3,3,2,1,1
5132,8441,10269,37,6,3,3,3,0,3
5133,8441,8697,63,3,1,2,1,0,1
5134,8446,9789,57,9,3,6,1,0,1
5135,8446,9904,43,2,0,2,0,0,0
5136,8448,8165,38,4,2,2,1,0,1
5137,8448,9823,62,5,2,3,1,0,1
5138,8458,8178,39,8,4,4,2,2,0
5139,8458,9823,61,3,1,2,2,0,2
5140,8465,8152,41,10,3,7,1,1,0
5141,8465,8721,59,1,0,1,5,1,4
5142,8466,9823,74,9,3,6,1,1,0
5143,8466,9810,26,3,1,2,0,0,0
5144,8467,8697,41,5,5,0,1,1,0
5145,8467,8152,59,9,2,7,3,0,3
5146,8472,8722,54,10,6,4,4,2,2
5147,8472,8721,46,3,2,1,3,1,2
5148,8478,8721,58,4,3,1,1,1,0
5149,8478,8697,42,11,2,9,0,0,0
5150,8482,9789,55,9,5,4,4,1,3
5151,8482,8165,45,2,2,0,1,1,0
5152,8484,9823,58,11,4,7,1,0,1
5153,8484,8152,42,3,0,3,0,0,0
5154,8487,9905,56,4,3,1,3,1,2
5155,8487,10189,44,4,2,2,0,0,0
5156,8490,8358,48,8,7,1,3,1,2
5157,8490,9788,52,5,3,2,2,1,1
5158,8495,8358,43,3,2,1,1,1,0
5159,8495,8178,57,6,3,3,2,0,2
5160,8502,10189,45,2,2,0,1,1,0
5161,8502,9790,55,3,2,1,1,0,1
5162,8506,8721,38,3,2,1,2,0,2
5163,8506,9823,62,8,4,4,1,0,1
5164,8513,9810,41,3,3,0,2,1,1
5165,8513,9790,59,3,1,2,1,1,0
5166,8515,8152,32,7,5,2,1,1,0
5167,8515,8226,68,4,1,3,0,0,0
5168,8516,9788,34,8,2,6,1,1,0
5169,8516,8178,66,3,1,2,0,0,0
5170,8517,8722,52,4,1,3,2,1,1
5171,8517,8697,48,2,0,2,0,0,0
5172,8520,10189,59,6,2,4,2,1,1
5173,8520,9904,41,2,1,1,2,1,1
5174,8527,9823,72,9,4,5,4,2,2
5175,8527,8350,28,3,1,2,1,0,1
5176,8531,9904,43,4,2,2,4,3,1
5177,8531,8178,57,7,5,2,4,1,3
5178,8532,8358,46,3,3,0,1,1,0
5179,8532,10269,54,6,3,3,0,0,0
5180,8534,9810,65,4,3,1,1,1,0
5181,8534,9788,35,5,0,5,0,0,0
5182,8536,9905,52,10,3,7,3,2,1
5183,8536,8350,48,11,4,7,0,0,0
5184,8538,9789,59,11,6,5,1,1,0
5185,8538,10189,41,2,0,2,1,0,1
5186,8539,9790,67,15,8,7,2,2,0
5187,8539,8152,33,3,1,2,2,1,1
5188,8544,8358,45,6,3,3,1,1,0
5189,8544,9810,55,2,2,0,2,1,1
5190,8549,8697,65,6,3,3,2,1,1
5191,8549,9904,35,2,0,2,1,0,1
5192,8553,8722,39,6,2,4,4,2,2
5193,8553,9905,61,2,1,1,1,0,1
5194,8556,10269,42,4,3,1,5,1,4
5195,8556,8178,58,4,3,1,0,0,0
5196,8559,9905,42,10,5,5,1,1,0
5197,8559,9823,58,8,4,4,4,0,4
5198,8561,9788,52,6,4,2,1,0,1
5199,8561,10189,48,0,0,0,0,0,0
5200,8567,8697,42,8,5,3,2,0,2
5201,8567,8178,58,8,4,4,0,0,0
5202,8569,9810,59,15,4,11,2,1,1
5203,8569,10269,41,7,2,5,1,0,1
5204,8577,9790,52,1,1,0,1,0,1
5205,8577,9905,48,4,2,2,0,0,0
5206,8580,8697,43,6,2,4,1,1,0
5207,8580,8358,57,1,0,1,0,0,0
5208,8587,8178,48,9,6,3,2,1,1
5209,8587,9905,52,1,1,0,1,1,0
5210,8589,9904,56,5,5,0,1,1,0
5211,8589,8722,44,4,2,2,1,0,1
5212,8598,8358,44,4,2,2,1,0,1
5213,8598,9823,56,7,0,7,1,0,1
5214,8604,9810,37,4,2,2,3,1,2
5215,8604,8721,63,9,4,5,0,0,0
5216,8606,9790,49,4,2,2,1,1,0
5217,8606,8226,51,8,6,2,1,0,1
5218,8607,8165,56,6,4,2,5,1,4
5219,8607,8722,44,4,1,3,1,0,1
5220,8620,9789,67,10,4,6,3,2,1
5221,8620,8721,33,1,0,1,1,0,1
5222,8622,8350,34,8,6,2,1,1,0
5223,8622,9905,66,5,2,3,1,0,1
5224,8623,8226,51,9,5,4,1,0,1
5225,8623,10189,49,4,1,3,0,0,0
5226,8625,8152,52,5,1,4,2,2,0
5227,8625,8722,48,9,5,4,0,0,0
5228,8628,8178,60,2,0,2,4,2,2
5229,8628,9823,40,0,0,0,0,0,0
5230,8629,10189,41,7,2,5,1,1,0
5231,8629,8697,59,8,3,5,0,0,0
5232,8630,9789,53,2,2,0,2,2,0
5233,8630,8358,47,3,1,2,0,0,0
5234,8633,9905,54,5,3,2,2,2,0
5235,8633,9788,46,5,3,2,2,1,1
5236,8640,8722,43,5,2,3,2,2,0
5237,8640,8721,57,6,3,3,1,1,0
5238,8642,9789,51,10,5,5,2,1,1
5239,8642,9788,49,1,0,1,0,0,0
5240,8643,9904,40,3,2,1,3,2,1
5241,8643,8358,60,6,2,4,1,0,1
5242,8644,8165,63,4,2,2,9,3,6
5243,8644,9905,37,2,2,0,1,0,1
5244,8646,9823,58,7,3,4,2,1,1
5245,8646,10189,42,1,0,1,4,0,4
5246,8648,9789,55,5,3,2,1,0,1
5247,8648,8165,45,3,0,3,0,0,0
5248,8656,8697,45,4,3,1,2,1,1
5249,8656,9789,55,4,1,3,1,1,0
5250,8663,9823,49,5,3,2,3,3,0
5251,8663,8152,51,5,2,3,2,1,1
5252,8667,9789,63,8,4,4,1,1,0
5253,8667,9810,37,3,2,1,1,0,1
5254,8673,9823,78,14,5,9,2,1,1
5255,8673,8722,22,5,1,4,2,0,2
5256,8674,9789,41,11,8,3,4,3,1
5257,8674,10189,59,1,0,1,2,1,1
5258,8681,9790,58,2,1,1,6,2,4
5259,8681,8152,42,2,2,0,0,0,0
5260,8683,8350,44,3,1,2,4,2,2
5261,8683,9789,56,8,4,4,1,1,0
5262,8686,8226,22,4,4,0,1,0,1
5263,8686,9823,78,3,2,1,1,0,1
5264,8691,9823,72,7,1,6,2,2,0
5265,8691,9905,28,3,2,1,6,3,3
5266,8701,9823,63,6,2,4,3,2,1
5267,8701,9789,37,1,0,1,1,0,1
5268,8703,9790,60,4,1,3,2,1,1
5269,8703,8350,40,2,0,2,2,0,2
5270,8712,8721,52,5,3,2,1,1,0
5271,8712,8178,48,6,1,5,3,1,2
5272,8714,8226,64,11,4,7,4,1,3
5273,8714,9788,36,3,3,0,2,0,2
5274,8716,8350,37,6,2,4,3,0,3
5275,8716,9810,63,4,1,3,0,0,0
5276,8719,8226,36,5,2,3,4,2,2
5277,8719,9789,64,3,0,3,0,0,0
5278,8727,9789,55,3,2,1,2,1,1
5279,8727,9790,45,1,0,1,0,0,0
5280,8734,8165,48,7,1,6,2,1,1
5281,8734,8177,52,1,0,1,0,0,0
5282,8735,9823,58,10,5,5,3,1,2
5283,8735,9788,42,4,4,0,0,0,0
5284,8736,9789,57,6,3,3,2,1,1
5285,8736,8722,43,2,0,2,2,1,1
5286,8737,8178,58,6,3,3,4,2,2
5287,8737,10189,42,6,4,2,1,0,1
5288,8739,9823,63,9,3,6,4,2,2
5289,8739,9904,37,2,0,2,0,0,0
5290,8743,8406,36,5,5,0,2,1,1
5291,8743,8697,64,9,4,5,0,0,0
5292,8747,8350,48,6,4,2,1,1,0
5293,8747,9790,52,7,3,4,0,0,0
5294,8750,10269,43,10,3,7,1,1,0
5295,8750,9789,57,6,1,5,1,0,1
5296,8751,8406,42,6,2,4,3,1,2
5297,8751,8722,58,0,0,0,2,1,1
5298,8754,9789,59,9,3,6,1,0,1
5299,8754,8721,41,3,1,2,3,0,3
5300,8756,8178,48,4,2,2,1,1,0
5301,8756,9790,52,5,2,3,1,0,1
5302,8770,8721,52,6,4,2,1,1,0
5303,8770,9904,48,5,3,2,0,0,0
5304,8773,8697,52,7,4,3,4,2,2
5305,8773,10269,48,6,3,3,0,0,0
5306,8778,9788,65,8,2,6,3,1,2
5307,8778,8722,35,5,3,2,1,1,0
5308,8781,8178,57,7,5,2,1,1,0
5309,8781,8226,43,3,2,1,4,3,1
5310,8787,10269,62,9,3,6,2,0,2
5311,8787,8722,38,5,2,3,0,0,0
5312,8789,9788,56,3,2,1,2,1,1
5313,8789,9789,44,5,3,2,2,0,2
5314,8791,8721,46,8,4,4,1,1,0
5315,8791,8697,54,9,5,4,0,0,0
5316,8795,9823,74,7,3,4,4,2,2
5317,8795,10269,26,1,0,1,0,0,0
5318,8798,8177,59,9,7,2,1,0,1
5319,8798,10189,41,3,1,2,0,0,0
5320,8800,9823,74,6,6,0,3,2,1
5321,8800,8722,26,1,0,1,1,0,1
5322,8808,9905,38,4,2,2,1,0,1
5323,8808,8178,62,2,0,2,1,0,1
5324,8810,9789,41,6,2,4,2,1,1
5325,8810,9790,59,1,0,1,0,0,0
5326,8813,8350,58,7,4,3,3,1,2
5327,8813,8697,42,8,2,6,2,0,2
5328,8815,8721,46,10,5,5,3,0,3
5329,8815,8722,54,4,4,0,0,0,0
5330,8816,9823,63,10,7,3,5,2,3
5331,8816,9788,37,2,0,2,0,0,0
5332,8817,9789,52,11,9,2,1,0,1
5333,8817,8226,48,5,2,3,1,0,1
5334,8823,8722,43,4,1,3,2,1,1
5335,8823,10189,57,5,2,3,1,1,0
5336,8826,8178,55,6,3,3,1,1,0
5337,8826,8697,45,6,2,4,1,0,1
5338,8831,8350,69,9,4,5,2,1,1
5339,8831,8406,31,5,3,2,0,0,0
5340,8836,9905,49,3,3,0,3,2,1
5341,8836,10189,51,5,3,2,1,0,1
5342,8839,8358,49,11,2,9,3,1,2
5343,8839,8697,51,1,0,1,3,1,2
5344,8840,8350,54,4,2,2,2,2,0
5345,8840,8722,46,6,2,4,0,0,0
5346,8844,9789,49,5,2,3,3,1,2
5347,8844,8178,51,1,0,1,1,0,1
5348,8849,9790,71,9,5,4,2,2,0
5349,8849,8722,29,7,2,5,0,0,0
5350,8851,9788,60,2,1,1,2,1,1
5351,8851,10189,40,2,0,2,1,1,0
5352,8852,8406,57,6,4,2,2,2,0
5353,8852,8165,43,5,0,5,2,0,2
5354,8854,8721,38,6,2,4,2,1,1
5355,8854,10189,62,6,2,4,1,0,1
5356,8861,9789,61,8,6,2,2,0,2
5357,8861,8177,39,3,1,2,0,0,0
5358,8862,9904,48,1,1,0,2,2,0
5359,8862,9789,52,7,2,5,2,0,2
5360,8863,9823,62,11,8,3,2,1,1
5361,8863,10189,38,4,3,1,1,0,1
5362,8864,8697,63,10,4,6,1,1,0
5363,8864,8165,37,4,1,3,1,1,0
5364,8867,8178,55,8,3,5,2,1,1
5365,8867,8722,45,7,2,5,1,1,0
5366,8871,9789,61,7,3,4,1,1,0
5367,8871,9905,39,2,0,2,2,0,2
5368,8872,9823,53,8,5,3,2,1,1
5369,8872,8178,47,6,3,3,0,0,0
5370,8878,8226,55,10,6,4,2,1,1
5371,8878,8722,45,3,1,2,0,0,0
5372,8880,9823,60,8,4,4,3,0,3
5373,8880,8226,40,1,0,1,0,0,0
5374,8881,9790,54,11,7,4,1,1,0
5375,8881,10189,46,6,5,1,1,0,1
5376,8882,8697,51,4,3,1,1,1,0
5377,8882,9904,49,8,6,2,1,0,1
5378,8888,8406,41,2,1,1,2,1,1
5379,8888,9789,59,4,1,3,0,0,0
5380,8889,9789,54,5,3,2,3,2,1
5381,8889,8697,46,2,1,1,1,0,1
5382,8892,9904,56,13,7,6,2,1,1
5383,8892,8722,44,9,4,5,1,1,0
5384,8895,10269,46,7,4,3,2,0,2
5385,8895,8226,54,7,2,5,0,0,0
5386,8897,9823,71,8,4,4,1,1,0
5387,8897,8177,29,3,2,1,2,1,1
5388,8899,10189,54,9,4,5,1,1,0
5389,8899,8178,46,5,2,3,2,2,0
5390,8907,9789,54,14,9,5,1,1,0
5391,8907,10269,46,1,1,0,2,0,2
5392,8911,8165,42,5,4,1,2,2,0
5393,8911,9823,58,3,0,3,1,1,0
5394,8914,8721,58,4,3,1,2,0,2
5395,8914,8177,42,6,2,4,0,0,0
5396,8918,8178,45,9,3,6,1,1,0
5397,8918,9790,55,6,0,6,3,2,1
5398,8923,8721,43,5,2,3,1,1,0
5399,8923,9789,57,2,1,1,2,1,1
5400,8924,9788,72,5,3,2,2,2,0
5401,8924,8177,28,5,1,4,2,1,1
5402,8926,9823,63,11,6,5,4,2,2
5403,8926,9790,37,2,1,1,1,1,0
5404,8928,9904,54,6,1,5,2,1,1
5405,8928,8177,46,4,0,4,4,2,2
5406,8929,9905,49,7,5,2,2,1,1
5407,8929,10189,51,7,2,5,2,1,1
5408,8931,8722,48,8,5,3,2,1,1
5409,8931,8350,52,7,4,3,0,0,0
5410,8932,8721,39,2,1,1,2,0,2
5411,8932,9788,61,9,5,4,0,0,0
5412,8934,9823,52,3,2,1,1,1,0
5413,8934,9789,48,6,4,2,0,0,0
5414,8953,9823,60,4,2,2,1,1,0
5415,8953,8697,40,4,1,3,0,0,0
5416,8955,9905,55,10,6,4,3,2,1
5417,8955,8721,45,4,2,2,3,1,2
5418,8970,9789,59,3,2,1,3,0,3
5419,8970,8358,41,5,3,2,0,0,0
5420,8979,8178,51,12,8,4,2,1,1
5421,8979,9789,49,5,2,3,1,1,0
5422,8987,8177,48,6,2,4,1,0,1
5423,8987,10269,52,9,4,5,0,0,0
5424,8990,9790,52,4,2,2,2,1,1
5425,8990,8697,48,8,4,4,1,0,1
5426,8994,10189,55,2,1,1,1,1,0
5427,8994,8721,45,3,2,1,1,0,1
5428,8996,8178,64,6,3,3,4,3,1
5429,8996,8406,36,7,1,6,0,0,0
5430,8997,8178,62,8,5,3,1,0,1
5431,8997,8722,38,2,0,2,0,0,0
5432,8998,9823,66,8,4,4,1,1,0
5433,8998,10189,34,2,0,2,1,1,0
5434,9000,9789,63,7,7,0,2,2,0
5435,9000,9904,37,8,3,5,1,0,1
5436,9003,8350,48,8,4,4,1,1,0
5437,9003,9905,52,4,1,3,4,1,3
5438,9010,9790,47,6,2,4,6,4,2
5439,9010,10269,53,6,4,2,0,0,0
5440,9017,9790,52,10,5,5,2,1,1
5441,9017,10189,48,2,0,2,0,0,0
5442,9018,8697,58,6,4,2,2,2,0
5443,9018,9904,42,5,1,4,1,0,1
5444,9021,8350,52,8,2,6,3,1,2
5445,9021,10269,48,3,0,3,0,0,0
5446,9022,8226,45,6,4,2,2,1,1
5447,9022,9823,55,2,0,2,1,0,1
5448,9023,8177,46,2,1,1,1,0,1
5449,9023,8722,54,2,1,1,0,0,0
5450,9026,9789,51,5,4,1,1,0,1
5451,9026,8697,49,10,3,7,0,0,0
5452,9028,8358,65,7,5,2,3,1,2
5453,9028,9790,35,5,2,3,0,0,0
5454,9030,8722,46,3,2,1,3,0,3
5455,9030,9904,54,7,3,4,0,0,0
5456,9645,8721,32,4,2,2,5,4,1
5457,9645,9823,68,14,7,7,0,0,0
5458,9649,10189,54,7,3,4,1,1,0
5459,9649,9904,46,3,2,1,2,1,1
5460,9650,8177,56,6,4,2,2,2,0
5461,9650,8697,44,2,0,2,2,2,0
5462,9651,9810,38,5,2,3,1,0,1
5463,9651,8358,62,9,2,7,0,0,0
5464,9652,9790,56,8,4,4,3,1,2
5465,9652,8722,44,5,2,3,2,0,2
5466,9654,9823,56,14,7,7,5,3,2
5467,9654,9789,44,2,1,1,1,0,1
5468,9655,8406,51,11,6,5,5,3,2
5469,9655,10189,49,9,2,7,0,0,0
5470,9656,8226,49,7,5,2,1,0,1
5471,9656,9788,51,6,2,4,2,0,2
5472,9657,9905,58,12,3,9,1,0,1
5473,9657,8697,42,4,2,2,0,0,0
5474,9658,9904,65,8,3,5,3,3,0
5475,9658,9810,35,5,1,4,1,0,1
5476,9659,10269,57,4,3,1,1,1,0
5477,9659,8721,43,4,0,4,0,0,0
5478,9662,8460,52,5,3,2,1,0,1
5479,9662,8177,48,3,2,1,0,0,0
5480,9665,9790,38,7,3,4,2,1,1
5481,9665,8721,62,7,4,3,1,1,0
5482,9666,8406,44,4,3,1,1,1,0
5483,9666,8460,56,6,5,1,2,0,2
5484,9668,9904,56,4,3,1,1,0,1
5485,9668,8177,44,2,2,0,1,0,1
5486,9669,8697,47,2,1,1,3,2,1
5487,9669,10269,53,1,1,0,3,1,2
5488,9670,9823,65,11,4,7,3,2,1
5489,9670,9810,35,3,2,1,1,1,0
5490,9671,8358,53,8,3,5,4,2,2
5491,9671,10189,47,4,3,1,1,0,1
5492,9672,9823,65,6,2,4,4,4,0
5493,9672,8226,35,6,3,3,0,0,0
5494,9674,9788,53,4,2,2,3,2,1
5495,9674,9810,47,11,4,7,2,1,1
5496,9675,8358,38,6,2,4,2,1,1
5497,9675,9905,62,2,1,1,1,1,0
5498,9676,9904,58,6,4,2,2,0,2
5499,9676,8178,42,6,1,5,1,0,1
5500,9677,10269,44,3,1,2,3,1,2
5501,9677,8406,56,10,3,7,1,0,1
5502,9678,9790,63,5,3,2,2,1,1
5503,9678,8697,37,8,4,4,1,0,1
5504,9680,8460,40,2,1,1,1,1,0
5505,9680,9789,60,4,1,3,5,1,4
5506,9682,8178,64,13,8,5,3,2,1
5507,9682,8722,36,0,0,0,1,1,0
5508,9683,9788,64,7,5,2,1,1,0
5509,9683,8721,36,13,5,8,0,0,0
5510,9684,8406,52,5,3,2,1,1,0
5511,9684,9790,48,3,0,3,3,0,3
5512,9685,8226,52,4,1,3,2,2,0
5513,9685,9904,48,2,1,1,0,0,0
5514,9686,9823,74,6,4,2,3,2,1
5515,9686,8177,26,1,0,1,2,1,1
5516,9689,8358,57,10,6,4,3,2,1
5517,9689,10269,43,8,2,6,1,0,1
5518,9690,8178,32,1,1,0,3,1,2
5519,9690,9823,68,6,2,4,3,2,1
5520,9691,9789,47,12,3,9,3,0,3
5521,9691,8226,53,4,2,2,1,0,1
5522,9692,8177,35,4,2,2,3,1,2
5523,9692,9788,65,9,4,5,1,0,1
5524,9697,8722,38,6,4,2,1,0,1
5525,9697,8406,62,3,1,2,1,0,1
5526,9698,8460,64,11,6,5,2,1,1
5527,9698,8358,36,1,0,1,1,1,0
5528,9699,10189,54,6,2,4,1,0,1
5529,9699,8722,46,3,0,3,1,0,1
5530,9701,8721,68,10,3,7,1,1,0
5531,9701,8460,32,2,1,1,5,2,3
5532,9705,8177,38,2,2,0,1,1,0
5533,9705,9789,62,7,1,6,1,0,1
5534,9707,9790,57,5,2,3,2,1,1
5535,9707,8358,43,5,1,4,1,0,1
5536,9708,9823,78,15,7,8,2,2,0
5537,9708,8358,22,1,0,1,0,0,0
5538,9709,8721,64,6,4,2,1,1,0
5539,9709,9789,36,8,1,7,0,0,0
5540,9710,8697,34,5,3,2,4,2,2
5541,9710,9788,66,4,0,4,1,1,0
5542,9713,9810,75,8,1,7,1,1,0
5543,9713,8177,25,1,0,1,0,0,0
5544,9714,10269,45,7,5,2,2,1,1
5545,9714,9790,55,4,0,4,3,1,2
5546,9715,9905,49,4,2,2,1,0,1
5547,9715,8722,51,2,0,2,0,0,0
5548,9716,10189,55,9,4,5,1,1,0
5549,9716,8460,45,6,1,5,3,2,1
5550,9718,8178,52,9,2,7,1,1,0
5551,9718,9810,48,5,4,1,2,1,1
5552,9720,9823,66,7,2,5,1,1,0
5553,9720,9905,34,5,2,3,2,0,2
5554,9721,9788,38,7,2,5,3,1,2
5555,9721,8406,62,10,3,7,0,0,0
5556,9723,8697,36,4,3,1,1,0,1
5557,9723,9789,64,8,3,5,0,0,0
5558,9727,8178,60,5,5,0,3,1,2
5559,9727,9789,40,3,2,1,0,0,0
5560,9728,9823,68,7,4,3,2,1,1
5561,9728,8721,32,2,0,2,3,0,3
5562,9729,9905,55,7,2,5,1,1,0
5563,9729,8460,45,2,2,0,3,1,2
5564,9732,9810,48,5,5,0,1,1,0
5565,9732,8358,52,6,1,5,1,0,1
5566,9733,9788,61,2,2,0,1,1,0
5567,9733,10269,39,4,3,1,0,0,0
5568,9734,9790,49,3,2,1,2,1,1
5569,9734,8722,51,5,2,3,0,0,0
5570,9735,10189,39,4,4,0,3,1,2
5571,9735,9823,61,2,1,1,0,0,0
5572,9736,8406,54,2,1,1,1,0,1
5573,9736,9789,46,9,2,7,1,0,1
5574,9737,9788,44,4,4,0,2,0,2
5575,9737,8358,56,9,8,1,1,0,1
5576,9738,8697,40,5,2,3,2,1,1
5577,9738,8226,60,5,3,2,0,0,0
5578,9739,9904,56,4,1,3,1,1,0
5579,9739,9905,44,9,2,7,1,0,1
5580,9741,8721,51,3,2,1,2,1,1
5581,9741,9810,49,6,1,5,2,1,1
5582,9743,8460,65,7,5,2,1,1,0
5583,9743,9790,35,3,1,2,1,0,1
5584,9744,9823,60,4,3,1,1,1,0
5585,9744,10189,40,3,0,3,1,0,1
5586,9745,8178,70,7,6,1,1,1,0
5587,9745,8177,30,1,1,0,1,1,0
5588,9746,8721,58,10,5,5,3,2,1
5589,9746,9810,42,5,2,3,0,0,0
5590,9747,9904,47,8,4,4,1,1,0
5591,9747,9905,53,4,0,4,1,0,1
5592,9749,8226,53,5,3,2,4,2,2
5593,9749,8697,47,4,3,1,2,0,2
5594,9750,9788,47,3,3,0,1,1,0
5595,9750,8358,53,5,2,3,0,0,0
5596,9751,10269,68,9,4,5,2,1,1
5597,9751,8722,32,1,1,0,0,0,0
5598,9752,8460,40,3,3,0,2,2,0
5599,9752,9790,60,3,1,2,0,0,0
5600,9753,9788,70,6,3,3,3,2,1
5601,9753,10189,30,4,2,2,2,1,1
5602,9755,9905,57,3,1,2,2,0,2
5603,9755,8177,43,3,1,2,0,0,0
5604,9756,9810,57,4,2,2,3,1,2
5605,9756,8406,43,5,3,2,1,0,1
5606,9757,8697,41,3,2,1,2,1,1
5607,9757,8178,59,5,3,2,1,0,1
5608,9759,10269,27,1,1,0,1,1,0
5609,9759,9823,73,2,0,2,4,0,4
5610,9760,9904,68,5,2,3,1,1,0
5611,9760,9790,32,2,0,2,1,0,1
5612,9762,9823,70,12,6,6,1,0,1
5613,9762,9790,30,3,1,2,1,0,1
5614,9763,9789,59,8,5,3,1,1,0
5615,9763,9905,41,2,1,1,3,0,3
5616,9765,9788,58,15,6,9,2,0,2
5617,9765,8722,42,6,4,2,0,0,0
5618,9766,8226,40,10,2,8,1,1,0
5619,9766,10269,60,4,2,2,1,0,1
5620,9769,8697,41,6,4,2,1,1,0
5621,9769,8406,59,3,0,3,2,1,1
5622,9770,9810,55,3,2,1,2,1,1
5623,9770,10189,45,7,3,4,2,0,2
5624,9774,8178,43,10,5,5,2,1,1
5625,9774,8406,57,8,2,6,2,1,1
5626,9776,9789,59,6,4,2,1,1,0
5627,9776,10269,41,0,0,0,0,0,0
5628,9779,8460,31,4,2,2,3,2,1
5629,9779,9823,69,6,2,4,1,0,1
5630,9780,9823,80,11,6,5,2,1,1
5631,9780,8722,20,5,1,4,1,0,1
5632,9785,9904,48,6,4,2,2,1,1
5633,9785,10269,52,1,0,1,4,1,3
5634,9787,8721,62,3,3,0,5,1,4
5635,9787,8697,38,5,2,3,0,0,0
5636,9789,8226,36,6,3,3,3,1,2
5637,9789,10189,64,4,3,1,1,0,1
5638,9790,9905,44,7,2,5,5,1,4
5639,9790,9788,56,2,0,2,0,0,0
5640,9792,9823,72,3,1,2,2,0,2
5641,9792,9904,28,0,0,0,0,0,0
5642,9795,9790,38,2,1,1,2,0,2
5643,9795,9789,62,4,3,1,0,0,0
5644,9796,8722,32,2,1,1,5,2,3
5645,9796,9810,68,4,0,4,1,0,1
5646,9797,8178,62,3,1,2,3,2,1
5647,9797,8460,38,6,3,3,1,1,0
5648,9798,9789,69,5,2,3,1,1,0
5649,9798,8722,31,4,2,2,0,0,0
5650,9799,10269,46,8,4,4,3,1,2
5651,9799,8178,54,4,0,4,0,0,0
5652,9801,9788,72,11,6,5,2,1,1
5653,9801,9904,28,3,1,2,0,0,0
5654,9802,9905,43,8,4,4,2,1,1
5655,9802,8406,57,4,1,3,0,0,0
5656,9803,8226,65,8,2,6,2,1,1
5657,9803,9790,35,6,1,5,0,0,0
5658,9804,10189,69,5,2,3,3,1,2
5659,9804,8177,31,8,1,7,3,1,2
5660,9805,9823,71,4,4,0,2,0,2
5661,9805,8697,29,4,1,3,1,0,1
5662,9806,9810,63,3,3,0,1,0,1
5663,9806,8460,37,4,1,3,1,0,1
5664,9807,9823,67,11,6,5,3,2,1
5665,9807,9788,33,2,0,2,1,1,0
5666,9808,10189,53,6,2,4,2,1,1
5667,9808,8178,47,9,5,4,0,0,0
5668,9809,9905,42,8,2,6,1,1,0
5669,9809,8721,58,2,0,2,3,1,2
5670,9810,9789,47,5,2,3,1,1,0
5671,9810,9904,53,7,3,4,0,0,0
5672,9812,9810,53,6,3,3,2,0,2
5673,9812,10269,47,2,0,2,1,0,1
5674,9814,8697,49,4,2,2,1,1,0
5675,9814,8722,51,4,1,3,0,0,0
5676,9816,9823,59,1,1,0,3,1,2
5677,9816,9789,41,3,0,3,0,0,0
5678,9817,8178,51,8,2,6,5,1,4
5679,9817,9790,49,1,0,1,0,0,0
5680,9818,10269,49,5,3,2,1,0,1
5681,9818,8721,51,10,4,6,1,0,1
5682,9819,8406,43,9,3,6,2,1,1
5683,9819,10189,57,6,1,5,2,2,0
5684,9820,8226,30,5,1,4,2,0,2
5685,9820,9788,70,4,2,2,2,0,2
5686,9821,8177,58,4,1,3,1,0,1
5687,9821,8460,42,3,0,3,1,0,1
5688,9822,8697,51,5,2,3,2,1,1
5689,9822,9905,49,8,2,6,2,0,2
5690,9823,9904,64,10,4,6,1,1,0
5691,9823,9810,36,6,2,4,2,0,2
5692,9824,8722,48,7,1,6,2,0,2
5693,9824,8358,52,5,2,3,0,0,0
5694,9825,9823,61,9,6,3,2,2,0
5695,9825,9810,39,1,1,0,0,0,0
5696,9826,10189,65,11,1,10,2,1,1
5697,9826,8358,35,6,2,4,2,1,1
5698,9827,9788,48,4,1,3,1,0,1
5699,9827,9789,52,8,5,3,0,0,0
5700,9829,9904,62,4,2,2,3,1,2
5701,9829,8177,38,5,2,3,0,0,0
5702,9831,8721,45,9,4,5,1,0,1
5703,9831,9790,55,0,0,0,0,0,0
5704,9832,8226,54,11,8,3,3,1,2
5705,9832,8722,46,7,5,2,1,1,0
5706,9834,9789,62,8,4,4,1,0,1
5707,9834,8460,38,1,1,0,2,0,2
5708,9835,8178,55,13,9,4,3,2,1
5709,9835,9904,45,2,1,1,0,0,0
5710,9836,8721,48,13,7,6,3,0,3
5711,9836,10189,52,1,1,0,0,0,0
5712,9837,10269,38,8,4,4,3,2,1
5713,9837,8406,62,4,2,2,0,0,0
5714,9838,8226,26,3,3,0,1,1,0
5715,9838,9823,74,13,3,10,0,0,0
5716,9841,9788,56,6,3,3,1,1,0
5717,9841,9810,44,9,5,4,2,1,1
5718,9843,9823,64,5,3,2,3,3,0
5719,9843,10269,36,1,0,1,3,0,3
5720,9844,8358,32,2,1,1,4,2,2
5721,9844,9789,68,3,2,1,1,1,0
5722,9845,8178,54,12,8,4,2,0,2
5723,9845,8697,46,2,0,2,0,0,0
5724,9848,9904,60,3,1,2,2,2,0
5725,9848,9790,40,3,1,2,2,0,2
5726,9849,9905,54,2,2,0,1,1,0
5727,9849,8177,46,9,5,4,1,0,1
5728,9851,8460,47,5,4,1,5,2,3
5729,9851,8722,53,1,0,1,1,0,1
5730,9855,10189,52,6,4,2,2,2,0
5731,9855,9905,48,2,1,1,1,1,0
5732,9856,9904,53,5,3,2,2,2,0
5733,9856,8226,47,3,1,2,2,0,2
5734,9857,10269,57,3,2,1,1,0,1
5735,9857,8358,43,8,2,6,1,0,1
5736,9859,8178,57,5,5,0,1,1,0
5737,9859,8722,43,4,1,3,2,1,1
5738,9862,9823,54,7,3,4,1,0,1
5739,9862,8178,46,9,4,5,0,0,0
5740,9863,9904,42,8,2,6,1,1,0
5741,9863,8721,58,9,4,5,3,1,2
5742,9864,9905,55,3,2,1,1,1,0
5743,9864,9790,45,7,2,5,0,0,0
5744,9866,8226,49,4,3,1,1,1,0
5745,9866,9789,51,5,1,4,0,0,0
5746,9867,9788,75,6,3,3,2,2,0
5747,9867,8177,25,4,1,3,1,1,0
5748,9869,8460,35,5,4,1,3,2,1
5749,9869,8358,65,9,5,4,1,0,1
5750,9870,8406,30,3,2,1,2,1,1
5751,9870,9823,70,6,3,3,2,2,0
5752,9871,9789,51,7,3,4,2,1,1
5753,9871,8177,49,2,0,2,3,2,1
5754,9872,8178,41,6,4,2,3,2,1
5755,9872,9788,59,4,3,1,1,0,1
5756,9873,8697,45,4,3,1,1,0,1
5757,9873,9904,55,2,0,2,0,0,0
5758,9876,9790,54,9,3,6,2,1,1
5759,9876,8358,46,9,3,6,0,0,0
5760,9877,10189,58,2,2,0,3,2,1
5761,9877,8722,42,3,1,2,1,1,0
5762,9878,8460,52,5,2,3,1,1,0
5763,9878,8721,48,3,0,3,0,0,0
5764,9881,9789,52,9,5,4,3,2,1
5765,9881,8721,48,7,3,4,0,0,0
5766,9885,8697,34,10,5,5,6,4,2
5767,9885,9788,66,5,4,1,2,1,1
5768,9886,9823,76,6,3,3,3,1,2
5769,9886,8358,24,2,2,0,4,2,2
5770,9887,10269,64,11,5,6,2,2,0
5771,9887,9790,36,3,2,1,1,1,0
5772,9892,9904,53,8,3,5,4,1,3
5773,9892,8358,47,4,2,2,1,0,1
5774,9893,8178,51,10,5,5,3,1,2
5775,9893,9810,49,2,1,1,0,0,0
5776,9894,9790,62,6,3,3,2,0,2
5777,9894,10189,38,6,2,4,0,0,0
5778,9895,8722,40,4,4,0,1,0,1
5779,9895,8721,60,3,1,2,0,0,0
5780,9896,10269,54,5,3,2,1,1,0
5781,9896,8460,46,5,1,4,3,1,2
5782,9897,9810,35,6,2,4,1,1,0
5783,9897,10189,65,2,2,0,5,0,5
5784,9898,8178,41,5,3,2,4,4,0
5785,9898,8721,59,7,3,4,2,0,2
5786,9900,8406,56,5,3,2,1,1,0
5787,9900,8697,44,5,2,3,3,2,1
5788,9901,8358,55,9,4,5,2,1,1
5789,9901,8177,45,4,2,2,0,0,0
5790,9902,10269,66,4,2,2,1,1,0
5791,9902,8226,34,4,0,4,1,0,1
5792,9904,9788,66,4,2,2,1,0,1
5793,9904,8722,34,7,3,4,2,0,2
5794,9905,8460,38,8,3,5,1,1,0
5795,9905,9904,62,8,3,5,2,1,1
5796,9908,8406,55,5,1,4,1,1,0
5797,9908,8178,45,3,0,3,1,0,1
5798,9909,9788,54,14,3,11,3,1,2
5799,9909,9790,46,5,2,3,1,1,0
5800,9910,8226,54,6,2,4,3,1,2
5801,9910,8358,46,2,1,1,0,0,0
5802,9913,8697,47,6,4,2,5,2,3
5803,9913,10189,53,1,0,1,1,1,0
5804,9916,8697,44,5,1,4,3,1,2
5805,9916,8721,56,9,4,5,0,0,0
5806,9919,8358,52,5,3,2,3,2,1
5807,9919,8178,48,7,1,6,0,0,0
5808,9920,9904,44,2,1,1,3,1,2
5809,9920,10269,56,8,3,5,0,0,0
5810,9921,9790,70,9,4,5,3,2,1
5811,9921,9810,30,3,1,2,3,1,2
5812,9922,9823,69,12,6,6,2,1,1
5813,9922,8722,31,4,2,2,1,0,1
5814,9924,9823,66,8,3,5,4,2,2
5815,9924,9904,34,3,1,2,2,1,1
5816,9927,8406,43,2,2,0,1,1,0
5817,9927,8721,57,5,1,4,1,0,1
5818,9928,9788,65,11,3,8,2,2,0
5819,9928,9905,35,3,2,1,0,0,0
5820,9929,8226,39,12,7,5,1,1,0
5821,9929,10189,61,4,4,0,0,0,0
5822,9930,10269,42,4,2,2,5,1,4
5823,9930,8177,58,7,7,0,1,1,0
5824,9933,9823,76,7,3,4,1,1,0
5825,9933,8697,24,0,0,0,0,0,0
5826,9934,8177,56,9,4,5,1,1,0
5827,9934,10189,44,2,0,2,1,0,1
5828,9935,9905,49,6,5,1,3,2,1
5829,9935,8406,51,8,2,6,1,0,1
5830,9936,9904,53,8,4,4,2,0,2
5831,9936,9788,47,2,1,1,0,0,0
5832,9937,8358,48,9,5,4,1,0,1
5833,9937,8721,52,9,4,5,0,0,0
5834,9942,9789,53,5,2,3,2,0,2
5835,9942,9904,47,2,0,2,0,0,0
5836,9943,8178,57,13,7,6,1,0,1
5837,9943,10189,43,3,2,1,1,0,1
5838,9944,9905,45,8,4,4,1,0,1
5839,9944,8721,55,7,3,4,0,0,0
5840,9945,9823,70,13,5,8,2,2,0
5841,9945,9788,30,6,1,5,1,0,1
5842,9948,9790,56,4,1,3,1,0,1
5843,9948,8177,44,4,3,1,0,0,0
5844,9952,9788,42,2,1,1,1,1,0
5845,9952,9789,58,5,4,1,0,0,0
5846,9953,8178,59,12,6,6,3,2,1
5847,9953,8226,41,2,1,1,2,0,2
5848,9954,9810,40,7,1,6,1,1,0
5849,9954,8721,60,2,0,2,0,0,0
5850,9958,9905,52,7,5,2,2,1,1
5851,9958,8234,48,5,3,2,4,0,4
5852,9959,9904,66,4,3,1,3,1,2
5853,9959,8262,34,4,2,2,1,0,1
5854,9961,9789,66,8,5,3,1,0,1
5855,9961,8406,34,2,2,0,0,0,0
5856,9963,9788,64,8,4,4,2,1,1
5857,9963,10189,36,8,1,7,2,2,0
5858,9964,9904,47,6,4,2,2,1,1
5859,9964,9810,53,3,1,2,3,0,3
5860,9965,8226,55,4,2,2,1,0,1
5861,9965,9790,45,6,4,2,0,0,0
5862,9966,9905,57,8,3,5,2,1,1
5863,9966,8697,43,5,1,4,1,1,0
5864,9967,8234,47,6,2,4,1,0,1
5865,9967,8177,53,0,0,0,0,0,0
5866,9968,8721,70,7,3,4,2,0,2
5867,9968,8262,30,3,0,3,1,0,1
5868,9970,8178,48,8,4,4,2,1,1
5869,9970,8721,52,8,3,5,5,0,5
5870,9971,9790,47,7,2,5,4,3,1
5871,9971,9904,53,1,1,0,2,1,1
5872,9972,8262,37,6,2,4,3,2,1
5873,9972,10269,63,5,1,4,3,0,3
5874,9973,8406,67,11,6,5,3,2,1
5875,9973,9905,33,6,0,6,0,0,0
5876,9974,9789,66,5,2,3,2,1,1
5877,9974,8697,34,2,1,1,1,1,0
5878,9975,9823,68,2,1,1,1,0,1
5879,9975,9810,32,1,0,1,0,0,0
5880,9976,8226,48,7,4,3,1,0,1
5881,9976,8722,52,6,1,5,0,0,0
5882,9977,8177,36,6,2,4,2,1,1
5883,9977,9788,64,4,2,2,2,0,2
5884,9978,9823,76,15,11,4,1,1,0
5885,9978,10269,24,2,0,2,0,0,0
5886,9979,9789,67,6,1,5,1,1,0
5887,9979,10189,33,3,0,3,1,1,0
5888,9980,8722,45,8,3,5,2,2,0
5889,9980,8178,55,7,5,2,0,0,0
5890,9981,8234,45,4,1,3,1,1,0
5891,9981,9788,55,9,4,5,2,0,2
5892,9982,8697,45,7,2,5,2,1,1
5893,9982,8406,55,11,6,5,0,0,0
5894,9983,8177,58,4,4,0,3,2,1
5895,9983,9904,42,5,1,4,4,4,0
5896,9984,9810,51,12,6,6,1,0,1
5897,9984,8226,49,4,3,1,0,0,0
5898,9988,9904,38,10,4,6,1,1,0
5899,9988,9788,62,12,4,8,1,1,0
5900,9989,8721,65,10,2,8,1,1,0
5901,9989,8697,35,5,2,3,4,3,1
5902,9992,8178,65,8,5,3,2,1,1
5903,9992,9810,35,4,1,3,1,0,1
5904,9993,8722,44,3,0,3,1,0,1
5905,9993,9905,56,1,0,1,0,0,0
5906,9994,8226,51,1,1,0,4,2,2
5907,9994,8177,49,0,0,0,0,0,0
5908,9995,8234,58,5,2,3,1,1,0
5909,9995,8262,42,3,2,1,2,0,2
5910,9996,9823,73,6,6,0,1,0,1
5911,9996,8177,27,1,0,1,0,0,0
5912,9997,9789,66,8,2,6,2,1,1
5913,9997,10269,34,5,5,0,1,0,1
5914,9999,8721,60,9,5,4,1,0,1
5915,9999,8406,40,7,4,3,0,0,0
5916,10000,9790,56,7,3,4,2,0,2
5917,10000,8697,44,7,4,3,1,0,1
5918,10002,9788,63,10,7,3,2,1,1
5919,10002,8226,37,8,2,6,0,0,0
5920,10004,8722,57,6,3,3,2,1,1
5921,10004,8262,43,1,0,1,0,0,0
5922,10005,10189,61,12,7,5,2,1,1
5923,10005,9904,39,2,1,1,2,0,2
5924,10008,9790,62,8,4,4,2,1,1
5925,10008,9905,38,4,1,3,0,0,0
5926,10011,8406,56,9,6,3,1,1,0
5927,10011,8722,44,10,4,6,0,0,0
5928,10012,8177,61,5,4,1,3,2,1
5929,10012,8178,39,3,1,2,3,0,3
5930,10013,8226,46,2,1,1,2,0,2
5931,10013,8234,54,2,2,0,0,0,0
5932,10015,9789,76,10,6,4,2,1,1
5933,10015,9810,24,1,1,0,0,0,0
5934,10017,9790,46,3,3,0,3,1,2
5935,10017,8721,54,11,3,8,0,0,0
5936,10018,8406,44,10,6,4,1,0,1
5937,10018,10189,56,6,5,1,0,0,0
5938,10020,8226,42,5,2,3,3,2,1
5939,10020,9904,58,5,1,4,0,0,0
5940,10021,9905,63,5,3,2,2,1,1
5941,10021,10269,37,7,4,3,0,0,0
5942,10022,8262,36,3,1,2,3,2,1
5943,10022,8177,64,1,0,1,0,0,0
5944,10023,10189,55,8,3,5,1,1,0
5945,10023,8226,45,6,2,4,0,0,0
5946,10024,8262,35,7,2,5,4,1,3
5947,10024,9788,65,6,3,3,1,0,1
5948,10025,8406,46,6,2,4,3,1,2
5949,10025,9790,54,7,3,4,0,0,0
5950,10026,10269,29,3,2,1,4,2,2
5951,10026,8721,71,10,4,6,1,1,0
5952,10027,9810,55,6,2,4,4,2,2
5953,10027,8697,45,6,3,3,2,1,1
5954,10028,9789,69,5,3,2,1,0,1
5955,10028,8722,31,5,3,2,3,0,3
5956,10030,8177,65,2,1,1,2,0,2
5957,10030,9905,35,1,0,1,0,0,0
5958,10031,8234,48,5,2,3,3,2,1
5959,10031,8178,52,3,0,3,2,1,1
5960,10034,9790,28,4,1,3,6,3,3
5961,10034,9823,72,3,0,3,1,0,1
5962,10035,8721,57,12,4,8,1,1,0
5963,10035,9810,43,5,1,4,0,0,0
5964,10036,10269,51,8,4,4,3,2,1
5965,10036,8722,49,5,2,3,0,0,0
5966,10038,8406,30,7,5,2,4,1,3
5967,10038,8177,70,4,3,1,1,0,1
5968,10039,8226,40,1,1,0,1,0,1
5969,10039,8178,60,8,2,6,0,0,0
5970,10040,8234,42,4,4,0,2,1,1
5971,10040,9905,58,4,3,1,1,0,1
5972,10041,9823,69,16,7,9,2,0,2
5973,10041,8226,31,2,1,1,0,0,0
5974,10043,8178,61,5,3,2,3,1,2
5975,10043,9904,39,3,1,2,1,1,0
5976,10044,8721,67,6,5,1,2,1,1
5977,10044,8722,33,3,0,3,1,0,1
5978,10045,10269,43,12,3,9,1,0,1
5979,10045,9790,57,5,0,5,3,0,3
5980,10046,8406,49,4,3,1,1,0,1
5981,10046,9810,51,9,0,9,1,0,1
5982,10049,10189,60,6,0,6,2,1,1
5983,10049,8262,40,2,0,2,3,0,3
5984,10050,8262,28,3,3,0,1,1,0
5985,10050,10189,72,7,4,3,0,0,0
5986,10051,9788,65,7,4,3,4,3,1
5987,10051,9905,35,4,2,2,3,1,2
5988,10053,8406,48,5,1,4,2,2,0
5989,10053,9810,52,3,2,1,2,2,0
5990,10054,8721,54,7,1,6,3,1,2
5991,10054,8722,46,4,0,4,0,0,0
5992,10056,8177,54,5,2,3,3,1,2
5993,10056,8697,46,3,0,3,3,2,1
5994,10059,10189,43,2,2,0,2,1,1
5995,10059,8721,57,6,3,3,1,0,1
5996,10060,8178,37,3,1,2,3,1,2
5997,10060,9823,63,3,1,2,2,0,2
5998,10062,8722,41,8,2,6,2,1,1
5999,10062,9790,59,4,1,3,2,1,1
6000,10063,9810,52,8,6,2,1,0,1
6001,10063,10269,48,6,5,1,1,0,1
6002,10064,9905,56,3,2,1,2,0,2
6003,10064,9904,44,3,0,3,0,0,0
6004,10066,8226,68,4,2,2,3,2,1
6005,10066,8262,32,2,0,2,1,0,1
6006,10069,8721,53,4,4,0,2,1,1
6007,10069,8234,47,4,1,3,0,0,0
6008,10070,9788,53,5,1,4,2,1,1
6009,10070,9790,47,6,4,2,3,1,2
6010,10071,10269,52,6,1,5,1,1,0
6011,10071,8177,48,3,1,2,1,0,1
6012,10072,9823,52,10,5,5,2,2,0
6013,10072,8406,48,1,0,1,0,0,0
6014,10075,9905,46,5,1,4,2,1,1
6015,10075,10189,54,4,1,3,1,0,1
6016,10077,9823,69,20,11,9,3,0,3
6017,10077,8262,31,4,2,2,0,0,0
6018,10078,10269,52,11,6,5,4,1,3
6019,10078,10189,48,6,3,3,0,0,0
6020,10081,9810,51,2,1,1,3,1,2
6021,10081,9790,49,3,2,1,0,0,0
6022,10083,8177,52,5,2,3,5,4,1
6023,10083,8721,48,7,0,7,3,0,3
6024,10086,8226,31,5,2,3,5,2,3
6025,10086,9789,69,11,2,9,1,0,1
6026,10087,8721,32,8,5,3,2,2,0
6027,10087,9823,68,4,1,3,2,0,2
6028,10088,8234,53,6,4,2,3,1,2
6029,10088,9790,47,2,2,0,1,0,1
6030,10089,9904,45,8,4,4,4,3,1
6031,10089,10269,55,10,4,6,3,1,2
6032,10090,9788,56,5,4,1,3,2,1
6033,10090,8406,44,11,6,5,0,0,0
6034,10091,8262,41,2,1,1,3,2,1
6035,10091,8697,59,10,0,10,1,1,0
6036,10093,8177,59,7,5,2,1,0,1
6037,10093,8722,41,7,3,4,0,0,0
6038,10094,9905,46,5,4,1,4,3,1
6039,10094,8178,54,3,2,1,3,2,1
6040,10095,9823,75,9,4,5,2,1,1
6041,10095,9905,25,1,1,0,1,0,1
6042,10096,10189,62,9,6,3,3,1,2
6043,10096,9790,38,1,1,0,0,0,0
6044,10097,8178,65,11,3,8,2,0,2
6045,10097,8697,35,4,2,2,0,0,0
6046,10098,9788,60,5,3,2,2,1,1
6047,10098,10269,40,3,0,3,1,1,0
6048,10099,9904,36,4,2,2,3,3,0
6049,10099,8721,64,9,4,5,0,0,0
6050,10100,9810,48,6,3,3,1,0,1
6051,10100,8177,52,4,3,1,0,0,0
6052,10106,8177,37,2,1,1,4,2,2
6053,10106,9790,63,5,3,2,3,0,3
6054,10107,10269,45,10,8,2,2,0,2
6055,10107,8226,55,7,4,3,0,0,0
6056,10111,10189,61,5,4,1,1,1,0
6057,10111,8722,39,8,4,4,0,0,0
6058,10115,9790,58,7,2,5,2,0,2
6059,10115,8178,42,5,2,3,0,0,0
6060,10116,9788,67,6,3,3,2,0,2
6061,10116,9810,33,0,0,0,2,0,2
6062,10117,8722,47,6,5,1,1,1,0
6063,10117,9904,53,3,1,2,0,0,0
6064,10118,8177,51,4,2,2,6,3,3
6065,10118,10189,49,9,4,5,2,1,1
6066,10119,8721,56,11,5,6,5,3,2
6067,10119,8226,44,2,1,1,1,0,1
6068,10120,10269,53,5,4,1,1,1,0
6069,10120,8234,47,6,2,4,2,1,1
6070,10122,10189,42,3,3,0,3,2,1
6071,10122,9788,58,13,7,6,4,2,2
6072,10123,8262,33,4,2,2,3,1,2
6073,10123,8721,67,5,2,3,0,0,0
6074,10124,8226,42,6,4,2,2,1,1
6075,10124,9790,58,11,2,9,0,0,0
6076,10125,8178,48,9,4,5,2,2,0
6077,10125,10269,52,5,2,3,1,0,1
6078,10126,8406,23,4,3,1,1,1,0
6079,10126,9789,77,5,2,3,0,0,0
6080,10129,9823,77,3,1,2,4,2,2
6081,10129,8722,23,2,0,2,0,0,0
6082,10130,8234,41,3,1,2,2,1,1
6083,10130,8177,59,1,1,0,1,0,1
6084,10131,9823,65,11,4,7,1,0,1
6085,10131,9810,35,0,0,0,2,0,2
6086,10133,8721,52,8,3,5,1,1,0
6087,10133,8178,48,3,2,1,1,0,1
6088,10134,8177,45,2,1,1,2,1,1
6089,10134,9788,55,5,2,3,1,1,0
6090,10136,8226,57,7,1,6,3,2,1
6091,10136,8722,43,0,0,0,0,0,0
6092,10139,10269,59,2,1,1,1,0,1
6093,10139,8262,41,5,1,4,0,0,0
6094,10140,9789,47,6,2,4,2,2,0
6095,10140,10189,53,4,0,4,0,0,0
6096,10141,9905,48,6,2,4,2,1,1
6097,10141,8721,52,6,5,1,3,1,2
6098,10143,9823,74,5,2,3,4,1,3
6099,10143,10269,26,2,2,0,1,0,1
6100,10144,8697,55,10,6,4,4,3,1
6101,10144,8406,45,2,0,2,2,1,1
6102,10145,8226,46,4,3,1,1,1,0
6103,10145,9810,54,4,3,1,0,0,0
6104,10146,8722,40,9,2,7,3,1,2
6105,10146,8178,60,3,1,2,1,0,1
6106,10147,9904,32,3,1,2,2,1,1
6107,10147,8177,68,9,4,5,1,0,1
6108,10148,8234,51,9,5,4,4,2,2
6109,10148,9788,49,3,1,2,1,0,1
6110,10151,8721,62,4,2,2,2,0,2
6111,10151,10189,38,3,3,0,2,0,2
6112,10153,8234,39,7,5,2,1,0,1
6113,10153,8406,61,4,1,3,0,0,0
6114,10154,9788,58,5,2,3,1,0,1
6115,10154,8697,42,7,4,3,3,0,3
6116,10155,9790,51,8,4,4,1,0,1
6117,10155,8722,49,1,0,1,3,0,3
6118,10156,9904,45,4,2,2,3,3,0
6119,10156,9905,55,3,1,2,3,1,2
6120,10158,10189,32,8,3,5,1,1,0
6121,10158,9823,68,6,2,4,1,1,0
6122,10159,9790,36,2,2,0,4,2,2
6123,10159,9789,64,5,2,3,2,1,1
6124,10161,10269,40,4,2,2,1,1,0
6125,10161,8406,60,7,2,5,4,1,3
6126,10164,8177,55,4,1,3,2,0,2
6127,10164,8226,45,9,6,3,0,0,0
6128,10167,10189,55,7,3,4,1,1,0
6129,10167,8178,45,5,2,3,2,0,2
6130,10173,8722,65,5,4,1,2,0,2
6131,10173,8262,35,4,1,3,0,0,0
6132,10174,8177,37,5,4,1,3,2,1
6133,10174,9823,63,4,3,1,1,1,0
6134,10175,9904,58,2,0,2,1,1,0
6135,10175,8234,42,1,0,1,1,1,0
6136,10176,9823,58,4,3,1,3,1,2
6137,10176,9788,42,2,1,1,0,0,0
6138,10177,8721,45,3,2,1,2,2,0
6139,10177,9789,55,8,0,8,3,3,0
6140,10178,8178,56,6,4,2,2,2,0
6141,10178,8177,44,2,0,2,1,0,1
6142,10184,8262,37,4,1,3,2,2,0
6143,10184,9810,63,2,1,1,2,0,2
6144,10185,10189,68,8,5,3,2,1,1
6145,10185,8406,32,1,1,0,2,0,2
6146,10186,9788,60,6,3,3,2,1,1
6147,10186,8178,40,8,1,7,1,0,1
6148,10187,9790,46,1,1,0,4,1,3
6149,10187,8721,54,5,1,4,1,0,1
6150,10188,10269,47,4,2,2,2,0,2
6151,10188,9905,53,10,3,7,0,0,0
6152,10189,9810,27,2,1,1,2,1,1
6153,10189,9789,73,12,6,6,0,0,0
6154,10191,9904,51,8,5,3,1,1,0
6155,10191,8226,49,8,5,3,2,0,2
6156,10193,8234,48,6,5,1,2,1,1
6157,10193,9823,52,4,2,2,2,0,2
6158,10194,9823,63,8,4,4,1,1,0
6159,10194,9904,37,6,3,3,3,2,1
6160,10195,9789,83,7,4,3,1,1,0
6161,10195,8722,17,3,1,2,2,2,0
6162,10196,8234,53,4,2,2,1,1,0
6163,10196,8178,47,4,0,4,2,0,2
6164,10197,8721,56,6,4,2,1,0,1
6165,10197,10269,44,5,2,3,0,0,0
6166,10199,9810,40,2,2,0,2,1,1
6167,10199,8697,60,5,2,3,0,0,0
6168,10202,9788,62,6,4,2,1,1,0
6169,10202,8262,38,2,1,1,1,0,1
6170,10204,10189,58,10,6,4,1,0,1
6171,10204,9905,42,7,2,5,2,0,2
6172,10205,8262,24,1,1,0,4,3,1
6173,10205,8178,76,6,2,4,3,1,2
6174,10206,9790,47,2,1,1,1,0,1
6175,10206,9788,53,7,6,1,0,0,0
6176,10207,9810,58,8,4,4,2,1,1
6177,10207,8722,42,7,2,5,3,2,1
6178,10208,9789,70,6,3,3,1,1,0
6179,10208,9904,30,3,1,2,1,0,1
6180,10209,8177,54,5,2,3,1,0,1
6181,10209,10269,46,5,4,1,0,0,0
6182,10210,8697,44,6,2,4,1,0,1
6183,10210,8226,56,5,1,4,0,0,0
6184,10211,8721,49,8,2,6,2,1,1
6185,10211,8234,51,4,3,1,1,0,1
6186,10212,9789,61,11,4,7,3,2,1
6187,10212,8178,39,4,1,3,1,1,0
6188,10213,8721,53,3,1,2,1,1,0
6189,10213,8177,47,4,4,0,2,0,2
6190,10214,9810,47,5,1,4,2,2,0
6191,10214,9790,53,2,2,0,0,0,0
6192,10218,8722,41,5,2,3,3,3,0
6193,10218,9788,59,8,3,5,1,0,1
6194,10219,9905,67,5,2,3,3,1,2
6195,10219,8226,33,6,3,3,2,1,1
6196,10221,9823,58,8,3,5,3,3,0
6197,10221,8721,42,1,1,0,1,1,0
6198,10224,9788,53,9,4,5,1,1,0
6199,10224,8406,47,7,3,4,2,1,1
6200,10225,10269,38,11,3,8,1,0,1
6201,10225,9904,62,2,1,1,1,0,1
6202,10226,8177,61,9,4,5,2,1,1
6203,10226,8722,39,6,2,4,1,1,0
6204,10227,8226,39,3,3,0,1,1,0
6205,10227,9789,61,7,2,5,2,1,1
6206,10228,8234,51,5,3,2,5,3,2
6207,10228,9790,49,3,1,2,0,0,0
6208,10229,8262,49,3,1,2,1,1,0
6209,10229,8697,51,2,1,1,1,1,0
6210,10231,8721,63,12,6,6,1,1,0
6211,10231,9904,37,6,4,2,2,0,2
6212,10234,8406,65,17,10,7,2,2,0
6213,10234,8226,35,2,2,0,1,0,1
6214,10235,8697,42,3,1,2,1,1,0
6215,10235,8178,58,5,1,4,0,0,0
6216,10239,9789,46,5,2,3,2,0,2
6217,10239,9823,54,6,2,4,0,0,0
6218,10240,10189,59,10,6,4,1,1,0
6219,10240,8722,41,3,1,2,3,2,1
6220,10241,8406,40,1,1,0,1,0,1
6221,10241,8178,60,12,6,6,0,0,0
6222,10244,9790,56,6,3,3,3,2,1
6223,10244,8177,44,5,2,3,2,0,2
6224,10247,9905,63,8,4,4,3,1,2
6225,10247,8262,37,3,1,2,1,0,1
6226,10248,10189,55,9,1,8,1,0,1
6227,10248,8177,45,5,3,2,1,0,1
6228,10249,8721,57,7,5,2,1,0,1
6229,10249,8226,43,0,0,0,0,0,0
6230,10251,10269,53,5,5,0,1,1,0
6231,10251,8234,47,5,2,3,1,1,0
6232,10252,8406,66,10,3,7,1,1,0
6233,10252,8262,34,4,2,2,0,0,0
6234,10253,8697,23,7,2,5,1,0,1
6235,10253,9823,77,6,2,4,0,0,0
6236,10254,9810,44,2,2,0,2,1,1
6237,10254,9788,56,1,1,0,1,0,1
6238,10255,8722,64,10,4,6,2,1,1
6239,10255,9904,36,4,3,1,1,0,1
6240,10261,9885,49,7,5,2,1,1,0
6241,10261,8535,51,5,1,4,1,0,1
6242,10266,8600,51,4,3,1,3,1,2
6243,10266,8540,49,4,1,3,1,0,1
6244,10272,8564,64,7,3,4,1,1,0
6245,10272,9875,36,4,2,2,1,1,0
6246,10273,8543,58,9,4,5,2,1,1
6247,10273,8530,42,1,1,0,0,0,0
6248,10277,9857,39,2,1,1,3,2,1
6249,10277,8686,61,5,4,1,1,1,0
6250,10280,9888,33,3,1,2,3,3,0
6251,10280,8564,67,10,7,3,0,0,0
6252,10282,8600,49,4,2,2,2,1,1
6253,10282,8636,51,5,2,3,1,1,0
6254,10284,8524,45,3,1,2,1,0,1
6255,10284,8535,55,8,2,6,0,0,0
6256,10288,8686,53,4,2,2,1,1,0
6257,10288,8543,47,7,2,5,2,1,1
6258,10292,8564,56,8,1,7,1,1,0
6259,10292,8533,44,6,2,4,0,0,0
6260,10294,9885,53,4,0,4,3,3,0
6261,10294,10233,47,0,0,0,2,2,0
6262,10295,8529,32,6,2,4,3,2,1
6263,10295,8535,68,6,2,4,0,0,0
6264,10297,8600,57,13,8,5,1,1,0
6265,10297,8535,43,8,4,4,0,0,0
6266,10301,8543,60,12,6,6,1,1,0
6267,10301,10233,40,5,2,3,1,0,1
6268,10302,8636,48,10,7,3,2,1,1
6269,10302,9885,52,5,3,2,3,0,3
6270,10306,8564,57,7,4,3,2,1,1
6271,10306,9804,43,7,0,7,1,1,0
6272,10311,8564,47,8,2,6,1,0,1
6273,10311,8540,53,8,5,3,0,0,0
6274,10317,8686,66,11,4,7,1,1,0
6275,10317,8533,34,0,0,0,1,0,1
6276,10323,8636,51,2,2,0,3,2,1
6277,10323,8543,49,12,3,9,0,0,0
6278,10324,8564,65,12,9,3,2,1,1
6279,10324,8530,35,4,2,2,1,0,1
6280,10325,9885,68,4,3,1,5,1,4
6281,10325,9888,32,3,0,3,3,1,2
6282,10329,9857,56,7,7,0,2,1,1
6283,10329,9804,44,7,6,1,2,1,1
6284,10330,9885,53,4,3,1,3,0,3
6285,10330,8564,47,3,2,1,1,0,1
6286,10332,8543,62,10,6,4,3,1,2
6287,10332,8600,38,6,2,4,1,1,0
6288,10333,9888,42,7,4,3,2,2,0
6289,10333,9875,58,4,2,2,1,0,1
6290,10339,8551,45,4,2,2,2,1,1
6291,10339,8636,55,7,4,3,1,0,1
6292,10340,8543,53,5,3,2,1,1,0
6293,10340,8540,47,3,3,0,3,2,1
6294,10341,9875,57,5,3,2,2,2,0
6295,10341,9804,43,6,3,3,2,2,0
6296,10349,8686,45,13,5,8,3,2,1
6297,10349,8564,55,6,2,4,3,0,3
6298,10354,8551,44,6,3,3,2,0,2
6299,10354,9885,56,3,1,2,0,0,0
6300,10362,8543,60,6,5,1,3,0,3
6301,10362,9885,40,5,0,5,0,0,0
6302,10365,8600,62,3,1,2,1,1,0
6303,10365,8529,38,2,1,1,0,0,0
6304,10371,9875,39,6,2,4,2,2,0
6305,10371,8535,61,8,0,8,1,1,0
6306,10374,9885,61,11,7,4,3,1,2
6307,10374,8600,39,4,2,2,1,0,1
6308,10379,8543,57,6,2,4,1,1,0
6309,10379,8529,43,1,0,1,1,0,1
6310,10380,8533,48,3,1,2,5,2,3
6311,10380,8690,52,6,5,1,3,1,2
6312,10381,8535,52,7,3,4,1,1,0
6313,10381,9885,48,6,2,4,0,0,0
6314,10382,9857,41,10,3,7,1,1,0
6315,10382,8564,59,9,4,5,0,0,0
6316,10392,8600,53,8,3,5,2,1,1
6317,10392,9885,47,3,0,3,2,0,2
6318,10400,10233,52,5,4,1,2,0,2
6319,10400,8540,48,1,0,1,0,0,0
6320,10402,8564,64,2,1,1,2,0,2
6321,10402,8543,36,8,4,4,0,0,0
6322,10411,8564,75,10,3,7,7,5,2
6323,10411,8690,25,2,2,0,0,0,0
6324,10412,8535,52,9,3,6,2,1,1
6325,10412,8543,48,8,6,2,5,0,5
6326,10414,9885,46,9,1,8,3,1,2
6327,10414,8530,54,8,5,3,2,0,2
6328,10428,8686,58,5,2,3,1,0,1
6329,10428,8551,42,4,0,4,0,0,0
6330,10431,8636,59,7,4,3,1,0,1
6331,10431,9857,41,5,2,3,0,0,0
6332,10433,8540,59,9,4,5,2,2,0
6333,10433,9885,41,8,6,2,2,1,1
6334,10435,8564,54,3,2,1,2,0,2
6335,10435,8529,46,5,5,0,0,0,0
6336,10440,8564,66,7,2,5,1,1,0
6337,10440,9882,34,3,1,2,1,0,1
6338,10441,8543,51,4,2,2,1,1,0
6339,10441,9857,49,3,2,1,2,0,2
6340,10442,9885,54,5,5,0,2,0,2
6341,10442,9875,46,1,1,0,1,0,1
6342,10444,8686,58,12,7,5,2,2,0
6343,10444,8636,42,7,3,4,2,1,1
6344,10451,8535,44,6,4,2,1,0,1
6345,10451,8540,56,5,2,3,1,0,1
6346,10454,10233,57,7,4,3,1,1,0
6347,10454,8636,43,3,1,2,0,0,0
6348,10456,8564,52,6,5,1,2,0,2
6349,10456,8524,48,10,7,3,0,0,0
6350,10457,10233,48,3,1,2,3,1,2
6351,10457,8529,52,2,0,2,0,0,0
6352,10465,8533,42,8,2,6,2,1,1
6353,10465,8543,58,8,5,3,2,1,1
6354,10466,8636,53,6,2,4,2,0,2
6355,10466,8535,47,10,5,5,1,0,1
6356,10468,8690,40,8,3,5,2,1,1
6357,10468,8636,60,4,1,3,0,0,0
6358,10469,9875,32,5,3,2,2,2,0
6359,10469,8564,68,8,4,4,0,0,0
6360,10476,8686,51,9,3,6,3,1,2
6361,10476,9885,49,5,2,3,2,0,2
6362,10480,8690,42,3,1,2,2,0,2
6363,10480,8686,58,7,1,6,0,0,0
6364,10482,8564,63,4,2,2,2,2,0
6365,10482,8543,37,9,4,5,2,0,2
6366,10490,9885,54,4,1,3,2,1,1
6367,10490,8533,46,1,0,1,3,1,2
6368,10491,8535,42,7,2,5,1,1,0
6369,10491,8524,58,3,3,0,2,2,0
6370,10495,9888,25,4,2,2,1,1,0
6371,10495,8564,75,10,3,7,0,0,0
6372,10501,10233,60,7,2,5,1,0,1
6373,10501,9885,40,4,1,3,0,0,0
6374,10513,8564,54,4,4,0,3,2,1
6375,10513,9804,46,3,2,1,1,0,1
6376,10518,8524,46,5,2,3,3,0,3
6377,10518,8543,54,6,1,5,3,0,3
6378,10521,8540,48,4,3,1,1,0,1
6379,10521,8564,52,5,2,3,0,0,0
6380,10522,8535,43,5,2,3,2,2,0
6381,10522,8686,57,5,2,3,2,0,2
6382,10523,8636,55,5,2,3,1,1,0
6383,10523,9875,45,6,1,5,2,0,2
6384,10526,8533,52,10,4,6,1,1,0
6385,10526,8600,48,8,3,5,1,1,0
6386,10531,8543,51,6,4,2,1,1,0
6387,10531,8636,49,3,0,3,2,0,2
6388,10534,10233,45,3,2,1,2,1,1
6389,10534,9882,55,2,1,1,2,1,1
6390,10536,9857,58,8,3,5,1,0,1
6391,10536,8690,42,2,0,2,0,0,0
6392,10539,8600,47,7,2,5,3,2,1
6393,10539,8543,53,3,1,2,3,2,1
6394,10540,9885,38,7,2,5,1,0,1
6395,10540,8564,62,6,2,4,0,0,0
6396,10544,8686,57,10,4,6,1,0,1
6397,10544,8529,43,3,1,2,1,0,1
6398,10547,8535,52,7,4,3,3,1,2
6399,10547,9882,48,1,0,1,1,0,1
6400,10550,8686,62,4,2,2,4,2,2
6401,10550,8530,38,4,1,3,2,1,1
6402,10551,8524,48,4,2,2,2,0,2
6403,10551,9885,52,6,0,6,0,0,0
6404,10552,8551,46,6,2,4,1,0,1
6405,10552,8636,54,10,5,5,0,0,0
6406,10553,10233,59,7,5,2,1,0,1
6407,10553,8533,41,5,4,1,4,0,4
6408,10556,8600,45,11,5,6,1,1,0
6409,10556,8564,55,2,1,1,0,0,0
6410,10559,8686,46,5,4,1,1,0,1
6411,10559,8564,54,6,3,3,1,0,1
6412,10564,8529,45,10,6,4,1,0,1
6413,10564,8636,55,5,2,3,0,0,0
6414,10566,9888,48,10,6,4,2,1,1
6415,10566,8535,52,8,4,4,0,0,0
6416,10571,8535,38,5,2,3,4,2,2
6417,10571,8564,62,3,1,2,0,0,0
6418,10572,9857,44,8,6,2,4,2,2
6419,10572,8530,56,7,3,4,1,0,1
6420,10573,8543,42,3,3,0,2,1,1
6421,10573,9885,58,5,0,5,1,0,1
6422,10576,8686,52,8,3,5,1,1,0
6423,10576,9804,48,12,2,10,2,0,2
6424,10581,8530,45,4,3,1,1,1,0
6425,10581,9885,55,13,3,10,0,0,0
6426,10589,9885,57,3,2,1,2,1,1
6427,10589,9882,43,6,3,3,1,0,1
6428,10590,8686,52,5,2,3,2,0,2
6429,10590,8524,48,2,0,2,0,0,0
6430,10600,8564,73,7,3,4,1,1,0
6431,10600,8529,27,5,3,2,0,0,0
6432,10603,9857,41,7,5,2,1,0,1
6433,10603,8636,59,14,10,4,0,0,0
6434,10607,9882,56,2,2,0,6,4,2
6435,10607,8564,44,4,2,2,1,1,0
6436,10609,8686,59,13,7,6,4,1,3
6437,10609,8636,41,6,4,2,1,0,1
6438,10613,8535,51,7,3,4,1,1,0
6439,10613,8690,49,4,3,1,0,0,0
6440,10650,8540,49,4,3,1,1,0,1
6441,10650,8636,51,5,2,3,0,0,0
6442,10651,9885,64,8,5,3,3,2,1
6443,10651,9882,36,1,0,1,1,0,1
6444,10654,8564,52,2,1,1,2,0,2
6445,10654,9875,48,10,2,8,0,0,0
6446,10659,8530,45,4,3,1,3,1,2
6447,10659,8535,55,5,1,4,0,0,0
6448,10672,8551,40,6,4,2,3,1,2
6449,10672,10233,60,4,3,1,1,0,1
6450,10674,8543,45,14,7,7,1,1,0
6451,10674,8564,55,4,2,2,0,0,0
6452,10677,8636,73,9,6,3,2,1,1
6453,10677,9857,27,3,1,2,0,0,0
6454,10679,9885,58,11,7,4,1,0,1
6455,10679,8600,42,3,1,2,0,0,0
6456,10681,8529,32,7,4,3,2,0,2
6457,10681,8564,68,3,2,1,0,0,0
6458,10689,9885,61,6,1,5,2,0,2
6459,10689,8529,39,0,0,0,1,0,1
6460,10692,9882,54,5,3,2,2,1,1
6461,10692,10233,46,2,1,1,0,0,0
6462,10693,8636,54,8,4,4,1,0,1
6463,10693,8535,46,6,5,1,0,0,0
6464,10700,9885,49,7,4,3,2,1,1
6465,10700,8636,51,6,3,3,1,0,1
6466,10702,8564,65,8,5,3,1,0,1
6467,10702,9882,35,3,1,2,0,0,0
6468,10705,8686,44,6,2,4,2,1,1
6469,10705,8543,56,7,4,3,0,0,0
6470,10709,8529,59,2,2,0,2,1,1
6471,10709,9875,41,7,1,6,2,0,2
6472,10713,8540,40,4,3,1,2,1,1
6473,10713,8564,60,12,3,9,0,0,0
6474,10720,8636,54,5,4,1,3,1,2
6475,10720,8543,46,5,3,2,1,1,0
6476,10725,8686,62,8,3,5,2,1,1
6477,10725,10167,38,4,1,3,2,0,2
6478,10729,8529,42,7,3,4,4,3,1
6479,10729,8686,58,2,0,2,0,0,0
6480,10731,8636,62,8,6,2,1,1,0
6481,10731,8533,38,3,2,1,1,1,0
6482,10733,8564,64,5,2,3,1,0,1
6483,10733,10233,36,4,2,2,0,0,0
6484,10736,8551,56,7,1,6,2,0,2
6485,10736,8535,44,6,1,5,0,0,0
6486,10738,8535,58,9,6,3,3,0,3
6487,10738,9976,42,5,1,4,0,0,0
6488,10740,8636,67,4,1,3,5,3,2
6489,10740,8551,33,4,1,3,1,0,1
6490,10741,9885,42,5,1,4,3,1,2
6491,10741,8564,58,3,1,2,1,1,0
6492,10745,8533,59,5,3,2,2,1,1
6493,10745,8686,41,4,2,2,0,0,0
6494,10757,9857,45,2,2,0,4,1,3
6495,10757,8535,55,13,1,12,1,0,1
6496,10764,9875,51,6,6,0,1,1,0
6497,10764,8540,49,4,1,3,0,0,0
6498,10765,8551,35,5,1,4,2,1,1
6499,10765,8564,65,5,1,4,1,0,1
6500,10772,8636,40,8,6,2,1,1,0
6501,10772,8564,60,6,2,4,0,0,0
6502,10775,8686,44,4,0,4,2,1,1
6503,10775,9885,56,3,0,3,1,0,1
6504,10783,8564,68,9,3,6,4,2,2
6505,10783,8537,32,3,0,3,0,0,0
6506,10785,8686,57,5,3,2,3,2,1
6507,10785,8551,43,2,1,1,2,0,2
6508,10788,8636,52,3,2,1,2,2,0
6509,10788,8529,48,6,2,4,0,0,0
6510,10792,8564,70,5,2,3,1,0,1
6511,10792,9857,30,1,1,0,0,0,0
6512,10795,8535,47,8,4,4,1,0,1
6513,10795,8686,53,1,0,1,0,0,0
6514,10800,9882,47,4,2,2,3,2,1
6515,10800,8535,53,1,0,1,0,0,0
6516,10801,9885,59,8,4,4,1,1,0
6517,10801,10233,41,0,0,0,3,1,2
6518,10802,9875,48,6,6,0,5,3,2
6519,10802,8636,52,8,2,6,1,0,1
6520,10804,8686,48,3,2,1,3,2,1
6521,10804,8540,52,5,4,1,1,0,1
6522,10806,8600,45,9,4,5,3,1,2
6523,10806,8564,55,6,3,3,0,0,0
6524,10807,8530,49,4,2,2,1,0,1
6525,10807,8686,51,5,2,3,0,0,0
6526,10809,9885,52,6,5,1,4,2,2
6527,10809,9857,48,4,1,3,1,1,0
6528,10812,8564,69,3,2,1,4,3,1
6529,10812,9976,31,2,1,1,0,0,0
6530,10815,9882,43,5,4,1,5,2,3
6531,10815,8636,57,5,2,3,4,2,2
6532,10817,8524,36,6,2,4,1,1,0
6533,10817,8564,64,4,2,2,0,0,0
6534,10824,9875,55,5,3,2,1,1,0
6535,10824,8686,45,6,4,2,0,0,0
6536,10833,8686,45,6,2,4,5,2,3
6537,10833,8564,55,2,0,2,0,0,0
6538,10840,8564,64,8,2,6,2,1,1
6539,10840,8533,36,4,2,2,0,0,0
6540,10841,8535,53,4,3,1,2,1,1
6541,10841,9875,47,4,2,2,3,0,3
6542,10842,8636,59,7,3,4,2,0,2
6543,10842,8530,41,3,2,1,0,0,0
6544,10846,8551,49,7,6,1,1,1,0
6545,10846,9885,51,4,2,2,2,0,2
6546,10854,9875,40,7,4,3,1,1,0
6547,10854,8564,60,7,1,6,1,0,1
6548,10856,8600,55,5,1,4,1,1,0
6549,10856,8686,45,6,3,3,0,0,0
6550,10860,10233,52,6,2,4,1,1,0
6551,10860,9875,48,6,3,3,2,0,2
6552,10861,10167,41,2,2,0,1,0,1
6553,10861,8636,59,14,6,8,0,0,0
6554,10862,9885,55,7,3,4,5,3,2
6555,10862,8543,45,6,4,2,4,1,3
6556,10874,8686,57,8,6,2,3,2,1
6557,10874,9857,43,4,2,2,1,1,0
6558,10877,9885,48,5,2,3,1,1,0
6559,10877,8524,52,5,3,2,1,0,1
6560,10884,8564,60,7,3,4,2,1,1
6561,10884,8543,40,9,3,6,5,2,3
6562,10885,10167,53,3,2,1,2,0,2
6563,10885,8533,47,3,3,0,0,0,0
6564,10887,8636,65,7,6,1,3,1,2
6565,10887,9857,35,2,0,2,1,1,0
6566,10891,8529,38,5,0,5,1,1,0
6567,10891,8564,62,1,0,1,0,0,0
6568,10897,8686,61,2,1,1,3,1,2
6569,10897,8524,39,4,1,3,0,0,0
6570,10900,8530,47,4,3,1,2,1,1
6571,10900,8564,53,4,2,2,1,0,1
6572,10903,8636,57,4,4,0,1,1,0
6573,10903,8535,43,4,3,1,3,3,0
6574,10908,8535,53,5,3,2,2,1,1
6575,10908,8524,47,8,4,4,0,0,0
6576,10909,10233,47,9,4,5,3,2,1
6577,10909,10167,53,12,2,10,1,0,1
6578,10910,9885,39,7,3,4,1,1,0
6579,10910,8636,61,7,6,1,1,0,1
6580,10911,8533,59,5,4,1,1,0,1
6581,10911,8537,41,2,0,2,0,0,0
6582,10912,9882,58,5,3,2,2,2,0
6583,10912,8564,42,1,0,1,0,0,0
6584,10914,8540,46,11,3,8,2,1,1
6585,10914,8529,54,6,4,2,0,0,0
6586,10917,8636,55,9,5,4,3,1,2
6587,10917,8524,45,2,0,2,2,0,2
6588,10922,8543,53,3,2,1,1,1,0
6589,10922,10233,47,5,2,3,0,0,0
6590,10925,8686,60,12,5,7,1,1,0
6591,10925,9882,40,1,1,0,1,0,1
6592,10928,8535,44,4,2,2,2,0,2
6593,10928,8564,56,5,4,1,0,0,0
6594,10930,8636,61,10,8,2,2,2,0
6595,10930,8543,39,5,3,2,1,1,0
6596,10931,8530,43,4,2,2,1,0,1
6597,10931,9885,57,4,3,1,0,0,0
6598,10939,8686,51,11,3,8,3,1,2
6599,10939,8529,49,2,0,2,1,0,1
6600,10941,8636,65,7,2,5,1,1,0
6601,10941,8533,35,2,1,1,1,0,1
6602,10943,10233,40,9,3,6,1,0,1
6603,10943,8564,60,5,2,3,3,0,3
6604,10944,9885,53,3,2,1,1,1,0
6605,10944,10167,47,1,0,1,0,0,0
6606,10947,8529,54,7,3,4,1,1,0
6607,10947,9857,46,2,2,0,2,1,1
6608,10950,8636,76,6,3,3,1,1,0
6609,10950,8551,24,2,1,1,2,0,2
6610,10953,9882,43,6,6,0,2,0,2
6611,10953,9875,57,6,4,2,1,0,1
6612,10954,8524,49,12,5,7,2,1,1
6613,10954,8540,51,11,2,9,2,1,1
6614,10956,8600,42,8,3,5,1,1,0
6615,10956,8543,58,11,4,7,0,0,0
6616,10958,8636,64,7,4,3,2,1,1
6617,10958,8529,36,7,2,5,2,1,1
6618,10961,8537,51,9,7,2,1,1,0
6619,10961,9885,49,4,1,3,0,0,0
6620,10965,8535,45,3,1,2,1,1,0
6621,10965,8686,55,8,3,5,2,1,1
6622,10971,9885,40,5,3,2,4,2,2
6623,10971,10233,60,4,1,3,1,0,1
6624,10972,8636,62,5,4,1,4,1,3
6625,10972,9875,38,4,3,1,1,0,1
6626,10979,9885,53,6,5,1,1,1,0
6627,10979,9857,47,6,3,3,1,0,1
6628,10980,8543,60,15,8,7,2,1,1
6629,10980,8540,40,1,0,1,0,0,0
6630,10991,8543,45,11,5,6,1,1,0
6631,10991,8535,55,11,5,6,1,1,0
6632,10992,8636,54,10,5,5,1,1,0
6633,10992,8600,46,5,1,4,1,0,1
6634,10994,8686,52,7,5,2,5,3,2
6635,10994,9875,48,2,1,1,1,0,1
6636,10999,8636,51,2,1,1,2,1,1
6637,10999,10233,49,5,0,5,0,0,0
6638,11000,9885,63,8,2,6,2,1,1
6639,11000,8535,37,8,3,5,0,0,0
6640,11003,8686,38,12,6,6,3,2,1
6641,11003,8564,62,6,2,4,2,2,0
6642,11012,8636,72,3,2,1,2,2,0
6643,11012,8530,28,5,1,4,4,2,2
6644,11014,8537,41,2,2,0,3,1,2
6645,11014,8686,59,9,5,4,0,0,0
6646,11017,8636,64,18,6,12,2,0,2
6647,11017,9857,36,5,3,2,1,0,1
6648,11031,8543,49,4,1,3,2,1,1
6649,11031,8686,51,6,3,3,0,0,0
6650,11032,9880,38,4,3,1,7,3,4
6651,11032,9885,62,10,5,5,0,0,0
6652,11034,8533,45,6,4,2,1,1,0
6653,11034,8535,55,12,8,4,2,1,1
6654,11036,9976,54,3,3,0,3,2,1
6655,11036,8564,46,3,1,2,0,0,0
6656,11037,8540,47,9,6,3,1,1,0
6657,11037,8564,53,3,3,0,2,2,0
6658,11038,9888,39,3,1,2,2,0,2
6659,11038,8636,61,4,2,2,0,0,0
6660,11039,10167,64,7,3,4,1,1,0
6661,11039,9882,36,2,0,2,2,2,0
6662,11049,9885,30,7,1,6,2,1,1
6663,11049,8686,70,6,4,2,1,1,0
6664,11050,8564,51,1,1,0,1,1,0
6665,11050,8636,49,3,0,3,1,0,1
6666,11051,8535,53,8,5,3,3,2,1
6667,11051,9880,47,4,2,2,3,1,2
6668,11061,8533,38,5,2,3,2,1,1
6669,11061,8636,62,8,3,5,0,0,0
6670,11068,8533,45,4,1,3,2,2,0
6671,11068,9857,55,8,2,6,1,0,1
6672,11070,8564,59,15,7,8,4,1,3
6673,11070,9882,41,3,0,3,0,0,0
6674,11072,8686,62,10,7,3,4,2,2
6675,11072,8540,38,6,3,3,1,1,0
6676,11074,8530,45,5,3,2,2,1,1
6677,11074,8543,55,10,4,6,1,1,0
6678,11075,8535,40,5,3,2,5,2,3
6679,11075,9885,60,11,7,4,2,1,1
6680,11077,9885,54,4,1,3,1,0,1
6681,11077,8530,46,3,0,3,1,0,1
6682,11079,8564,64,7,5,2,2,2,0
6683,11079,9858,36,2,1,1,0,0,0
6684,11080,10167,58,5,5,0,1,1,0
6685,11080,8600,42,6,2,4,0,0,0
6686,11082,9875,53,8,2,6,3,1,2
6687,11082,8540,47,2,1,1,1,1,0
6688,11088,8543,49,3,2,1,1,1,0
6689,11088,9885,51,7,1,6,2,0,2
6690,11089,9882,62,7,3,4,2,1,1
6691,11089,9858,38,3,2,1,2,0,2
6692,11093,8636,58,6,4,2,1,1,0
6693,11093,9880,42,1,0,1,2,1,1
6694,11096,8686,49,9,2,7,2,2,0
6695,11096,9976,51,3,1,2,2,0,2
6696,11098,8529,58,1,1,0,5,1,4
6697,11098,9880,42,3,0,3,0,0,0
6698,11099,9976,41,3,1,2,2,1,1
6699,11099,8540,59,8,2,6,0,0,0
6700,11101,8543,44,10,7,3,2,2,0
6701,11101,8600,56,3,0,3,0,0,0
6702,11103,8533,40,6,2,4,1,1,0
6703,11103,9885,60,3,1,2,1,0,1
6704,11107,8543,59,8,7,1,3,0,3
6705,11107,10233,41,10,4,6,0,0,0
6706,11113,8564,63,6,1,5,2,1,1
6707,11113,8529,37,5,3,2,0,0,0
6708,11114,9857,48,5,2,3,1,1,0
6709,11114,8535,52,4,2,2,2,1,1
6710,11121,9885,48,6,3,3,3,3,0
6711,11121,9875,52,4,3,1,4,1,3
6712,11123,9888,44,7,3,4,3,2,1
6713,11123,8543,56,7,1,6,1,0,1
6714,11124,8564,53,9,3,6,1,1,0
6715,11124,8600,47,0,0,0,1,0,1
6716,11125,8533,41,7,4,3,1,0,1
6717,11125,8540,59,8,5,3,0,0,0
6718,11127,9875,47,6,2,4,2,2,0
6719,11127,9976,53,6,1,5,2,0,2
6720,11129,8543,54,6,4,2,2,2,0
6721,11129,9857,46,4,2,2,0,0,0
6722,11131,8636,63,6,5,1,2,1,1
6723,11131,8600,37,7,5,2,2,2,0
6724,11133,8564,73,6,3,3,1,0,1
6725,11133,9880,27,5,0,5,1,0,1
6726,11137,9885,55,5,3,2,1,1,0
6727,11137,9976,45,3,2,1,2,0,2
6728,11152,8543,46,8,5,3,2,1,1
6729,11152,9857,54,3,1,2,2,0,2
6730,11160,10233,47,6,6,0,1,1,0
6731,11160,10167,53,6,2,4,1,0,1
6732,11161,8636,56,12,9,3,3,2,1
6733,11161,8540,44,5,0,5,0,0,0
6734,11164,8535,53,5,3,2,1,1,0
6735,11164,8543,47,10,5,5,2,1,1
6736,11172,9976,47,5,1,4,5,3,2
6737,11172,8636,53,6,2,4,0,0,0
6738,11174,8535,48,7,4,3,1,1,0
6739,11174,10233,52,5,4,1,1,1,0
6740,11175,9885,55,9,3,6,1,1,0
6741,11175,8540,45,1,0,1,0,0,0
6742,11177,8529,44,5,2,3,3,3,0
6743,11177,9885,56,6,4,2,1,0,1
6744,11179,10167,45,3,1,2,4,1,3
6745,11179,8535,55,3,2,1,3,0,3
6746,11180,8686,49,7,6,1,3,2,1
6747,11180,8636,51,15,7,8,1,0,1
6748,11181,9857,55,5,2,3,3,1,2
6749,11181,8530,45,4,2,2,1,0,1
6750,11188,9885,37,3,3,0,2,2,0
6751,11188,8636,63,5,0,5,2,0,2
6752,11201,8535,64,5,1,4,3,2,1
6753,11201,9882,36,2,1,1,2,1,1
6754,11207,8530,52,8,4,4,2,1,1
6755,11207,10233,48,3,3,0,1,0,1
6756,11210,9882,37,9,7,2,3,1,2
6757,11210,8636,63,8,5,3,3,1,2
6758,11214,9885,57,10,5,5,1,1,0
6759,11214,9857,43,0,0,0,0,0,0
6760,11215,8600,57,8,7,1,1,1,0
6761,11215,8540,43,5,3,2,0,0,0
6762,11219,8636,59,10,4,6,1,1,0
6763,11219,10233,41,6,2,4,1,0,1
6764,11222,9882,53,4,1,3,2,0,2
6765,11222,9880,47,2,0,2,0,0,0
6766,11225,9875,66,7,5,2,2,1,1
6767,11225,9858,34,4,1,3,2,0,2
6768,11226,9976,52,6,4,2,2,1,1
6769,11226,8600,48,9,3,6,1,0,1
6770,11229,9882,41,1,0,1,1,1,0
6771,11229,8530,59,7,0,7,0,0,0
6772,11230,9880,47,7,2,5,2,1,1
6773,11230,9885,53,3,1,2,1,1,0
6774,11232,8543,47,1,1,0,7,4,3
6775,11232,8686,53,5,2,3,0,0,0
6776,11234,9976,29,3,2,1,2,1,1
6777,11234,8564,71,12,2,10,0,0,0
6778,11236,9858,36,7,2,5,6,3,3
6779,11236,8636,64,6,3,3,3,1,2
6780,11247,9875,59,5,2,3,1,0,1
6781,11247,8529,41,4,0,4,0,0,0
6782,11248,8535,43,3,2,1,2,0,2
6783,11248,8686,57,6,2,4,0,0,0
6784,11249,9882,54,7,3,4,2,1,1
6785,11249,10167,46,5,0,5,1,0,1
6786,11251,8540,40,6,2,4,1,1,0
6787,11251,8564,60,7,1,6,1,0,1
6788,11260,8686,55,8,6,2,1,0,1
6789,11260,9885,45,7,3,4,0,0,0
6790,11261,8564,45,11,5,6,2,1,1
6791,11261,8636,55,7,5,2,1,1,0
6792,11263,9880,49,7,3,4,1,1,0
6793,11263,8535,51,5,4,1,1,0,1
6794,11267,8600,42,6,4,2,2,1,1
6795,11267,8686,58,3,2,1,0,0,0
6796,11269,8543,58,4,3,1,1,1,0
6797,11269,10167,42,6,3,3,2,1,1
6798,11270,9875,53,6,3,3,3,2,1
6799,11270,9857,47,8,2,6,1,0,1
6800,11272,10233,31,3,1,2,1,0,1
6801,11272,9885,69,10,4,6,2,0,2
6802,11274,8636,58,7,3,4,1,1,0
6803,11274,8533,42,2,1,1,2,1,1
6804,11276,8540,54,8,4,4,5,2,3
6805,11276,9880,46,3,1,2,1,0,1
6806,11283,8686,52,5,3,2,2,1,1
6807,11283,8540,48,6,2,4,3,1,2
6808,11291,9875,44,4,2,2,2,1,1
6809,11291,8540,56,5,4,1,0,0,0
6810,11295,8686,60,9,2,7,1,0,1
6811,11295,8533,40,3,1,2,0,0,0
6812,11298,9875,62,9,2,7,4,2,2
6813,11298,10233,38,1,0,1,1,1,0
6814,11300,8540,73,7,5,2,3,1,2
6815,11300,10167,27,1,0,1,0,0,0
6816,11301,9882,57,7,2,5,2,1,1
6817,11301,9858,43,2,1,1,1,0,1
6818,11304,8543,67,5,4,1,1,1,0
6819,11304,9885,33,2,1,1,1,1,0
6820,11309,8600,45,5,3,2,2,2,0
6821,11309,8543,55,7,2,5,2,1,1
6822,11311,10167,58,4,4,0,1,1,0
6823,11311,9857,42,5,3,2,1,1,0
6824,11317,8535,62,6,5,1,3,2,1
6825,11317,9857,38,3,1,2,1,0,1
6826,11320,9875,42,6,4,2,4,2,2
6827,11320,8636,58,2,1,1,1,1,0
6828,11322,8530,52,8,4,4,3,2,1
6829,11322,8686,48,2,1,1,1,0,1
6830,11324,9882,45,10,2,8,2,2,0
6831,11324,8540,55,6,1,5,1,0,1
6832,11325,10167,56,6,6,0,1,1,0
6833,11325,9885,44,5,1,4,1,1,0
6834,11329,8543,47,8,4,4,3,0,3
6835,11329,9888,53,7,3,4,0,0,0
6836,11333,8600,38,7,1,6,1,1,0
6837,11333,8564,62,5,1,4,1,1,0
6838,11339,8564,58,4,2,2,2,0,2
6839,11339,8543,42,6,2,4,0,0,0
6840,11340,8540,42,5,3,2,2,1,1
6841,11340,9885,58,13,5,8,1,0,1
6842,11344,9882,45,5,2,3,1,0,1
6843,11344,8529,55,4,2,2,0,0,0
6844,11347,8600,39,6,2,4,1,0,1
6845,11347,9882,61,2,1,1,1,0,1
6846,11351,9885,52,4,3,1,3,1,2
6847,11351,8529,48,3,1,2,0,0,0
6848,11352,8535,62,11,6,5,1,0,1
6849,11352,10167,38,3,1,2,0,0,0
6850,11353,8543,59,4,3,1,2,1,1
6851,11353,8533,41,1,1,0,0,0,0
6852,11354,9875,65,10,7,3,1,0,1
6853,11354,9880,35,5,1,4,0,0,0
6854,11357,8530,59,4,3,1,2,1,1
6855,11357,9888,41,3,3,0,0,0,0
6856,11358,9875,38,10,5,5,4,1,3
6857,11358,8686,62,11,5,6,0,0,0
6858,11360,8600,63,9,5,4,3,1,2
6859,11360,9880,37,0,0,0,1,1,0
6860,11362,9885,41,11,4,7,2,0,2
6861,11362,8636,59,10,7,3,2,0,2
6862,11366,9857,52,8,4,4,1,0,1
6863,11366,9882,48,5,4,1,0,0,0
6864,11367,8564,56,9,5,4,2,0,2
6865,11367,8533,44,8,5,3,0,0,0
6866,11368,8540,55,8,2,6,1,0,1
6867,11368,9857,45,2,1,1,0,0,0
6868,11369,8686,53,4,3,1,2,0,2
6869,11369,10233,47,5,0,5,0,0,0
6870,11370,8535,53,2,2,0,4,2,2
6871,11370,9882,47,5,4,1,1,1,0
6872,11374,8636,54,7,3,4,2,0,2
6873,11374,8529,46,3,0,3,0,0,0
6874,11378,10167,51,2,1,1,1,0,1
6875,11378,8686,49,2,1,1,1,0,1
6876,11385,9976,54,2,1,1,2,1,1
6877,11385,8535,46,7,3,4,0,0,0
6878,11387,9888,49,7,4,3,2,2,0
6879,11387,8686,51,12,8,4,0,0,0
6880,11391,10233,38,7,4,3,1,0,1
6881,11391,8636,62,4,3,1,0,0,0
6882,11392,9882,42,5,1,4,2,1,1
6883,11392,9880,58,7,4,3,0,0,0
6884,11402,9875,54,9,4,5,1,1,0
6885,11402,10233,46,6,2,4,0,0,0
6886,11405,8551,55,4,2,2,2,1,1
6887,11405,8535,45,7,3,4,0,0,0
6888,11406,9885,57,10,8,2,4,3,1
6889,11406,8600,43,6,1,5,3,0,3
6890,11415,8533,53,4,3,1,4,1,3
6891,11415,8551,47,4,1,3,1,0,1
6892,11416,8600,54,6,3,3,1,1,0
6893,11416,8540,46,8,2,6,0,0,0
6894,11419,8535,56,3,2,1,2,2,0
6895,11419,8533,44,2,2,0,1,0,1
6896,11422,8530,44,6,4,2,1,1,0
6897,11422,8564,56,10,4,6,1,0,1
6898,11424,8686,64,12,4,8,1,0,1
6899,11424,6269,36,3,1,2,0,0,0
6900,11428,8564,73,6,2,4,2,2,0
6901,11428,8535,27,2,0,2,2,0,2
6902,11432,8540,40,3,2,1,2,1,1
6903,11432,9885,60,4,2,2,3,0,3
6904,11435,8686,69,8,4,4,1,0,1
6905,11435,9888,31,1,1,0,0,0,0
6906,11440,9885,60,5,3,2,1,0,1
6907,11440,8543,40,11,4,7,0,0,0
6908,11444,8535,56,10,6,4,1,0,1
6909,11444,8540,44,3,2,1,1,0,1
6910,11445,8636,67,4,2,2,1,0,1
6911,11445,8551,33,2,0,2,0,0,0
6912,11446,8600,48,3,1,2,2,0,2
6913,11446,8686,52,4,0,4,0,0,0
6914,11455,10167,46,9,4,5,4,3,1
6915,11455,8540,54,2,1,1,0,0,0
6916,11456,8600,37,7,3,4,3,1,2
6917,11456,8636,63,2,2,0,0,0,0
6918,11460,8636,56,9,4,5,2,1,1
6919,11460,8535,44,3,1,2,2,0,2
6920,11463,8540,59,7,4,3,1,0,1
6921,11463,9880,41,7,4,3,0,0,0
6922,11464,9885,58,12,7,5,2,0,2
6923,11464,8686,42,5,1,4,1,0,1
6924,11468,9880,38,7,3,4,1,0,1
6925,11468,8636,62,3,1,2,1,0,1
6926,11469,8529,45,9,5,4,1,1,0
6927,11469,8533,55,8,4,4,1,1,0
6928,11470,8524,57,4,2,2,2,2,0
6929,11470,8535,43,5,1,4,1,0,1
6930,11472,9885,69,13,10,3,2,2,0
6931,11472,6269,31,8,4,4,0,0,0
6932,11473,8600,48,2,1,1,1,0,1
6933,11473,8543,52,11,2,9,0,0,0
6934,11475,9875,44,5,1,4,2,1,1
6935,11475,8686,56,4,1,3,1,1,0
6936,11485,8543,59,8,5,3,2,1,1
6937,11485,8551,41,4,1,3,0,0,0
6938,11487,8686,71,5,2,3,1,1,0
6939,11487,8530,29,3,1,2,1,0,1
6940,11494,8564,65,7,4,3,2,1,1
6941,11494,8636,35,6,3,3,2,1,1
6942,11497,8524,34,6,3,3,1,1,0
6943,11497,9885,66,7,4,3,2,1,1
6944,11502,8564,64,11,9,2,4,2,2
6945,11502,6269,36,2,0,2,1,0,1
6946,11504,8686,79,10,5,5,2,1,1
6947,11504,9880,21,4,1,3,0,0,0
6948,11508,9880,53,6,5,1,3,1,2
6949,11508,9875,47,9,4,5,3,2,1
6950,11510,8535,52,5,1,4,3,1,2
6951,11510,9857,48,5,2,3,1,0,1
6952,11512,9885,66,5,1,4,1,0,1
6953,11512,10167,34,2,0,2,1,0,1
6954,11520,8636,64,13,7,6,2,0,2
6955,11520,9888,36,3,2,1,1,0,1
6956,11526,9885,62,11,8,3,4,3,1
6957,11526,8600,38,6,5,1,0,0,0
6958,11527,8530,47,4,2,2,2,2,0
6959,11527,8551,53,11,3,8,3,1,2
6960,11529,8533,54,5,4,1,1,1,0
6961,11529,6269,46,7,6,1,0,0,0
6962,11532,9885,63,8,4,4,4,1,3
6963,11532,10167,37,3,1,2,0,0,0
6964,11540,8686,65,3,2,1,4,3,1
6965,11540,8636,35,3,1,2,0,0,0
6966,11541,8543,48,5,3,2,2,1,1
6967,11541,10233,52,2,0,2,4,2,2
6968,11544,9885,68,13,3,10,1,1,0
6969,11544,8551,32,3,1,2,1,0,1
6970,11547,8533,43,3,2,1,3,1,2
6971,11547,9875,57,5,0,5,2,1,1
6972,11551,8636,72,13,5,8,1,1,0
6973,11551,6269,28,5,3,2,3,1,2
6974,11553,8686,73,5,3,2,2,2,0
6975,11553,8551,27,3,1,2,3,0,3
6976,11555,8636,49,8,3,5,5,1,4
6977,11555,9857,51,3,1,2,1,0,1
6978,11557,8530,29,5,4,1,2,2,0
6979,11557,9885,71,17,9,8,3,2,1
6980,11559,8543,48,9,1,8,1,1,0
6981,11559,8540,52,2,0,2,2,1,1
6982,11560,8564,66,5,4,1,2,2,0
6983,11560,9880,34,3,1,2,2,1,1
6984,11561,8535,53,8,3,5,1,0,1
6985,11561,9875,47,3,1,2,0,0,0
6986,11566,9875,47,3,2,1,3,2,1
6987,11566,8636,53,2,0,2,2,1,1
6988,11572,8686,73,4,4,0,3,2,1
6989,11572,8524,27,0,0,0,0,0,0
6990,11575,8564,63,8,4,4,1,1,0
6991,11575,8540,37,7,4,3,2,1,1
6992,11577,8529,51,4,3,1,1,0,1
6993,11577,9875,49,3,2,1,1,0,1
6994,11579,8686,66,6,4,2,1,0,1
6995,11579,8540,34,11,4,7,0,0,0
6996,11580,8636,57,7,3,4,3,3,0
6997,11580,8524,43,2,0,2,3,2,1
6998,11584,9885,74,6,3,3,3,1,2
6999,11584,8535,26,3,0,3,2,0,2
7000,11586,8564,53,7,4,3,2,0,2
7001,11586,10167,47,8,3,5,1,0,1
7002,11587,9875,57,10,3,7,4,0,4
7003,11587,8600,43,1,1,0,3,0,3
7004,11590,9857,42,7,6,1,3,1,2
7005,11590,8524,58,10,7,3,3,0,3
7006,11596,8686,51,6,3,3,1,1,0
7007,11596,8564,49,9,6,3,3,2,1
7008,11598,8540,44,4,2,2,2,0,2
7009,11598,8600,56,10,5,5,2,0,2
7010,11599,8540,54,2,1,1,3,2,1
7011,11599,8524,46,1,0,1,4,1,3
7012,11604,10233,51,2,1,1,2,2,0
7013,11604,8543,49,2,0,2,2,1,1
7014,11607,9885,59,7,2,5,3,2,1
7015,11607,8551,41,4,2,2,0,0,0
7016,11609,10233,44,8,6,2,1,1,0
7017,11609,8636,56,7,3,4,0,0,0
7018,11610,10167,49,7,3,4,3,3,0
7019,11610,8543,51,2,1,1,3,2,1
7020,11611,8564,57,9,3,6,2,1,1
7021,11611,8530,43,7,1,6,1,0,1
7022,11612,8686,67,8,2,6,2,1,1
7023,11612,6269,33,8,1,7,1,0,1
7024,11620,9885,65,9,5,4,1,0,1
7025,11620,8540,35,2,1,1,1,0,1
7026,11621,9875,58,2,1,1,1,0,1
7027,11621,8543,42,3,0,3,0,0,0
7028,11630,8533,56,6,4,2,4,1,3
7029,11630,8564,44,3,2,1,0,0,0
7030,11636,8530,47,8,3,5,1,0,1
7031,11636,8529,53,6,2,4,1,0,1
7032,11638,8686,56,7,2,5,2,2,0
7033,11638,8535,44,5,4,1,4,2,2
7034,11640,8600,49,8,3,5,3,2,1
7035,11640,8636,51,3,2,1,0,0,0
7036,11641,9885,68,11,5,6,3,2,1
7037,11641,9880,32,4,3,1,0,0,0
7038,11642,6269,47,6,4,2,1,0,1
7039,11642,8543,53,5,1,4,0,0,0
7040,11646,8564,67,9,4,5,2,0,2
7041,11646,9857,33,6,3,3,1,0,1
7042,11648,8636,65,8,4,4,1,1,0
7043,11648,8535,35,0,0,0,0,0,0
7044,11650,9875,64,12,6,6,1,0,1
7045,11650,6269,36,3,0,3,1,0,1
7046,11665,8564,60,9,6,3,2,2,0
7047,11665,8524,40,4,2,2,2,0,2
7048,11675,8686,59,13,5,8,2,1,1
7049,11675,8530,41,4,4,0,1,1,0
7050,11678,8535,36,2,2,0,2,1,1
7051,11678,9888,64,4,1,3,2,1,1
7052,11680,9885,61,8,5,3,2,1,1
7053,11680,8529,39,0,0,0,1,0,1
7054,11684,8551,41,4,2,2,1,1,0
7055,11684,10167,59,4,1,3,1,1,0
7056,11693,8551,33,4,1,3,2,1,1
7057,11693,9875,67,4,1,3,0,0,0
7058,11696,9875,49,3,2,1,1,1,0
7059,11696,8533,51,4,0,4,3,0,3
7060,11706,8636,52,3,1,2,4,4,0
7061,11706,9857,48,4,2,2,0,0,0
7062,11708,9885,65,6,3,3,1,1,0
7063,11708,8530,35,1,0,1,1,0,1
7064,11709,10233,59,5,5,0,2,1,1
7065,11709,8533,41,9,2,7,7,1,6
7066,11711,9880,34,4,1,3,3,2,1
7067,11711,8564,66,4,0,4,1,0,1
7068,11716,8543,56,6,2,4,2,2,0
7069,11716,8535,44,6,0,6,0,0,0
7070,11725,8524,51,9,4,5,1,0,1
7071,11725,8600,49,2,1,1,2,0,2
7072,11727,8530,60,5,2,3,3,1,2
7073,11727,8636,40,2,0,2,0,0,0
7074,11728,8535,45,6,3,3,1,1,0
7075,11728,9880,55,3,1,2,1,0,1
7076,11733,10167,37,4,4,0,1,0,1
7077,11733,9875,63,6,1,5,0,0,0
7078,11736,8529,47,4,2,2,2,1,1
7079,11736,9875,53,3,1,2,0,0,0
7080,11737,8535,47,9,5,4,1,1,0
7081,11737,8530,53,5,1,4,0,0,0
7082,11738,8636,59,4,4,0,1,1,0
7083,11738,8533,41,4,1,3,3,0,3
7084,11739,10233,42,6,4,2,2,1,1
7085,11739,9885,58,6,5,1,0,0,0
7086,11742,8540,39,8,2,6,1,1,0
7087,11742,8686,61,2,0,2,2,0,2
7088,11745,8524,41,2,2,0,1,0,1
7089,11745,8636,59,4,2,2,0,0,0
7090,11751,10167,35,5,3,2,2,2,0
7091,11751,8564,65,6,1,5,1,1,0
7092,12515,9876,55,4,3,1,2,1,1
7093,12515,8524,45,6,2,4,1,0,1
7094,12519,8543,45,7,1,6,2,0,2
7095,12519,8564,55,1,0,1,1,0,1
7096,12520,9882,55,4,2,2,1,0,1
7097,12520,8540,45,1,0,1,0,0,0
7098,12521,8535,33,4,2,2,2,1,1
7099,12521,8686,67,5,1,4,0,0,0
7100,12522,7943,42,8,3,5,4,1,3
7101,12522,8529,58,7,2,5,2,2,0
7102,12525,9876,54,4,3,1,3,0,3
7103,12525,9880,46,3,1,2,0,0,0
7104,12526,7943,55,5,2,3,1,1,0
7105,12526,8533,45,5,3,2,0,0,0
7106,12528,8543,45,4,4,0,2,1,1
7107,12528,8529,55,4,1,3,1,0,1
7108,12530,9875,42,8,5,3,3,1,2
7109,12530,8686,58,7,4,3,1,0,1
7110,12531,8636,76,2,1,1,2,1,1
7111,12531,10167,24,4,1,3,2,2,0
7112,12532,8535,66,9,6,3,2,2,0
7113,12532,9882,34,5,1,4,0,0,0
7114,12533,8524,31,6,1,5,1,0,1
7115,12533,9804,69,13,1,12,0,0,0
7116,12534,10233,57,3,2,1,1,0,1
7117,12534,8600,43,1,0,1,0,0,0
7118,12535,10233,55,7,4,3,2,1,1
7119,12535,8529,45,6,3,3,0,0,0
7120,12536,8533,59,7,3,4,2,1,1
7121,12536,9880,41,2,0,2,0,0,0
7122,12538,9875,43,10,7,3,1,1,0
7123,12538,8535,57,6,1,5,0,0,0
7124,12540,9885,67,4,3,1,1,1,0
7125,12540,10167,33,2,2,0,0,0,0
7126,12541,8600,30,7,2,5,1,0,1
7127,12541,8540,70,8,2,6,0,0,0
7128,12542,8686,56,7,4,3,2,2,0
7129,12542,9804,44,5,2,3,2,0,2
7130,12544,7943,47,11,5,6,2,0,2
7131,12544,8524,53,3,1,2,1,0,1
7132,12545,8524,40,4,3,1,4,1,3
7133,12545,8686,60,3,3,0,0,0,0
7134,12546,9882,46,5,0,5,1,1,0
7135,12546,9880,54,4,0,4,2,0,2
7136,12547,10233,59,8,5,3,4,2,2
7137,12547,8540,41,5,3,2,3,1,2
7138,12548,9876,36,3,2,1,1,1,0
7139,12548,8535,64,7,5,2,2,0,2
7140,12550,8636,52,2,2,0,5,3,2
7141,12550,8564,48,2,0,2,1,0,1
7142,12551,9875,55,4,2,2,2,1,1
7143,12551,8529,45,7,4,3,0,0,0
7144,12552,10167,48,5,2,3,2,0,2
7145,12552,8534,52,4,2,2,0,0,0
7146,12554,8600,60,4,1,3,4,2,2
7147,12554,8533,40,5,4,1,0,0,0
7148,12555,8535,47,4,3,1,3,2,1
7149,12555,8529,53,9,3,6,2,0,2
7150,12559,9885,62,7,5,2,1,0,1
7151,12559,9804,38,8,2,6,0,0,0
7152,12561,10167,49,7,2,5,1,0,1
7153,12561,8540,51,3,1,2,0,0,0
7154,12562,8686,60,4,3,1,3,3,0
7155,12562,8636,40,2,1,1,1,0,1
7156,12563,9882,54,6,5,1,2,0,2
7157,12563,9875,46,2,0,2,0,0,0
7158,12566,8533,45,4,3,1,1,0,1
7159,12566,8529,55,5,1,4,0,0,0
7160,12567,8535,54,6,4,2,1,0,1
7161,12567,9885,46,8,2,6,1,0,1
7162,12568,8564,47,10,7,3,1,0,1
7163,12568,10233,53,6,4,2,1,0,1
7164,12569,9876,43,8,3,5,1,1,0
7165,12569,9882,57,6,3,3,1,1,0
7166,12570,8600,32,5,2,3,4,0,4
7167,12570,8636,68,9,3,6,1,0,1
7168,12571,9875,57,15,11,4,3,2,1
7169,12571,8534,43,4,2,2,2,2,0
7170,12572,8543,52,5,3,2,1,1,0
7171,12572,10167,48,4,0,4,5,2,3
7172,12573,8686,81,5,4,1,2,2,0
7173,12573,7943,19,3,1,2,0,0,0
7174,12575,9880,32,1,1,0,2,1,1
7175,12575,8535,68,4,1,3,4,0,4
7176,12576,8636,66,12,5,7,3,1,2
7177,12576,8533,34,7,4,3,1,0,1
7178,12577,8534,58,11,5,6,1,1,0
7179,12577,9804,42,5,3,2,0,0,0
7180,12578,8686,65,8,5,3,3,2,1
7181,12578,10233,35,3,3,0,2,0,2
7182,12579,9885,65,11,5,6,3,2,1
7183,12579,9882,35,4,2,2,0,0,0
7184,12580,8543,53,9,4,5,1,0,1
7185,12580,8524,47,2,0,2,0,0,0
7186,12581,9875,45,7,4,3,2,2,0
7187,12581,8564,55,3,0,3,1,1,0
7188,12583,10167,46,1,1,0,3,2,1
7189,12583,8529,54,6,1,5,1,0,1
7190,12584,9876,47,5,4,1,3,3,0
7191,12584,8600,53,9,4,5,1,0,1
7192,12585,8540,46,7,4,3,3,2,1
7193,12585,8524,54,6,1,5,1,0,1
7194,12586,9885,60,7,1,6,1,1,0
7195,12586,8529,40,3,3,0,1,0,1
7196,12587,8535,59,6,3,3,2,1,1
7197,12587,8534,41,5,2,3,1,0,1
7198,12588,9876,57,4,2,2,3,1,2
7199,12588,8533,43,4,2,2,1,0,1
7200,12589,8636,61,8,2,6,1,1,0
7201,12589,8543,39,1,0,1,0,0,0
7202,12590,9875,63,7,1,6,1,1,0
7203,12590,10167,37,0,0,0,1,0,1
7204,12592,8600,35,3,1,2,2,1,1
7205,12592,9882,65,9,3,6,1,0,1
7206,12593,7943,53,10,7,3,1,0,1
7207,12593,9880,47,2,1,1,0,0,0
7208,12594,9804,47,6,2,4,5,3,2
7209,12594,10233,53,6,3,3,0,0,0
7210,12596,8533,54,11,6,5,2,1,1
7211,12596,9804,46,6,4,2,1,1,0
7212,12598,10233,62,10,4,6,1,1,0
7213,12598,8524,38,5,2,3,0,0,0
7214,12599,8636,45,4,1,3,1,1,0
7215,12599,9885,55,8,6,2,1,0,1
7216,12600,8543,53,7,3,4,2,1,1
7217,12600,9882,47,2,1,1,0,0,0
7218,12601,8564,59,6,1,5,6,4,2
7219,12601,7943,41,3,2,1,1,1,0
7220,12602,8529,41,3,2,1,1,1,0
7221,12602,8540,59,3,2,1,1,0,1
7222,12603,8535,71,7,6,1,2,1,1
7223,12603,10167,29,2,0,2,1,1,0
7224,12604,8686,63,7,2,5,1,1,0
7225,12604,8600,37,1,1,0,3,2,1
7226,12606,9880,55,7,3,4,1,1,0
7227,12606,8529,45,5,0,5,1,0,1
7228,12607,8535,54,7,3,4,2,2,0
7229,12607,8540,46,2,1,1,0,0,0
7230,12609,8636,69,9,7,2,2,1,1
7231,12609,10233,31,7,1,6,2,1,1
7232,12610,9885,61,4,4,0,4,2,2
7233,12610,9875,39,3,1,2,2,1,1
7234,12611,8686,53,5,3,2,2,1,1
7235,12611,8543,47,6,2,4,0,0,0
7236,12615,9804,51,5,1,4,3,1,2
7237,12615,9880,49,6,1,5,1,0,1
7238,12616,8533,44,10,5,5,1,1,0
7239,12616,8535,56,8,2,6,1,0,1
7240,12617,8534,64,9,2,7,1,1,0
7241,12617,8636,36,2,1,1,2,1,1
7242,12618,7943,36,7,6,1,1,0,1
7243,12618,10233,64,5,0,5,0,0,0
7244,12620,8543,68,10,4,6,1,1,0
7245,12620,9875,32,7,2,5,0,0,0
7246,12621,8564,68,11,6,5,2,2,0
7247,12621,8524,32,7,3,4,0,0,0
7248,12622,8686,60,4,1,3,1,1,0
7249,12622,8540,40,2,1,1,2,0,2
7250,12623,9882,53,5,2,3,2,0,2
7251,12623,10167,47,5,3,2,0,0,0
7252,12624,8600,55,10,4,6,2,2,0
7253,12624,8529,45,7,2,5,2,0,2
7254,12625,8529,61,9,5,4,1,0,1
7255,12625,8524,39,2,1,1,1,0,1
7256,12626,8686,62,2,1,1,2,0,2
7257,12626,8534,38,9,4,5,0,0,0
7258,12627,8535,65,12,5,7,2,1,1
7259,12627,10233,35,2,1,1,2,1,1
7260,12628,8540,49,4,2,2,3,1,2
7261,12628,9876,51,6,2,4,0,0,0
7262,12629,8636,57,6,4,2,1,1,0
7263,12629,7943,43,6,1,5,1,0,1
7264,12630,9885,60,7,3,4,5,1,4
7265,12630,8600,40,2,0,2,2,0,2
7266,12633,10167,40,7,1,6,1,1,0
7267,12633,8564,60,3,1,2,2,0,2
7268,12635,9876,53,8,4,4,1,0,1
7269,12635,8524,47,7,2,5,0,0,0
7270,12637,9885,66,16,9,7,3,0,3
7271,12637,8533,34,4,2,2,1,0,1
7272,12638,9875,46,8,3,5,2,2,0
7273,12638,10233,54,4,3,1,2,1,1
7274,12640,8540,55,9,3,6,1,0,1
7275,12640,9882,45,6,3,3,0,0,0
7276,12643,8636,72,7,3,4,1,1,0
7277,12643,9804,28,3,0,3,1,1,0
7278,12644,8534,63,6,3,3,2,1,1
7279,12644,8600,37,1,0,1,2,0,2
7280,12646,8686,52,4,1,3,1,0,1
7281,12646,8534,48,1,1,0,0,0,0
7282,12647,10233,45,7,4,3,1,1,0
7283,12647,8535,55,6,2,4,1,1,0
7284,12648,8540,64,6,5,1,4,3,1
7285,12648,9876,36,7,3,4,0,0,0
7286,12649,8636,71,8,4,4,2,1,1
7287,12649,7943,29,7,4,3,0,0,0
7288,12651,9880,45,5,4,1,1,1,0
7289,12651,8543,55,6,4,2,3,2,1
7290,12652,9875,47,7,2,5,4,3,1
7291,12652,8533,53,3,0,3,1,1,0
7292,12654,9882,60,3,2,1,3,3,0
7293,12654,9804,40,5,2,3,0,0,0
7294,12655,8524,41,5,4,1,2,1,1
7295,12655,8535,59,10,5,5,0,0,0
7296,12656,8534,64,4,3,1,2,0,2
7297,12656,9880,36,3,0,3,0,0,0
7298,12657,10167,51,4,3,1,1,1,0
7299,12657,8533,49,4,0,4,1,0,1
7300,12659,9885,56,10,7,3,1,1,0
7301,12659,8564,44,6,1,5,0,0,0
7302,12660,8636,56,4,3,1,1,1,0
7303,12660,8540,44,3,1,2,1,0,1
7304,12661,8529,33,7,3,4,2,2,0
7305,12661,8686,67,4,1,3,2,1,1
7306,12662,7943,46,5,3,2,1,0,1
7307,12662,9882,54,6,2,4,0,0,0
7308,12664,8600,52,5,3,2,2,1,1
7309,12664,9875,48,4,1,3,0,0,0
7310,12665,9804,47,10,2,8,1,0,1
7311,12665,8529,53,3,2,1,0,0,0
7312,12667,8535,56,8,5,3,2,0,2
7313,12667,7943,44,8,3,5,0,0,0
7314,12669,8636,61,8,3,5,2,0,2
7315,12669,8524,39,4,3,1,0,0,0
7316,12672,9875,65,4,3,1,4,4,0
7317,12672,8540,35,2,0,2,3,2,1
7318,12674,9882,70,5,3,2,2,1,1
7319,12674,8533,30,4,0,4,1,0,1
7320,12678,10233,62,5,4,1,4,2,2
7321,12678,9882,38,2,1,1,1,0,1
7322,12679,8636,69,9,6,3,4,1,3
7323,12679,8529,31,5,1,4,0,0,0
7324,12681,8686,77,11,4,7,1,1,0
7325,12681,9876,23,3,2,1,0,0,0
7326,12682,7943,44,4,2,2,1,1,0
7327,12682,9875,56,2,1,1,2,1,1
7328,12683,8535,62,9,6,3,4,1,3
7329,12683,9804,38,6,1,5,1,0,1
7330,12686,8535,42,6,3,3,1,1,0
7331,12686,8636,58,9,3,6,1,0,1
7332,12688,9885,35,3,1,2,1,0,1
7333,12688,8686,65,9,3,6,0,0,0
7334,12689,7943,35,5,2,3,1,0,1
7335,12689,8543,65,6,3,3,0,0,0
7336,12690,8564,66,5,3,2,3,2,1
7337,12690,8533,34,7,3,4,0,0,0
7338,12691,9875,48,6,3,3,1,1,0
7339,12691,9804,52,4,2,2,4,2,2
7340,12692,10233,62,4,2,2,1,0,1
7341,12692,10167,38,3,0,3,0,0,0
7342,12694,8600,44,3,2,1,4,1,3
7343,12694,9880,56,6,4,2,0,0,0
7344,12695,8524,56,3,2,1,3,2,1
7345,12695,10167,44,8,3,5,3,2,1
7346,12696,9882,62,7,4,3,2,1,1
7347,12696,8529,38,5,1,4,2,0,2
7348,12697,8543,47,10,5,5,1,0,1
7349,12697,8535,53,3,2,1,0,0,0
7350,12699,8564,67,10,4,6,1,0,1
7351,12699,9876,33,5,3,2,0,0,0
7352,12700,8636,60,6,4,2,2,1,1
7353,12700,9875,40,6,5,1,1,1,0
7354,12702,8686,60,5,3,2,1,1,0
7355,12702,8533,40,4,2,2,5,1,4
7356,12703,9885,64,6,2,4,1,0,1
7357,12703,7943,36,1,1,0,0,0,0
7358,12706,8533,41,6,3,3,1,0,1
7359,12706,10233,59,7,4,3,0,0,0
7360,12708,9885,53,4,1,3,2,1,1
7361,12708,8540,47,7,2,5,3,0,3
7362,12709,8543,63,6,4,2,1,0,1
7363,12709,9804,37,5,1,4,0,0,0
7364,12712,10167,40,4,1,3,2,2,0
7365,12712,7943,60,10,3,7,2,1,1
7366,12713,8686,61,10,6,4,1,0,1
7367,12713,9882,39,4,2,2,0,0,0
7368,12715,9875,58,11,5,6,2,0,2
7369,12715,8524,42,4,4,0,0,0,0
7370,12718,9885,51,6,3,3,1,1,0
7371,12718,10233,49,4,3,1,3,1,2
7372,12719,9876,39,2,1,1,2,1,1
7373,12719,8543,61,11,5,6,0,0,0
7374,12720,8636,69,3,1,2,3,2,1
7375,12720,9882,31,3,2,1,4,0,4
7376,12721,8533,29,8,4,4,3,1,2
7377,12721,8540,71,5,1,4,2,1,1
7378,12722,8686,51,4,4,0,7,3,4
7379,12722,9880,49,1,0,1,1,0,1
7380,12724,9804,58,5,2,3,2,2,0
7381,12724,10167,42,6,1,5,1,1,0
7382,12725,9880,61,8,4,4,3,2,1
7383,12725,9876,39,6,3,3,0,0,0
7384,12728,8529,40,8,4,4,2,1,1
7385,12728,8543,60,8,3,5,1,0,1
7386,12730,8686,61,3,1,2,3,2,1
7387,12730,9875,39,7,3,4,3,2,1
7388,12733,8524,44,5,3,2,1,1,0
7389,12733,9804,56,5,1,4,1,0,1
7390,12734,8600,41,9,5,4,2,2,0
7391,12734,10233,59,8,5,3,1,0,1
7392,12735,8535,67,10,5,5,1,1,0
7393,12735,8524,33,9,3,6,1,1,0
7394,12736,8534,62,6,2,4,2,1,1
7395,12736,9880,38,3,2,1,3,0,3
7396,12737,10167,60,3,2,1,4,1,3
7397,12737,8533,40,1,0,1,0,0,0
7398,12738,8543,65,7,6,1,3,1,2
7399,12738,10233,35,3,2,1,2,0,2
7400,12739,8564,37,8,6,2,3,3,0
7401,12739,9885,63,5,3,2,2,1,1
7402,12742,7943,40,5,2,3,5,3,2
7403,12742,9882,60,3,0,3,0,0,0
7404,12743,9804,49,7,2,5,2,1,1
7405,12743,9876,51,4,2,2,1,0,1
7406,12744,9875,57,4,3,1,1,1,0
7407,12744,8600,43,4,1,3,0,0,0
7408,12745,8529,39,13,3,10,1,1,0
7409,12745,10233,61,11,3,8,0,0,0
7410,12747,8534,53,9,4,5,1,1,0
7411,12747,8543,47,3,1,2,1,0,1
7412,12748,9875,34,4,4,0,5,2,3
7413,12748,8535,66,2,2,0,0,0,0
7414,12749,9876,36,7,0,7,2,2,0
7415,12749,8636,64,0,0,0,2,1,1
7416,12750,10167,33,3,1,2,2,2,0
7417,12750,9885,67,8,7,1,0,0,0
7418,12752,9804,37,6,3,3,1,0,1
7419,12752,8686,63,8,1,7,0,0,0
7420,12753,8564,56,13,8,5,2,0,2
7421,12753,9882,44,4,2,2,0,0,0
7422,12755,8686,57,9,2,7,1,0,1
7423,12755,8524,43,3,2,1,1,0,1
7424,12756,9882,61,10,5,5,2,1,1
7425,12756,9880,39,5,3,2,0,0,0
7426,12757,8540,44,5,3,2,1,0,1
7427,12757,10233,56,2,0,2,2,0,2
7428,12759,9885,44,3,2,1,2,1,1
7429,12759,8543,56,5,2,3,1,0,1
7430,12760,8636,59,7,2,5,5,3,2
7431,12760,8564,41,6,2,4,2,1,1
7432,12761,8529,43,5,3,2,1,1,0
7433,12761,9875,57,4,3,1,1,1,0
7434,12764,8600,53,3,2,1,2,1,1
7435,12764,8533,47,12,4,8,1,0,1
7436,12767,8543,69,12,6,6,1,0,1
7437,12767,8533,31,2,1,1,0,0,0
7438,12768,8524,48,7,2,5,1,1,0
7439,12768,8534,52,10,7,3,3,1,2
7440,12769,9804,53,4,3,1,3,1,2
7441,12769,9885,47,5,2,3,1,0,1
7442,12774,9876,38,9,5,4,4,3,1
7443,12774,7943,62,8,2,6,2,0,2
7444,12776,8529,54,6,5,1,1,0,1
7445,12776,8533,46,5,1,4,1,0,1
7446,12777,9885,57,6,5,1,1,1,0
7447,12777,8535,43,2,1,1,0,0,0
7448,12778,10233,39,12,7,5,2,1,1
7449,12778,8564,61,6,2,4,3,2,1
7450,12779,9876,36,6,1,5,2,1,1
7451,12779,9882,64,11,6,5,1,0,1
7452,12780,8636,62,14,7,7,1,1,0
7453,12780,8600,38,3,0,3,2,0,2
7454,12782,10167,33,2,1,1,2,1,1
7455,12782,8543,67,5,2,3,0,0,0
7456,12784,9804,48,5,2,3,3,1,2
7457,12784,8540,52,4,0,4,0,0,0
7458,12786,8636,71,11,5,6,2,1,1
7459,12786,8533,29,5,0,5,1,0,1
7460,12787,8534,41,12,9,3,4,3,1
7461,12787,9804,59,7,1,6,1,0,1
7462,12791,9875,76,7,1,6,3,1,2
7463,12791,8564,24,1,1,0,1,0,1
7464,12793,10167,46,8,3,5,1,0,1
7465,12793,8529,54,4,3,1,1,0,1
7466,12795,8540,64,11,3,8,2,1,1
7467,12795,8524,36,6,1,5,0,0,0
7468,12796,8529,43,9,2,7,2,1,1
7469,12796,9885,57,4,3,1,4,2,2
7470,12797,8535,57,4,1,3,2,0,2
7471,12797,8534,43,4,0,4,0,0,0
7472,12799,8543,36,9,5,4,2,1,1
7473,12799,8636,64,7,2,5,2,1,1
7474,12803,9880,47,9,2,7,3,2,1
7475,12803,7943,53,5,3,2,1,0,1
7476,12804,10233,58,6,6,0,2,1,1
7477,12804,9804,42,4,3,1,2,1,1
7478,12805,9875,53,4,1,3,3,1,2
7479,12805,9880,47,2,1,1,2,0,2
7480,12807,9876,45,6,4,2,3,3,0
7481,12807,8534,55,8,4,4,0,0,0
7482,12809,8636,67,11,6,5,1,0,1
7483,12809,9885,33,4,3,1,0,0,0
7484,12810,8543,56,3,2,1,1,1,0
7485,12810,9882,44,1,1,0,1,0,1
7486,12811,7943,39,4,1,3,1,0,1
7487,12811,8564,61,3,2,1,1,0,1
7488,12813,8535,69,9,4,5,2,1,1
7489,12813,10167,31,7,2,5,2,1,1
7490,12814,8600,26,2,1,1,1,0,1
7491,12814,8686,74,3,3,0,1,0,1
7492,12815,8533,35,8,2,6,1,0,1
7493,12815,8524,65,4,4,0,3,0,3
7494,12816,8529,57,4,1,3,3,1,2
7495,12816,9880,43,5,1,4,1,1,0
7496,12819,8636,53,6,4,2,2,2,0
7497,12819,10233,47,8,6,2,1,0,1
7498,12820,9875,42,11,4,7,2,2,0
7499,12820,9885,58,4,2,2,0,0,0
7500,12821,8543,63,9,4,5,3,1,2
7501,12821,8686,37,1,0,1,0,0,0
7502,12827,8636,58,9,6,3,6,3,3
7503,12827,8534,42,5,0,5,3,1,2
7504,12829,9876,42,6,3,3,1,0,1
7505,12829,9885,58,3,2,1,0,0,0
7506,12830,8564,60,3,3,0,3,3,0
7507,12830,8524,40,9,7,2,3,1,2
7508,12832,9882,53,8,3,5,2,2,0
7509,12832,10167,47,1,1,0,1,1,0
7510,12833,8600,47,4,3,1,3,2,1
7511,12833,8529,53,4,3,1,3,1,2
7512,12835,8534,52,5,2,3,2,1,1
7513,12835,8564,48,5,2,3,0,0,0
7514,12838,8636,48,6,2,4,2,2,0
7515,12838,8524,52,5,4,1,3,2,1
7516,12840,8600,40,4,3,1,1,1,0
7517,12840,8543,60,6,1,5,1,0,1
7518,12841,8540,41,3,3,0,1,1,0
7519,12841,9875,59,10,5,5,1,0,1
7520,12842,10167,33,4,2,2,2,0,2
7521,12842,8686,67,5,1,4,0,0,0
7522,12843,8533,32,3,1,2,1,1,0
7523,12843,9882,68,7,4,3,3,2,1
7524,12846,8533,57,7,5,2,5,2,3
7525,12846,8534,43,3,1,2,0,0,0
7526,12847,10233,51,5,2,3,2,1,1
7527,12847,9882,49,3,2,1,1,0,1
7528,12849,8543,55,9,4,5,5,2,3
7529,12849,8540,45,11,5,6,0,0,0
7530,12852,9804,39,7,5,2,3,2,1
7531,12852,8535,61,14,10,4,0,0,0
7532,12853,10167,61,11,5,6,3,3,0
7533,12853,8600,39,3,0,3,1,1,0
7534,12854,8540,32,5,3,2,2,1,1
7535,12854,8534,68,13,7,6,1,0,1
7536,12855,8535,48,7,4,3,2,1,1
7537,12855,8636,52,8,2,6,4,0,4
7538,12856,8529,48,8,7,1,1,1,0
7539,12856,9876,52,10,3,7,0,0,0
7540,12861,10233,53,6,5,1,1,1,0
7541,12861,10167,47,3,3,0,0,0,0
7542,12862,9882,54,7,4,3,1,0,1
7543,12862,8524,46,2,0,2,0,0,0
7544,12863,9880,43,4,2,2,6,3,3
7545,12863,8600,57,3,0,3,2,0,2
7546,12865,8529,53,3,2,1,3,1,2
7547,12865,9882,47,5,2,3,0,0,0
7548,12867,8534,52,5,3,2,4,1,3
7549,12867,10233,48,3,1,2,0,0,0
7550,12868,8564,51,4,2,2,2,1,1
7551,12868,9876,49,10,4,6,1,0,1
7552,12870,8540,54,3,1,2,2,2,0
7553,12870,9880,46,2,0,2,2,1,1
7554,12872,9885,60,7,5,2,3,2,1
7555,12872,7943,40,4,1,3,1,0,1
7556,12874,8636,65,8,1,7,2,0,2
7557,12874,9880,35,2,1,1,0,0,0
7558,12875,8533,43,5,3,2,1,1,0
7559,12875,10233,57,4,1,3,1,0,1
7560,12876,8529,47,9,6,3,1,0,1
7561,12876,8534,53,8,2,6,0,0,0
7562,12879,8564,42,7,2,5,1,1,0
7563,12879,8535,58,4,1,3,1,0,1
7564,12880,9875,76,14,11,3,3,2,1
7565,12880,9876,24,5,2,3,2,2,0
7566,12881,7943,52,5,2,3,3,1,2
7567,12881,10167,48,7,2,5,2,0,2
7568,12883,8524,53,8,3,5,4,1,3
7569,12883,8600,47,3,1,2,0,0,0
7570,12884,9875,79,7,4,3,1,1,0
7571,12884,8524,21,4,2,2,3,0,3
7572,12886,8535,70,15,10,5,2,1,1
7573,12886,8600,30,2,2,0,1,1,0
7574,12888,9876,42,4,2,2,4,2,2
7575,12888,8543,58,4,2,2,0,0,0
7576,12890,8533,46,7,3,4,2,0,2
7577,12890,8540,54,7,3,4,0,0,0
7578,12891,8686,71,7,3,4,5,2,3
7579,12891,9880,29,1,1,0,2,0,2
7580,12893,9804,57,7,2,5,1,1,0
7581,12893,10167,43,4,2,2,0,0,0
7582,12894,8534,58,9,8,1,2,0,2
7583,12894,8533,42,2,1,1,0,0,0
7584,12895,8535,51,9,6,3,1,1,0
7585,12895,8564,49,4,2,2,0,0,0
7586,12896,9891,39,5,3,2,2,0,2
7587,12896,9804,61,14,7,7,0,0,0
7588,12899,9885,67,15,6,9,4,1,3
7589,12899,8600,33,3,0,3,1,1,0
7590,12900,9857,40,5,3,2,2,1,1
7591,12900,8543,60,14,5,9,1,0,1
7592,12904,8524,44,4,2,2,2,2,0
7593,12904,8543,56,5,3,2,0,0,0
7594,12906,208931,53,5,2,3,1,0,1
7595,12906,9891,47,2,2,0,0,0,0
7596,12908,8533,44,4,3,1,1,1,0
7597,12908,8564,56,7,3,4,3,0,3
7598,12909,9875,74,11,5,6,1,0,1
7599,12909,8540,26,3,2,1,0,0,0
7600,12913,10233,51,2,2,0,2,1,1
7601,12913,9804,49,8,2,6,4,3,1
7602,12914,9857,52,2,2,0,3,1,2
7603,12914,8524,48,4,3,1,0,0,0
7604,12918,9875,55,12,4,8,4,2,2
7605,12918,10233,45,3,1,2,1,0,1
7606,12919,8686,56,11,4,7,2,2,0
7607,12919,8636,44,5,3,2,2,1,1
7608,12920,9885,56,7,1,6,2,1,1
7609,12920,9804,44,7,0,7,0,0,0
7610,12921,8564,40,2,2,0,1,1,0
7611,12921,8543,60,3,1,2,1,0,1
7612,12925,9891,44,9,5,4,3,1,2
7613,12925,10233,56,3,3,0,0,0,0
7614,12926,9876,54,8,5,3,1,1,0
7615,12926,9857,46,3,0,3,1,0,1
7616,12927,8564,45,5,3,2,3,3,0
7617,12927,8524,55,8,1,7,1,0,1
7618,12928,9875,61,11,5,6,2,0,2
7619,12928,8600,39,4,1,3,0,0,0
7620,12929,8533,47,7,2,5,1,1,0
7621,12929,8540,53,4,0,4,3,0,3
7622,12930,8686,55,4,3,1,4,1,3
7623,12930,8543,45,2,0,2,0,0,0
7624,12931,9882,47,3,2,1,2,0,2
7625,12931,8535,53,9,2,7,0,0,0
7626,12932,208931,38,3,3,0,1,0,1
7627,12932,7943,62,3,1,2,0,0,0
7628,12933,9804,38,9,2,7,2,1,1
7629,12933,8636,62,2,1,1,1,0,1
7630,12934,9804,44,6,4,2,3,1,2
7631,12934,8524,56,8,6,2,1,0,1
7632,12937,8534,41,7,4,3,5,4,1
7633,12937,8535,59,8,2,6,2,0,2
7634,12938,7943,51,5,3,2,3,2,1
7635,12938,10233,49,3,0,3,0,0,0
7636,12940,8636,66,12,6,6,2,1,1
7637,12940,9891,34,5,4,1,0,0,0
7638,12942,8543,64,8,8,0,3,3,0
7639,12942,8540,36,10,5,5,1,0,1
7640,12944,8533,48,4,4,0,2,1,1
7641,12944,8600,52,6,3,3,2,1,1
7642,12947,208931,47,5,2,3,2,0,2
7643,12947,10233,53,6,1,5,0,0,0
7644,12948,9882,32,5,3,2,1,1,0
7645,12948,8564,68,8,4,4,3,1,2
7646,12951,8686,57,10,4,6,2,1,1
7647,12951,8524,43,2,0,2,0,0,0
7648,12953,9804,63,7,5,2,2,0,2
7649,12953,9857,37,2,2,0,0,0,0
7650,12954,8524,46,2,2,0,5,3,2
7651,12954,8540,54,7,4,3,4,1,3
7652,12955,9857,29,2,1,1,1,0,1
7653,12955,9875,71,7,3,4,0,0,0
7654,12956,208931,43,6,4,2,2,0,2
7655,12956,8564,57,8,3,5,1,0,1
7656,12959,8534,44,5,4,1,3,1,2
7657,12959,9876,56,13,7,6,1,1,0
7658,12960,8636,68,6,5,1,4,1,3
7659,12960,10233,32,4,1,3,2,1,1
7660,12962,9882,59,4,2,2,2,1,1
7661,12962,7943,41,7,6,1,0,0,0
7662,12964,8533,49,7,2,5,2,1,1
7663,12964,8524,51,1,1,0,1,0,1
7664,12966,10233,70,13,8,5,2,2,0
7665,12966,9857,30,4,0,4,0,0,0
7666,12968,8543,58,3,3,0,1,1,0
7667,12968,9882,42,4,2,2,2,1,1
7668,12969,9876,47,4,3,1,2,1,1
7669,12969,8564,53,8,3,5,1,0,1
7670,12972,7943,62,6,3,3,2,1,1
7671,12972,9804,38,3,1,2,2,1,1
7672,12974,8524,43,10,5,5,2,1,1
7673,12974,9875,57,5,3,2,0,0,0
7674,12975,8534,54,9,4,5,2,1,1
7675,12975,9857,46,5,0,5,0,0,0
7676,12976,9885,72,4,4,0,2,0,2
7677,12976,208931,28,5,2,3,0,0,0
7678,12977,8535,72,8,4,4,2,0,2
7679,12977,8533,28,6,0,6,0,0,0
7680,12978,9891,23,7,4,3,5,2,3
7681,12978,8564,77,14,9,5,0,0,0
7682,12980,8543,37,5,3,2,1,1,0
7683,12980,8636,63,4,3,1,3,2,1
7684,12983,8600,62,7,4,3,2,1,1
7685,12983,9804,38,3,2,1,1,0,1
7686,12986,9882,40,4,2,2,2,0,2
7687,12986,10233,60,13,3,10,0,0,0
7688,12987,9876,40,2,1,1,4,1,3
7689,12987,9885,60,4,2,2,0,0,0
7690,12988,208931,34,1,0,1,2,1,1
7691,12988,8543,66,4,0,4,1,0,1
7692,12989,9857,40,3,1,2,3,1,2
7693,12989,8564,60,13,6,7,1,0,1
7694,12990,9875,61,8,4,4,3,1,2
7695,12990,9804,39,3,2,1,1,0,1
7696,12991,8535,59,2,1,1,1,1,0
7697,12991,8540,41,4,0,4,2,0,2
7698,12992,7943,58,11,2,9,2,0,2
7699,12992,9891,42,1,0,1,1,0,1
7700,12993,8600,48,7,3,4,2,0,2
7701,12993,8524,52,11,3,8,0,0,0
7702,12995,9857,54,5,1,4,1,1,0
7703,12995,8533,46,4,1,3,3,1,2
7704,12996,208931,51,7,5,2,1,1,0
7705,12996,8600,49,4,1,3,2,2,0
7706,12997,8535,63,10,4,6,1,1,0
7707,12997,8543,37,3,2,1,0,0,0
7708,12999,9876,56,12,5,7,2,1,1
7709,12999,8540,44,5,2,3,2,0,2
7710,13001,8686,42,5,3,2,1,0,1
7711,13001,8564,58,8,6,2,0,0,0
7712,13002,9885,56,5,2,3,2,0,2
7713,13002,9882,44,3,1,2,2,0,2
7714,13005,7943,55,5,1,4,3,0,3
7715,13005,9857,45,6,3,3,0,0,0
7716,13007,8543,57,7,3,4,1,0,1
7717,13007,8533,43,4,3,1,0,0,0
7718,13009,8534,46,9,2,7,2,1,1
7719,13009,8564,54,2,1,1,0,0,0
7720,13013,8600,48,10,4,6,1,0,1
7721,13013,8540,52,3,2,1,1,0,1
7722,13014,8534,64,7,1,6,2,1,1
7723,13014,8533,36,4,2,2,2,1,1
7724,13015,8535,70,3,1,2,3,2,1
7725,13015,8564,30,1,0,1,0,0,0
7726,13016,9804,59,10,5,5,2,2,0
7727,13016,9891,41,7,3,4,3,0,3
7728,13017,8686,76,6,1,5,2,0,2
7729,13017,9876,24,4,3,1,1,0,1
7730,13022,9882,58,7,4,3,1,0,1
7731,13022,208931,42,7,3,4,0,0,0
7732,13023,9875,69,7,3,4,2,0,2
7733,13023,7943,31,5,4,1,0,0,0
7734,13024,9891,53,5,3,2,1,1,0
7735,13024,8524,47,6,2,4,0,0,0
7736,13026,8636,72,9,4,5,2,0,2
7737,13026,208931,28,7,6,1,0,0,0
7738,13028,10233,57,4,3,1,1,1,0
7739,13028,9876,43,10,2,8,3,0,3
7740,13029,8534,56,8,5,3,3,2,1
7741,13029,8564,44,5,3,2,1,0,1
7742,13030,9882,48,4,2,2,1,1,0
7743,13030,9875,52,9,4,5,3,1,2
7744,13032,9804,42,5,2,3,3,1,2
7745,13032,8535,58,4,1,3,0,0,0
7746,13038,8636,55,6,4,2,3,1,2
7747,13038,8564,45,5,0,5,1,1,0
7748,13040,8600,43,4,2,2,2,1,1
7749,13040,8543,57,10,4,6,2,1,1
7750,13041,208931,49,5,3,2,1,1,0
7751,13041,8540,51,1,0,1,0,0,0
7752,13044,8524,53,9,5,4,1,1,0
7753,13044,9876,47,2,0,2,1,0,1
7754,13047,8636,72,10,6,4,1,0,1
7755,13047,8533,28,5,1,4,1,0,1
7756,13048,9885,61,6,4,2,5,2,3
7757,13048,10233,39,6,3,3,1,0,1
7758,13050,9875,59,4,2,2,3,1,2
7759,13050,8543,41,2,0,2,0,0,0
7760,13053,8534,64,7,5,2,2,0,2
7761,13053,8600,36,3,2,1,2,0,2
7762,13054,9875,77,8,4,4,1,1,0
7763,13054,208931,23,0,0,0,1,0,1
7764,13055,9804,43,9,5,4,2,0,2
7765,13055,8533,57,4,1,3,0,0,0
7766,13056,8534,46,4,4,0,3,2,1
7767,13056,8524,54,6,6,0,0,0,0
7768,13057,9857,36,9,4,5,3,1,2
7769,13057,8535,64,3,3,0,0,0,0
7770,13059,9885,63,15,5,10,2,1,1
7771,13059,9891,37,1,1,0,1,1,0
7772,13060,8543,45,2,1,1,2,0,2
7773,13060,10233,55,4,1,3,0,0,0
7774,13061,7943,60,9,3,6,2,1,1
7775,13061,8540,40,2,2,0,0,0,0
7776,13062,8686,67,4,3,1,2,1,1
7777,13062,9882,33,6,1,5,3,1,2
7778,13063,8564,61,14,7,7,1,1,0
7779,13063,8600,39,6,3,3,2,1,1
7780,13068,8543,67,7,4,3,1,1,0
7781,13068,9876,33,3,2,1,4,3,1
7782,13069,8535,64,8,4,4,1,0,1
7783,13069,8636,36,1,0,1,0,0,0
7784,13070,9885,45,4,3,1,4,1,3
7785,13070,9875,55,2,1,1,0,0,0
7786,13071,8686,74,7,4,3,6,3,3
7787,13071,208931,26,1,0,1,2,2,0
7788,13073,8540,44,9,2,7,1,0,1
7789,13073,9804,56,9,0,9,1,0,1
7790,13074,9804,56,7,4,3,2,2,0
7791,13074,208931,44,1,1,0,2,1,1
7792,13080,8564,38,3,1,2,2,1,1
7793,13080,9875,62,7,2,5,0,0,0
7794,13083,10233,64,9,4,5,3,2,1
7795,13083,8600,36,6,0,6,1,0,1
7796,13087,8533,51,10,3,7,3,2,1
7797,13087,10233,49,8,4,4,1,0,1
7798,13090,8535,52,2,1,1,2,2,0
7799,13090,9875,48,5,1,4,1,0,1
7800,13091,8686,54,5,2,3,2,0,2
7801,13091,8534,46,5,3,2,1,0,1
7802,13093,9804,36,6,3,3,3,2,1
7803,13093,8564,64,8,5,3,1,0,1
7804,13095,9875,74,12,7,5,2,1,1
7805,13095,8533,26,3,1,2,0,0,0
7806,13097,8535,47,3,1,2,1,1,0
7807,13097,8686,53,3,0,3,1,0,1
7808,13102,9882,60,7,6,1,3,0,3
7809,13102,9876,40,6,3,3,0,0,0
7810,13103,9891,49,3,1,2,1,1,0
7811,13103,8600,51,3,2,1,0,0,0
7812,13104,8524,48,5,4,1,4,2,2
7813,13104,8543,52,0,0,0,0,0,0
7814,13107,8535,63,6,1,5,3,1,2
7815,13107,9876,37,7,0,7,1,1,0
7816,13109,9875,69,8,2,6,2,1,1
7817,13109,8540,31,5,3,2,2,0,2
7818,13111,9882,49,7,5,2,6,3,3
7819,13111,8534,51,10,5,5,0,0,0
7820,13114,8534,47,5,4,1,3,2,1
7821,13114,9875,53,7,3,4,1,0,1
7822,13115,8535,59,4,3,1,2,1,1
7823,13115,10233,41,8,2,6,2,0,2
7824,13116,8686,64,7,5,2,1,1,0
7825,13116,9891,36,7,1,6,1,1,0
7826,13118,8564,42,9,6,3,2,2,0
7827,13118,8636,58,7,4,3,0,0,0
7828,13120,8600,36,8,1,7,2,1,1
7829,13120,8543,64,8,3,5,0,0,0
7830,13122,9857,43,5,4,1,3,2,1
7831,13122,9882,57,5,2,3,1,0,1
7832,13123,7943,55,7,3,4,1,1,0
7833,13123,8524,45,3,2,1,2,0,2
7834,13125,9876,59,4,2,2,2,2,0
7835,13125,208931,41,6,3,3,3,0,3
7836,13127,8535,72,14,6,8,1,1,0
7837,13127,9891,28,7,3,4,0,0,0
7838,13130,9885,59,6,4,2,1,0,1
7839,13130,9804,41,7,2,5,0,0,0
7840,13132,8540,45,4,4,0,3,1,2
7841,13132,8534,55,5,3,2,0,0,0
7842,13135,9891,44,3,1,2,2,1,1
7843,13135,10233,56,5,0,5,1,1,0
7844,13136,9857,55,6,2,4,5,1,4
7845,13136,9876,45,1,0,1,0,0,0
7846,13137,8564,44,6,2,4,3,0,3
7847,13137,8524,56,5,2,3,1,0,1
7848,13140,8543,37,5,2,3,1,1,0
7849,13140,8686,63,3,1,2,1,0,1
7850,13145,8686,67,4,3,1,3,1,2
7851,13145,9857,33,4,1,3,0,0,0
7852,13146,8533,65,6,3,3,1,0,1
7853,13146,208931,35,5,1,4,1,0,1
7854,13150,9891,40,5,2,3,1,0,1
7855,13150,8636,60,6,0,6,0,0,0
7856,13152,8543,73,8,5,3,5,5,0
7857,13152,8540,27,5,0,5,2,0,2
7858,13154,8600,44,7,3,4,2,2,0
7859,13154,8533,56,2,1,1,0,0,0
7860,13157,208931,39,6,3,3,5,3,2
7861,13157,10233,61,7,3,4,1,1,0
7862,13158,8564,63,7,6,1,2,1,1
7863,13158,9882,37,4,3,1,1,0,1
7864,13160,9885,69,3,2,1,1,0,1
7865,13160,8540,31,6,3,3,0,0,0
7866,13161,8686,61,6,2,4,2,0,2
7867,13161,8524,39,3,1,2,0,0,0
7868,13162,8535,57,5,4,1,8,5,3
7869,13162,7943,43,2,0,2,0,0,0
7870,13163,9804,43,2,2,0,3,1,2
7871,13163,9857,57,3,1,2,2,0,2
7872,13166,8564,79,11,4,7,2,1,1
7873,13166,208931,21,2,0,2,2,1,1
7874,13167,8535,72,5,3,2,1,0,1
7875,13167,8600,28,3,1,2,0,0,0
7876,13168,8533,56,8,4,4,1,1,0
7877,13168,9891,44,1,1,0,1,0,1
7878,13169,8534,62,8,6,2,3,2,1
7879,13169,9876,38,10,3,7,2,1,1
7880,13172,7943,58,7,1,6,1,1,0
7881,13172,9882,42,2,1,1,0,0,0
7882,13173,9804,53,5,1,4,2,2,0
7883,13173,8686,47,7,6,1,1,0,1
7884,13174,8524,53,10,3,7,1,1,0
7885,13174,8533,47,5,1,4,4,2,2
7886,13178,9882,42,6,2,4,3,1,2
7887,13178,8543,58,6,3,3,0,0,0
7888,13180,8686,55,3,3,0,3,1,2
7889,13180,9875,45,4,2,2,1,0,1
7890,13181,8540,53,1,1,0,3,3,0
7891,13181,9891,47,6,1,5,3,0,3
7892,13183,8636,62,13,6,7,4,2,2
7893,13183,8600,38,6,2,4,0,0,0
7894,13186,9885,74,7,5,2,4,3,1
7895,13186,208931,26,3,1,2,3,1,2
7896,13187,8535,57,9,5,4,3,0,3
7897,13187,8533,43,6,2,4,0,0,0
7898,13188,9891,32,4,1,3,2,1,1
7899,13188,8564,68,12,8,4,0,0,0
7900,13191,10233,45,6,4,2,1,1,0
7901,13191,8686,55,7,4,3,0,0,0
7902,13193,9804,62,5,4,1,1,1,0
7903,13193,8600,38,5,3,2,2,0,2
7904,13195,8636,48,6,5,1,1,1,0
7905,13195,8534,52,4,2,2,0,0,0
7906,13196,10233,49,7,6,1,3,2,1
7907,13196,9882,51,5,2,3,1,1,0
7908,13197,9876,44,6,2,4,1,0,1
7909,13197,9885,56,9,1,8,1,0,1
7910,13198,208931,47,10,1,9,1,1,0
7911,13198,8543,53,7,5,2,3,1,2
7912,13199,8564,58,6,3,3,1,1,0
7913,13199,9857,42,3,1,2,0,0,0
7914,13200,9875,66,7,6,1,3,1,2
7915,13200,9804,34,5,3,2,2,0,2
7916,13201,8535,69,11,6,5,1,1,0
7917,13201,8540,31,2,2,0,3,0,3
7918,13203,8524,73,5,5,0,2,2,0
7919,13203,8600,27,1,1,0,4,2,2
7920,13204,10233,53,4,1,3,1,1,0
7921,13204,8524,47,4,3,1,1,1,0
7922,13208,9891,22,5,2,3,1,0,1
7923,13208,9875,78,16,12,4,0,0,0
7924,13209,9876,60,4,2,2,5,3,2
7925,13209,8540,40,0,0,0,0,0,0
7926,13210,8636,61,5,4,1,1,1,0
7927,13210,7943,39,2,0,2,4,1,3
7928,13212,9882,26,3,2,1,4,3,1
7929,13212,9885,74,8,3,5,3,3,0
7930,13213,8534,53,3,3,0,1,0,1
7931,13213,9804,47,7,1,6,1,0,1
7932,13215,9891,62,7,2,5,3,3,0
7933,13215,9857,38,7,6,1,4,3,1
7934,13217,8533,42,5,4,1,2,2,0
7935,13217,8636,58,4,2,2,2,1,1
7936,13218,9885,54,4,3,1,2,1,1
7937,13218,10233,46,2,0,2,4,0,4
7938,13220,9875,63,6,4,2,1,1,0
7939,13220,8543,37,3,0,3,0,0,0
7940,13221,7943,43,9,5,4,2,1,1
7941,13221,8686,57,10,5,5,0,0,0
7942,13222,9804,55,10,7,3,1,1,0
7943,13222,9882,45,8,1,7,1,1,0
7944,13224,9875,68,8,7,1,1,0,1
7945,13224,208931,32,2,0,2,2,0,2
7946,13225,9804,52,2,1,1,2,0,2
7947,13225,8533,48,5,1,4,0,0,0
7948,13227,8535,63,11,4,7,2,2,0
7949,13227,9857,37,1,1,0,0,0,0
7950,13229,9885,65,16,5,11,2,1,1
7951,13229,9891,35,3,1,2,3,1,2
7952,13230,8543,49,4,3,1,3,2,1
7953,13230,10233,51,4,3,1,2,1,1
7954,13232,9882,38,5,1,4,1,0,1
7955,13232,8686,62,17,4,13,0,0,0
7956,13240,9875,55,4,1,3,5,2,3
7957,13240,9885,45,5,1,4,0,0,0
7958,13241,8686,66,6,4,2,2,0,2
7959,13241,208931,34,8,1,7,0,0,0
7960,13242,7943,53,8,1,7,1,1,0
7961,13242,8533,47,5,4,1,2,0,2
7962,13243,9804,58,6,2,4,2,0,2
7963,13243,8540,42,2,0,2,0,0,0
7964,13246,8534,57,6,2,4,1,1,0
7965,13246,7943,43,2,0,2,2,0,2
7966,13248,9885,65,6,3,3,6,6,0
7967,13248,9857,35,0,0,0,1,1,0
7968,13250,8564,44,8,4,4,1,0,1
7969,13250,9875,56,6,3,3,0,0,0
7970,13251,8540,42,4,1,3,1,1,0
7971,13251,8686,58,7,3,4,2,1,1
7972,13252,9882,36,6,5,1,2,2,0
7973,13252,8636,64,10,4,6,2,1,1
7974,13255,9857,56,7,3,4,1,1,0
7975,13255,8540,44,5,3,2,1,0,1
7976,13257,10233,53,5,4,1,2,2,0
7977,13257,8533,47,9,3,6,1,0,1
7978,13262,7943,42,7,1,6,4,1,3
7979,13262,8543,58,5,2,3,2,1,1
7980,13264,208931,56,4,4,0,2,0,2
7981,13264,9857,44,4,2,2,0,0,0
7982,13266,8534,52,5,3,2,6,3,3
7983,13266,10233,48,7,3,4,1,1,0
7984,13268,9885,67,8,6,2,4,2,2
7985,13268,8524,33,1,1,0,1,1,0
7986,13270,7943,52,2,2,0,6,4,2
7987,13270,8564,48,7,0,7,0,0,0
7988,13272,9882,44,4,3,1,2,1,1
7989,13272,9876,56,5,1,4,0,0,0
7990,13801,8640,49,9,4,5,2,0,2
7991,13801,10235,51,5,3,2,0,0,0
7992,14119,8640,46,10,5,5,3,1,2
7993,14119,10235,54,8,5,3,0,0,0
7994,14206,8593,62,4,3,1,4,2,2
7995,14206,10235,38,7,3,4,2,1,1
7996,14251,8640,52,8,3,5,2,0,2
7997,14251,10235,48,9,3,6,1,0,1
7998,14287,10235,42,9,6,3,4,2,2
7999,14287,8593,58,5,2,3,1,0,1
8000,14368,8593,63,5,4,1,1,0,1
8001,14368,8640,37,1,0,1,0,0,0
8002,14467,8593,55,6,2,4,1,0,1
8003,14467,8640,45,8,2,6,1,0,1
8004,15416,10228,55,8,3,5,2,0,2
8005,15416,8526,45,6,2,4,0,0,0
8006,15419,8640,49,4,1,3,2,1,1
8007,15419,10217,51,2,0,2,0,0,0
8008,15420,10235,55,3,2,1,3,1,2
8009,15420,9908,45,6,2,4,2,0,2
8010,15421,8593,59,6,3,3,1,1,0
8011,15421,10229,41,7,4,3,1,0,1
8012,15422,10218,44,2,1,1,2,1,1
8013,15422,8464,56,4,3,1,0,0,0
8014,15423,8674,64,11,7,4,1,1,0
8015,15423,8611,36,2,0,2,3,1,2
8016,15424,8277,51,8,5,3,2,1,1
8017,15424,8525,49,5,4,1,0,0,0
8018,15425,6413,59,3,3,0,1,0,1
8019,15425,9908,41,3,1,2,0,0,0
8020,15430,7788,57,11,6,5,1,0,1
8021,15430,10217,43,8,1,7,0,0,0
8022,15431,8277,51,8,7,1,3,1,2
8023,15431,8593,49,7,4,3,3,1,2
8024,15433,10235,62,7,3,4,4,2,2
8025,15433,10229,38,11,3,8,0,0,0
8026,15434,8525,57,2,2,0,2,2,0
8027,15434,9791,43,5,2,3,1,0,1
8028,15435,6413,54,9,3,6,2,1,1
8029,15435,8674,46,2,1,1,4,1,3
8030,15437,8277,64,4,3,1,2,1,1
8031,15437,10218,36,12,4,8,2,2,0
8032,15438,8640,72,12,9,3,2,1,1
8033,15438,8526,28,8,1,7,2,0,2
8034,15439,10235,62,9,2,7,3,2,1
8035,15439,10217,38,2,1,1,1,0,1
8036,15441,9908,59,3,2,1,3,0,3
8037,15441,8611,41,9,0,9,0,0,0
8038,15443,10217,56,7,3,4,2,1,1
8039,15443,9803,44,1,0,1,0,0,0
8040,15444,10228,40,5,3,2,1,1,0
8041,15444,8611,60,2,2,0,0,0,0
8042,15445,8526,41,8,1,7,2,1,1
8043,15445,8464,59,2,1,1,6,3,3
8044,15446,8525,60,4,2,2,3,1,2
8045,15446,10218,40,6,0,6,0,0,0
8046,15447,6413,61,10,6,4,1,1,0
8047,15447,9791,39,5,0,5,3,1,2
8048,15450,10235,49,8,4,4,3,3,0
8049,15450,8593,51,2,0,2,3,0,3
8050,15451,10229,34,8,2,6,4,3,1
8051,15451,8277,66,3,2,1,3,1,2
8052,15452,10228,44,4,2,2,3,2,1
8053,15452,10229,56,7,4,3,0,0,0
8054,15453,9803,61,11,4,7,1,1,0
8055,15453,6413,39,4,2,2,2,1,1
8056,15456,8526,42,10,8,2,2,1,1
8057,15456,8674,58,2,2,0,2,0,2
8058,15457,10218,40,6,3,3,3,1,2
8059,15457,9791,60,9,1,8,2,0,2
8060,15458,10235,65,7,2,5,1,1,0
8061,15458,8611,35,4,0,4,0,0,0
8062,15462,10228,71,10,6,4,1,1,0
8063,15462,9803,29,1,0,1,3,1,2
8064,15464,8525,48,7,6,1,1,1,0
8065,15464,8611,52,11,6,5,2,0,2
8066,15467,8674,63,7,4,3,2,1,1
8067,15467,10217,37,2,0,2,1,0,1
8068,15468,9791,47,5,2,3,1,1,0
8069,15468,9908,53,4,1,3,2,1,1
8070,15470,10229,54,6,3,3,4,3,1
8071,15470,10217,46,6,2,4,2,1,1
8072,15472,8526,44,3,1,2,3,2,1
8073,15472,9908,56,6,4,2,2,0,2
8074,15473,8277,57,7,4,3,2,0,2
8075,15473,8640,43,7,2,5,0,0,0
8076,15474,10228,39,6,3,3,2,1,1
8077,15474,8593,61,9,3,6,2,0,2
8078,15475,8525,45,6,1,5,1,1,0
8079,15475,7788,55,4,0,4,2,0,2
8080,15476,10235,54,7,5,2,2,2,0
8081,15476,9791,46,3,1,2,0,0,0
8082,15478,9803,51,8,2,6,2,2,0
8083,15478,8674,49,5,1,4,2,2,0
8084,15479,10218,41,7,3,4,3,2,1
8085,15479,10228,59,13,5,8,1,0,1
8086,15480,8611,51,9,5,4,1,0,1
8087,15480,8526,49,8,0,8,0,0,0
8088,15481,8464,33,2,1,1,4,2,2
8089,15481,7788,67,3,2,1,4,0,4
8090,15482,8640,64,7,3,4,4,3,1
8091,15482,9803,36,3,2,1,2,2,0
8092,15483,10217,36,10,4,6,1,0,1
8093,15483,8525,64,1,0,1,1,0,1
8094,15484,8593,67,6,6,0,3,2,1
8095,15484,9908,33,4,3,1,2,1,1
8096,15486,10235,60,5,3,2,2,2,0
8097,15486,8674,40,9,2,7,3,1,2
8098,15491,6413,38,8,3,5,3,0,3
8099,15491,8640,62,5,1,4,0,0,0
8100,15492,9908,61,7,4,3,2,1,1
8101,15492,10229,39,4,0,4,1,0,1
8102,15494,10228,60,12,6,6,3,1,2
8103,15494,10217,40,5,1,4,3,1,2
8104,15495,8464,52,4,2,2,3,2,1
8105,15495,10235,48,8,2,6,2,1,1
8106,15496,8593,67,11,5,6,1,0,1
8107,15496,8526,33,5,3,2,0,0,0
8108,15497,8611,39,2,2,0,3,2,1
8109,15497,9791,61,5,4,1,0,0,0
8110,15498,8277,47,4,2,2,3,1,2
8111,15498,7788,53,4,2,2,2,1,1
8112,15499,10228,44,4,2,2,3,2,1
8113,15499,6413,56,8,3,5,2,0,2
8114,15500,10229,42,3,2,1,4,3,1
8115,15500,9803,58,7,1,6,2,1,1
8116,15501,10218,51,4,3,1,3,3,0
8117,15501,8526,49,2,1,1,1,0,1
8118,15502,8593,65,6,2,4,1,1,0
8119,15502,10217,35,6,1,5,2,1,1
8120,15503,10235,58,4,2,2,1,0,1
8121,15503,8640,42,6,2,4,1,0,1
8122,15504,8674,48,6,4,2,3,2,1
8123,15504,9908,52,9,4,5,1,0,1
8124,15506,8464,49,7,3,4,1,0,1
8125,15506,8674,51,9,3,6,1,0,1
8126,15507,8526,48,2,1,1,3,2,1
8127,15507,9791,52,3,1,2,2,0,2
8128,15508,8277,55,7,3,4,4,1,3
8129,15508,8593,45,5,1,4,0,0,0
8130,15509,10218,49,6,5,1,1,0,1
8131,15509,9803,51,5,2,3,0,0,0
8132,15510,10228,49,7,3,4,1,0,1
8133,15510,8525,51,6,4,2,0,0,0
8134,15512,6413,47,7,5,2,2,1,1
8135,15512,9908,53,10,4,6,1,0,1
8136,15513,8611,46,6,1,5,1,1,0
8137,15513,8640,54,7,3,4,1,1,0
8138,15515,8277,69,7,3,4,2,1,1
8139,15515,9803,31,4,2,2,3,1,2
8140,15518,8611,49,6,3,3,3,1,2
8141,15518,10217,51,1,0,1,1,1,0
8142,15519,10229,54,4,1,3,5,1,4
8143,15519,10218,46,4,1,3,2,0,2
8144,15520,8674,45,7,5,2,2,0,2
8145,15520,8640,55,8,3,5,2,0,2
8146,15522,10228,55,3,1,2,1,1,0
8147,15522,9908,45,9,4,5,0,0,0
8148,15523,9791,51,11,4,7,1,1,0
8149,15523,8464,49,1,1,0,2,0,2
8150,15524,8674,44,3,1,2,1,1,0
8151,15524,8525,56,4,2,2,0,0,0
8152,15525,8593,68,8,2,6,3,0,3
8153,15525,9791,32,1,1,0,2,0,2
8154,15526,7788,56,6,2,4,3,1,2
8155,15526,10229,44,5,2,3,1,0,1
8156,15527,8464,51,5,3,2,2,2,0
8157,15527,8611,49,12,3,9,1,0,1
8158,15528,8526,64,7,6,1,6,4,2
8159,15528,10217,36,4,1,3,0,0,0
8160,15529,8640,46,5,3,2,2,1,1
8161,15529,10218,54,2,1,1,1,0,1
8162,15530,8277,73,4,3,1,1,1,0
8163,15530,6413,27,4,0,4,1,0,1
8164,15531,9803,47,8,4,4,2,0,2
8165,15531,9908,53,7,3,4,0,0,0
8166,15532,10235,62,8,4,4,4,3,1
8167,15532,10228,38,8,1,7,1,0,1
8168,15533,9791,36,9,8,1,1,1,0
8169,15533,8525,64,3,1,2,1,0,1
8170,15534,8277,63,10,5,5,3,2,1
8171,15534,10218,37,7,2,5,1,1,0
8172,15535,8674,46,6,4,2,2,1,1
8173,15535,6413,54,8,6,2,0,0,0
8174,15536,8640,70,16,11,5,3,1,2
8175,15536,8526,30,2,0,2,2,1,1
8176,15537,8464,52,4,3,1,1,0,1
8177,15537,10229,48,8,4,4,3,0,3
8178,15540,10235,58,9,2,7,5,2,3
8179,15540,10217,42,1,1,0,1,0,1
8180,15541,8611,41,7,4,3,1,1,0
8181,15541,9908,59,5,1,4,0,0,0
8182,15543,10217,58,5,1,4,1,1,0
8183,15543,9803,42,6,1,5,0,0,0
8184,15546,9791,56,7,5,2,3,2,1
8185,15546,6413,44,2,2,0,0,0,0
8186,15547,10235,38,6,4,2,1,0,1
8187,15547,8593,62,3,2,1,1,0,1
8188,15549,7788,44,4,2,2,4,0,4
8189,15549,8674,56,8,3,5,0,0,0
8190,15551,7788,38,5,5,0,3,2,1
8191,15551,9908,62,7,3,4,0,0,0
8192,15552,9791,62,6,4,2,3,1,2
8193,15552,10229,38,6,1,5,0,0,0
8194,15554,9803,48,4,2,2,1,1,0
8195,15554,8611,52,3,2,1,1,1,0
8196,15556,8593,38,7,4,3,5,4,1
8197,15556,8674,62,4,2,2,2,1,1
8198,15557,6413,47,5,5,0,2,0,2
8199,15557,10235,53,11,4,7,0,0,0
8200,15558,10217,48,4,1,3,3,2,1
8201,15558,10218,52,7,4,3,1,0,1
8202,15560,6413,39,5,0,5,1,1,0
8203,15560,10217,61,3,0,3,0,0,0
8204,15562,10228,60,7,4,3,2,1,1
8205,15562,8464,40,5,1,4,0,0,0
8206,15563,8640,59,10,7,3,3,2,1
8207,15563,9791,41,3,3,0,0,0,0
8208,15564,7788,52,4,3,1,3,1,2
8209,15564,8611,48,6,2,4,2,2,0
8210,15566,8525,45,1,1,0,1,1,0
8211,15566,9908,55,6,1,5,2,2,0
8212,15568,8277,61,6,2,4,2,2,0
8213,15568,8526,39,8,5,3,0,0,0
8214,15569,10218,40,6,2,4,2,1,1
8215,15569,8464,60,3,3,0,1,0,1
8216,15570,8611,44,8,4,4,1,1,0
8217,15570,8674,56,4,1,3,1,1,0
8218,15571,6413,29,6,3,3,3,0,3
8219,15571,7788,71,7,1,6,0,0,0
8220,15572,8640,65,9,5,4,2,2,0
8221,15572,10217,35,3,1,2,2,1,1
8222,15574,9803,37,6,4,2,1,1,0
8223,15574,9791,63,4,3,1,0,0,0
8224,15576,9908,45,11,5,6,1,1,0
8225,15576,10235,55,4,0,4,0,0,0
8226,15578,8611,51,6,2,4,1,1,0
8227,15578,10217,49,1,1,0,1,0,1
8228,15580,10229,68,11,3,8,2,2,0
8229,15580,10218,32,3,0,3,1,1,0
8230,15584,8525,41,8,4,4,6,2,4
8231,15584,8593,59,8,7,1,2,1,1
8232,15585,8277,63,8,3,5,4,2,2
8233,15585,9803,37,3,1,2,1,0,1
8234,15586,10235,55,7,3,4,1,1,0
8235,15586,7788,45,3,0,3,3,1,2
8236,15587,9803,46,11,2,9,2,1,1
8237,15587,8526,54,7,0,7,1,0,1
8238,15590,6413,48,7,4,3,1,0,1
8239,15590,8611,52,7,2,5,0,0,0
8240,15591,10218,47,3,2,1,4,3,1
8241,15591,8674,53,7,2,5,0,0,0
8242,15594,10235,47,4,3,1,1,1,0
8243,15594,8277,53,2,1,1,0,0,0
8244,15595,8593,63,10,5,5,5,2,3
8245,15595,8464,37,3,0,3,1,0,1
8246,15596,10218,42,3,1,2,1,1,0
8247,15596,9908,58,7,4,3,4,1,3
8248,15597,10228,47,11,3,8,3,0,3
8249,15597,9791,53,4,1,3,1,0,1
8250,15598,10235,63,15,8,7,1,1,0
8251,15598,8526,37,3,3,0,3,1,2
8252,15600,7788,57,7,3,4,4,1,3
8253,15600,9803,43,3,0,3,1,0,1
8254,15601,8611,49,12,5,7,3,2,1
8255,15601,10229,51,8,5,3,0,0,0
8256,15602,8674,49,6,5,1,1,1,0
8257,15602,8277,51,7,3,4,1,0,1
8258,15603,10217,65,3,1,2,1,1,0
8259,15603,8464,35,5,2,3,3,1,2
8260,15604,8593,37,6,4,2,2,1,1
8261,15604,8640,63,4,2,2,0,0,0
8262,15605,9908,54,10,4,6,1,1,0
8263,15605,9791,46,1,0,1,1,1,0
8264,15606,8526,57,4,1,3,5,2,3
8265,15606,7788,43,4,1,3,0,0,0
8266,15608,10235,69,10,4,6,1,0,1
8267,15608,10218,31,1,0,1,0,0,0
8268,15609,8611,47,5,1,4,4,0,4
8269,15609,8525,53,6,3,3,0,0,0
8270,15611,10228,53,4,3,1,1,0,1
8271,15611,9803,47,8,2,6,3,0,3
8272,15612,10217,47,13,4,9,4,1,3
8273,15612,8674,53,4,2,2,2,0,2
8274,15614,8674,67,6,5,1,2,0,2
8275,15614,10218,33,5,3,2,0,0,0
8276,15615,9803,48,4,2,2,1,0,1
8277,15615,8526,52,4,3,1,1,0,1
8278,15622,10235,54,7,4,3,4,4,0
8279,15622,8277,46,4,1,3,2,1,1
8280,15623,6413,64,4,3,1,2,0,2
8281,15623,9803,36,4,2,2,0,0,0
8282,15624,9791,41,3,1,2,3,2,1
8283,15624,10218,59,4,2,2,0,0,0
8284,15626,8277,68,9,3,6,2,1,1
8285,15626,10217,32,3,2,1,2,1,1
8286,15627,8525,49,6,4,2,2,1,1
8287,15627,8640,51,4,1,3,3,0,3
8288,15629,9908,37,6,2,4,4,2,2
8289,15629,8464,63,4,3,1,3,1,2
8290,15630,8674,64,9,2,7,2,1,1
8291,15630,8526,36,8,3,5,0,0,0
8292,15631,10235,57,6,3,3,3,1,2
8293,15631,8611,43,5,3,2,0,0,0
8294,15632,8611,51,3,1,2,3,2,1
8295,15632,8526,49,7,3,4,2,1,1
8296,15633,9791,35,4,1,3,5,1,4
8297,15633,8277,65,5,0,5,0,0,0
8298,15635,10229,59,18,10,8,3,2,1
8299,15635,6413,41,3,1,2,2,0,2
8300,15636,9803,39,3,2,1,2,1,1
8301,15636,8640,61,3,1,2,0,0,0
8302,15637,8593,67,8,2,6,2,1,1
8303,15637,9908,33,3,1,2,2,1,1
8304,15638,8525,53,8,2,6,5,4,1
8305,15638,10217,47,2,0,2,2,1,1
8306,15641,8674,65,4,3,1,3,1,2
8307,15641,9803,35,4,3,1,0,0,0
8308,15642,8277,56,8,3,5,2,1,1
8309,15642,8640,44,11,4,7,0,0,0
8310,15643,10218,36,2,1,1,4,2,2
8311,15643,8611,64,6,1,5,1,0,1
8312,15644,10229,46,2,1,1,2,1,1
8313,15644,10217,54,5,2,3,0,0,0
8314,15646,8593,54,7,4,3,1,1,0
8315,15646,10228,46,3,2,1,2,0,2
8316,15647,8526,37,9,4,5,3,0,3
8317,15647,9908,63,12,7,5,0,0,0
8318,15649,10235,66,11,7,4,2,1,1
8319,15649,9791,34,1,0,1,0,0,0
8320,15650,10228,59,5,4,1,2,2,0
8321,15650,8674,41,1,1,0,3,0,3
8322,15651,8526,42,3,1,2,2,1,1
8323,15651,10229,58,9,2,7,1,0,1
8324,15652,10235,53,4,2,2,1,1,0
8325,15652,8525,47,3,1,2,3,0,3
8326,15653,8593,57,11,8,3,2,1,1
8327,15653,8611,43,5,2,3,1,1,0
8328,15654,8640,66,10,6,4,3,1,2
8329,15654,7788,34,7,4,3,0,0,0
8330,15656,9791,55,12,3,9,1,1,0
8331,15656,10217,45,3,0,3,2,1,1
8332,15658,9803,47,4,1,3,2,1,1
8333,15658,8464,53,2,1,1,0,0,0
8334,15659,7788,70,15,6,9,2,2,0
8335,15659,10218,30,2,1,1,1,0,1
8336,15660,9908,64,6,2,4,2,1,1
8337,15660,10229,36,4,0,4,0,0,0
8338,15662,8640,55,8,4,4,5,1,4
8339,15662,6413,45,6,5,1,3,2,1
8340,15663,8593,51,11,3,8,3,2,1
8341,15663,8526,49,3,0,3,1,0,1
8342,15665,8674,49,6,2,4,3,2,1
8343,15665,9791,51,4,0,4,1,1,0
8344,15667,8277,58,12,2,10,1,1,0
8345,15667,8611,42,4,0,4,0,0,0
8346,15669,8674,41,4,2,2,2,0,2
8347,15669,9908,59,3,2,1,1,0,1
8348,15670,10228,62,6,4,2,3,3,0
8349,15670,6413,38,4,0,4,1,1,0
8350,15671,10218,51,7,3,4,4,3,1
8351,15671,8526,49,4,1,3,1,0,1
8352,15674,9803,54,5,3,2,2,0,2
8353,15674,10229,46,4,2,2,0,0,0
8354,15676,8640,52,10,8,2,1,0,1
8355,15676,10235,48,4,1,3,0,0,0
8356,15677,8526,39,6,4,2,2,2,0
8357,15677,10229,61,7,5,2,3,2,1
8358,15679,8593,62,7,1,6,3,1,2
8359,15679,8611,38,2,0,2,1,1,0
8360,15680,7788,37,2,2,0,4,1,3
8361,15680,8640,63,10,7,3,1,1,0
8362,15682,8674,51,12,6,6,1,1,0
8363,15682,10228,49,5,3,2,3,1,2
8364,15687,8611,45,6,2,4,1,1,0
8365,15687,7788,55,0,0,0,4,1,3
8366,15690,8525,51,5,2,3,1,0,1
8367,15690,9908,49,3,0,3,1,0,1
8368,15691,9803,45,8,3,5,3,2,1
8369,15691,10235,55,6,2,4,2,0,2
8370,15692,8593,64,7,2,5,2,2,0
8371,15692,10218,36,2,0,2,0,0,0
8372,15697,8593,54,7,3,4,1,0,1
8373,15697,8674,46,2,1,1,0,0,0
8374,15698,10229,46,10,3,7,5,1,4
8375,15698,9791,54,3,2,1,1,1,0
8376,15701,10235,62,6,2,4,2,1,1
8377,15701,6413,38,2,1,1,0,0,0
8378,15705,8464,59,8,2,6,1,1,0
8379,15705,10217,41,4,2,2,3,1,2
8380,15707,8525,58,7,4,3,2,1,1
8381,15707,6413,42,7,3,4,3,1,2
8382,15708,10218,38,6,4,2,3,3,0
8383,15708,9908,62,7,2,5,3,1,2
8384,15709,10235,62,6,5,1,2,1,1
8385,15709,8526,38,8,6,2,0,0,0
8386,15710,8593,44,3,2,1,1,1,0
8387,15710,8640,56,13,6,7,1,0,1
8388,15711,8277,61,10,4,6,5,4,1
8389,15711,8674,39,2,0,2,1,0,1
8390,15712,10229,45,9,4,5,3,0,3
8391,15712,8611,55,2,1,1,0,0,0
8392,15713,7788,62,10,6,4,3,1,2
8393,15713,10229,38,6,2,4,0,0,0
8394,15714,8674,59,6,3,3,2,1,1
8395,15714,8525,41,3,0,3,2,2,0
8396,15717,8640,64,15,7,8,2,1,1
8397,15717,10218,36,7,2,5,1,0,1
8398,15718,8464,44,7,4,3,1,0,1
8399,15718,8611,56,7,4,3,0,0,0
8400,15719,10235,55,4,2,2,1,1,0
8401,15719,10228,45,2,1,1,0,0,0
8402,15720,10217,61,9,3,6,1,1,0
8403,15720,8526,39,6,4,2,0,0,0
8404,15721,8277,47,15,7,8,4,3,1
8405,15721,6413,53,6,3,3,2,1,1
8406,21520,8633,61,12,5,7,1,0,1
8407,21520,9783,39,2,1,1,0,0,0
8408,21525,10281,54,7,1,6,8,4,4
8409,21525,8558,46,3,1,2,1,0,1
8410,21528,8479,39,5,2,3,2,1,1
8411,21528,8302,61,2,0,2,1,0,1
8412,21535,10281,39,3,1,2,2,0,2
8413,21535,8634,61,7,2,5,0,0,0
8414,21539,10267,64,10,5,5,2,0,2
8415,21539,9869,36,3,0,3,0,0,0
8416,21544,9864,52,8,4,4,1,0,1
8417,21544,10205,48,6,3,3,0,0,0
8418,21545,10281,54,2,1,1,4,2,2
8419,21545,8633,46,11,2,9,0,0,0
8420,21550,8634,62,7,5,2,3,1,2
8421,21550,8305,38,7,4,3,1,1,0
8422,21551,10267,56,8,3,5,1,1,0
8423,21551,8302,44,7,4,3,4,2,2
8424,21553,8315,51,6,3,3,2,0,2
8425,21553,9783,49,8,7,1,0,0,0
8426,21555,8479,41,3,1,2,1,1,0
8427,21555,8633,59,8,3,5,4,2,2
8428,21559,10205,49,3,2,1,1,1,0
8429,21559,8479,51,4,1,3,0,0,0
8430,21561,8696,39,3,2,1,1,1,0
8431,21561,9906,61,3,0,3,1,0,1
8432,21564,8634,65,13,7,6,7,4,3
8433,21564,8302,35,3,2,1,1,1,0
8434,21566,8633,59,6,4,2,6,2,4
8435,21566,8305,41,3,1,2,1,1,0
8436,21571,10205,57,7,2,5,3,2,1
8437,21571,8305,43,2,1,1,0,0,0
8438,21572,8634,59,5,4,1,1,1,0
8439,21572,10267,41,2,2,0,0,0,0
8440,21576,8633,52,12,5,7,2,0,2
8441,21576,8302,48,6,1,5,0,0,0
8442,21578,8634,69,10,6,4,3,1,2
8443,21578,8633,31,3,2,1,0,0,0
8444,21580,9906,52,10,5,5,2,2,0
8445,21580,8603,48,5,3,2,1,0,1
8446,21585,8302,63,10,5,5,2,1,1
8447,21585,10205,37,2,0,2,3,0,3
8448,21586,8558,33,2,1,1,3,3,0
8449,21586,10267,67,11,5,6,3,1,2
8450,21588,8315,43,4,1,3,3,3,0
8451,21588,8603,57,3,0,3,0,0,0
8452,21592,8661,38,8,3,5,2,2,0
8453,21592,8302,62,3,0,3,3,1,2
8454,21598,8305,45,7,2,5,1,1,0
8455,21598,9783,55,5,3,2,0,0,0
8456,21602,8371,39,1,1,0,3,2,1
8457,21602,8302,61,4,1,3,0,0,0
8458,21603,8661,30,3,2,1,2,0,2
8459,21603,8634,70,7,4,3,1,0,1
8460,21604,8633,56,10,3,7,4,2,2
8461,21604,10205,44,7,1,6,1,0,1
8462,21614,8634,68,8,4,4,2,2,0
8463,21614,8371,32,3,1,2,4,2,2
8464,21617,8302,41,2,1,1,2,1,1
8465,21617,9783,59,6,0,6,0,0,0
8466,21618,8315,47,5,3,2,4,1,3
8467,21618,10267,53,6,4,2,0,0,0
8468,21619,9865,51,6,2,4,3,2,1
8469,21619,9906,49,6,0,6,1,0,1
8470,21624,8302,66,8,1,7,2,1,1
8471,21624,8388,34,6,5,1,0,0,0
8472,21625,8634,62,9,6,3,4,2,2
8473,21625,9783,38,1,0,1,0,0,0
8474,21626,8633,59,6,4,2,1,0,1
8475,21626,8371,41,2,1,1,0,0,0
8476,21629,8633,65,13,9,4,3,2,1
8477,21629,8388,35,3,1,2,4,1,3
8478,21630,8634,74,13,4,9,1,1,0
8479,21630,8696,26,1,0,1,2,1,1
8480,21631,8302,67,10,4,6,1,0,1
8481,21631,9869,33,7,2,5,0,0,0
8482,21636,9865,47,6,3,3,3,1,2
8483,21636,10267,53,2,1,1,1,0,1
8484,21638,8634,74,8,4,4,3,1,2
8485,21638,8388,26,1,0,1,0,0,0
8486,21639,8633,62,9,4,5,4,1,3
8487,21639,9783,38,5,1,4,3,0,3
8488,21642,8302,58,6,1,5,1,0,1
8489,21642,8696,42,5,3,2,0,0,0
8490,21646,9906,60,7,4,3,2,1,1
8491,21646,9864,40,6,1,5,4,3,1
8492,21648,8634,67,2,1,1,1,0,1
8493,21648,8696,33,3,1,2,0,0,0
8494,21649,8388,47,6,3,3,1,0,1
8495,21649,8633,53,7,3,4,0,0,0
8496,21652,8302,58,11,5,6,2,2,0
8497,21652,9869,42,5,3,2,0,0,0
8498,21656,8315,57,5,3,2,1,0,1
8499,21656,9864,43,2,1,1,0,0,0
8500,21657,10267,56,2,1,1,3,1,2
8501,21657,9865,44,4,3,1,0,0,0
8502,21660,8633,62,8,6,2,1,1,0
8503,21660,8696,38,6,4,2,2,0,2
8504,21670,8633,59,6,3,3,2,1,1
8505,21670,9869,41,3,1,2,2,0,2
8506,21671,10267,59,11,5,6,1,1,0
8507,21671,9864,41,6,5,1,0,0,0
8508,21673,8305,48,3,3,0,1,0,1
8509,21673,9906,52,7,2,5,1,0,1
8510,21674,8558,44,6,1,5,3,1,2
8511,21674,8302,56,8,3,5,1,1,0
8512,21680,9783,48,7,5,2,2,2,0
8513,21680,10267,52,3,3,0,1,0,1
8514,21684,8633,65,8,3,5,2,1,1
8515,21684,8603,35,0,0,0,2,0,2
8516,21687,9906,37,8,3,5,1,0,1
8517,21687,8302,63,5,2,3,0,0,0
8518,21690,8302,65,6,3,3,2,2,0
8519,21690,8315,35,3,1,2,2,1,1
8520,21693,8603,47,9,5,4,2,2,0
8521,21693,10205,53,4,2,2,1,1,0
8522,21702,9906,47,5,3,2,1,1,0
8523,21702,8633,53,8,5,3,2,2,0
8524,21705,9864,43,3,1,2,2,0,2
8525,21705,8305,57,3,2,1,1,0,1
8526,21711,9906,57,12,9,3,2,1,1
8527,21711,10205,43,2,1,1,4,0,4
8528,21712,8634,66,7,5,2,1,0,1
8529,21712,9865,34,2,0,2,0,0,0
8530,21716,8315,53,4,2,2,1,1,0
8531,21716,8633,47,9,4,5,2,0,2
8532,21719,10281,36,4,1,3,2,2,0
8533,21719,8302,64,3,2,1,1,1,0
8534,21724,8634,73,11,7,4,3,1,2
8535,21724,9864,27,3,1,2,0,0,0
8536,21725,8661,41,1,1,0,1,0,1
8537,21725,9906,59,1,1,0,0,0,0
8538,21726,8315,42,7,5,2,3,1,2
8539,21726,10205,58,5,1,4,2,0,2
8540,21727,9865,47,5,2,3,3,3,0
8541,21727,8633,53,7,3,4,0,0,0
8542,21728,8371,49,2,2,0,2,2,0
8543,21728,9906,51,7,2,5,2,1,1
8544,21729,9869,52,6,3,3,1,1,0
8545,21729,8696,48,3,1,2,2,1,1
8546,21732,10267,60,7,4,3,3,2,1
8547,21732,8305,40,6,2,4,1,0,1
8548,21741,10267,62,4,3,1,1,0,1
8549,21741,8371,38,1,0,1,1,0,1
8550,21743,8305,54,6,5,1,1,1,0
8551,21743,8558,46,3,1,2,1,0,1
8552,21744,8696,41,10,2,8,2,1,1
8553,21744,8633,59,1,1,0,0,0,0
8554,21755,8633,54,9,2,7,3,1,2
8555,21755,10281,46,10,4,6,0,0,0
8556,21756,8479,27,3,2,1,1,0,1
8557,21756,8634,73,6,3,3,0,0,0
8558,21757,8302,60,4,4,0,1,1,0
8559,21757,8305,40,1,1,0,1,0,1
8560,21758,9869,48,6,3,3,3,1,2
8561,21758,8603,52,6,1,5,0,0,0
8562,21763,10267,46,10,5,5,3,0,3
8563,21763,8302,54,3,3,0,1,0,1
8564,21764,8634,71,10,7,3,2,2,0
8565,21764,8305,29,1,0,1,0,0,0
8566,21765,8633,53,10,4,6,1,1,0
8567,21765,8479,47,3,2,1,0,0,0
8568,21766,10205,48,3,1,2,2,2,0
8569,21766,10281,52,7,3,4,0,0,0
8570,21775,8633,52,9,3,6,1,1,0
8571,21775,8305,48,2,0,2,1,1,0
8572,21776,8634,60,8,5,3,2,1,1
8573,21776,8302,40,2,0,2,1,0,1
8574,21780,10205,43,4,3,1,3,2,1
8575,21780,8305,57,5,1,4,1,0,1
8576,21781,8302,54,4,2,2,5,3,2
8577,21781,8633,46,2,1,1,2,0,2
8578,21782,8634,57,8,4,4,2,2,0
8579,21782,10267,43,3,2,1,1,0,1
8580,21783,9783,63,9,3,6,2,1,1
8581,21783,9864,37,6,4,2,0,0,0
8582,21786,9906,62,4,4,0,4,2,2
8583,21786,9869,38,6,2,4,1,0,1
8584,21788,10267,62,9,4,5,1,1,0
8585,21788,8558,38,5,0,5,0,0,0
8586,21789,8603,52,2,1,1,4,2,2
8587,21789,9906,48,2,0,2,4,0,4
8588,21793,10281,56,7,5,2,2,1,1
8589,21793,9783,44,8,3,5,0,0,0
8590,21794,8634,55,8,7,1,2,2,0
8591,21794,8633,45,2,1,1,0,0,0
8592,21795,10205,46,8,3,5,3,2,1
8593,21795,8302,54,3,2,1,0,0,0
8594,21799,8661,37,6,3,3,1,1,0
8595,21799,8302,63,6,2,4,3,0,3
8596,21805,8558,48,4,1,3,3,0,3
8597,21805,9906,52,9,3,6,0,0,0
8598,21806,8634,65,5,3,2,1,1,0
8599,21806,10205,35,1,1,0,0,0,0
8600,21807,10267,54,6,5,1,1,1,0
8601,21807,8633,46,7,3,4,2,0,2
8602,21808,9869,56,12,6,6,3,2,1
8603,21808,9864,44,2,0,2,1,1,0
8604,21812,8634,62,10,6,4,1,1,0
8605,21812,8661,38,8,2,6,0,0,0
8606,21816,8633,60,4,2,2,1,1,0
8607,21816,10205,40,5,1,4,1,0,1
8608,21817,8371,48,7,3,4,2,1,1
8609,21817,8302,52,2,1,1,2,0,2
8610,21824,8371,33,5,1,4,3,0,3
8611,21824,8634,67,4,1,3,2,0,2
8612,21825,8633,58,6,4,2,1,1,0
8613,21825,8661,42,5,2,3,0,0,0
8614,21831,8479,58,1,1,0,2,1,1
8615,21831,9869,42,8,2,6,1,1,0
8616,21834,9783,39,8,1,7,4,1,3
8617,21834,8634,61,8,6,2,0,0,0
8618,21835,8371,46,8,4,4,4,1,3
8619,21835,8633,54,5,2,3,2,0,2
8620,21836,8661,54,11,5,6,2,2,0
8621,21836,10205,46,3,1,2,1,1,0
8622,21842,8634,64,9,4,5,2,1,1
8623,21842,8603,36,3,2,1,1,0,1
8624,21847,9864,52,6,2,4,4,1,3
8625,21847,10267,48,3,1,2,0,0,0
8626,21852,8633,56,8,5,3,1,1,0
8627,21852,8603,44,9,3,6,0,0,0
8628,21853,8558,41,4,2,2,3,1,2
8629,21853,8634,59,15,5,10,0,0,0
8630,21854,9906,57,4,1,3,2,1,1
8631,21854,8302,43,2,0,2,1,0,1
8632,21859,8558,44,3,1,2,6,3,3
8633,21859,8633,56,8,0,8,0,0,0
8634,21870,8633,49,13,5,8,2,1,1
8635,21870,9906,51,5,1,4,1,0,1
8636,21876,8302,51,4,4,0,3,2,1
8637,21876,9865,49,5,1,4,1,0,1
8638,21882,9906,36,4,2,2,4,3,1
8639,21882,10205,64,12,6,6,2,1,1
8640,21883,8315,48,5,3,2,3,0,3
8641,21883,8633,52,3,1,2,0,0,0
8642,21886,10267,73,7,2,5,1,0,1
8643,21886,8479,27,2,0,2,1,0,1
8644,21889,9864,44,2,2,0,1,1,0
8645,21889,8634,56,4,1,3,3,1,2
8646,21890,10281,57,8,4,4,2,1,1
8647,21890,8302,43,3,0,3,1,0,1
8648,21893,9783,43,5,3,2,2,2,0
8649,21893,8603,57,8,3,5,1,0,1
8650,21895,8633,60,5,3,2,2,0,2
8651,21895,9865,40,7,1,6,0,0,0
8652,21897,10267,56,7,3,4,4,3,1
8653,21897,8696,44,3,2,1,0,0,0
8654,21898,9783,38,2,2,0,3,1,2
8655,21898,8633,62,9,4,5,2,0,2
8656,21902,8394,47,7,4,3,2,2,0
8657,21902,9867,53,5,2,3,2,1,1
8658,21905,9869,27,6,2,4,2,1,1
8659,21905,8634,73,8,2,6,1,0,1
8660,21909,8302,54,4,4,0,2,2,0
8661,21909,10205,46,3,2,1,1,0,1
8662,21913,9906,46,7,3,4,6,2,4
8663,21913,8633,54,6,5,1,0,0,0
8664,21915,8634,67,7,6,1,1,0,1
8665,21915,8661,33,5,2,3,1,0,1
8666,21917,10267,53,6,2,4,4,3,1
8667,21917,8394,47,5,2,3,0,0,0
8668,21922,9783,51,10,5,5,1,1,0
8669,21922,9906,49,7,1,6,2,0,2
8670,21924,8634,62,6,2,4,2,0,2
8671,21924,8315,38,1,0,1,1,0,1
8672,21926,10267,49,2,2,0,1,1,0
8673,21926,8371,51,2,1,1,1,0,1
8674,21927,8394,56,2,1,1,1,1,0
8675,21927,9864,44,4,2,2,3,1,2
8676,21928,8302,63,4,1,3,2,0,2
8677,21928,9864,37,6,2,4,0,0,0
8678,21932,9906,52,6,4,2,2,1,1
8679,21932,8558,48,3,1,2,2,0,2
8680,21933,9783,46,3,1,2,3,1,2
8681,21933,8696,54,3,0,3,1,0,1
8682,21934,8634,55,4,3,1,2,1,1
8683,21934,8633,45,8,4,4,0,0,0
8684,21936,8661,31,1,1,0,1,0,1
8685,21936,10267,69,6,1,5,1,0,1
8686,21938,10281,43,3,2,1,1,1,0
8687,21938,8302,57,5,1,4,0,0,0
8688,21940,10205,58,7,6,1,3,2,1
8689,21940,8305,42,1,0,1,1,1,0
8690,21943,8634,68,9,8,1,1,1,0
8691,21943,9783,32,2,1,1,1,0,1
8692,21944,8633,65,18,13,5,2,0,2
8693,21944,9865,35,1,0,1,1,0,1
8694,21945,10267,55,3,2,1,1,0,1
8695,21945,8315,45,3,0,3,1,0,1
8696,21949,9869,47,7,4,3,3,1,2
8697,21949,8302,53,2,2,0,0,0,0
8698,21951,10205,55,7,4,3,2,1,1
8699,21951,9906,45,2,2,0,4,1,3
8700,21953,8634,76,3,3,0,5,2,3
8701,21953,8558,24,2,1,1,3,0,3
8702,21955,10267,46,6,3,3,3,2,1
8703,21955,8633,54,4,2,2,2,1,1
8704,21956,8315,38,2,1,1,2,1,1
8705,21956,8394,62,5,3,2,1,0,1
8706,21959,8302,61,7,5,2,5,3,2
8707,21959,8305,39,2,0,2,1,1,0
8708,21964,10267,53,7,3,4,1,0,1
8709,21964,9783,47,4,2,2,0,0,0
8710,21965,8633,54,5,1,4,2,2,0
8711,21965,8394,46,2,1,1,2,2,0
8712,21970,8302,56,2,1,1,2,1,1
8713,21970,9906,44,2,0,2,1,0,1
8714,21972,8634,58,7,1,6,3,2,1
8715,21972,10205,42,3,0,3,1,0,1
8716,21975,8394,49,7,2,5,6,4,2
8717,21975,9783,51,6,0,6,0,0,0
8718,21976,8633,52,9,3,6,4,1,3
8719,21976,8371,48,2,1,1,1,0,1
8720,21977,8661,61,6,3,3,5,1,4
8721,21977,8315,39,4,0,4,1,0,1
8722,21981,9867,40,5,4,1,4,2,2
8723,21981,8634,60,4,3,1,1,1,0
8724,21982,10205,61,3,1,2,4,2,2
8725,21982,9865,39,2,0,2,0,0,0
8726,21983,10267,54,4,4,0,1,1,0
8727,21983,9868,46,3,1,2,2,0,2
8728,21986,8661,33,3,2,1,4,1,3
8729,21986,8633,67,5,0,5,0,0,0
8730,21989,9869,60,7,4,3,2,1,1
8731,21989,9906,40,3,1,2,1,0,1
8732,21991,8634,69,11,4,7,2,1,1
8733,21991,8302,31,0,0,0,1,1,0
8734,21993,10267,61,9,2,7,1,1,0
8735,21993,10205,39,1,0,1,0,0,0
8736,21997,8315,34,5,4,1,2,1,1
8737,21997,8633,66,18,4,14,0,0,0
8738,21998,9906,45,3,2,1,3,0,3
8739,21998,8305,55,7,4,3,0,0,0
8740,22000,8634,69,7,2,5,3,1,2
8741,22000,10281,31,6,3,3,2,0,2
8742,22005,8558,64,4,2,2,3,1,2
8743,22005,8661,36,4,2,2,0,0,0
8744,22006,8315,57,7,3,4,4,1,3
8745,22006,9783,43,3,0,3,0,0,0
8746,22007,9864,39,3,2,1,1,0,1
8747,22007,8633,61,6,4,2,0,0,0
8748,22009,8633,53,7,2,5,2,1,1
8749,22009,8558,47,5,3,2,2,0,2
8750,22010,9868,54,9,2,7,4,2,2
8751,22010,8315,46,7,2,5,1,0,1
8752,22014,10267,48,4,2,2,1,0,1
8753,22014,10281,52,6,2,4,1,0,1
8754,22016,8305,42,6,1,5,1,1,0
8755,22016,8634,58,8,2,6,0,0,0
8756,22018,8633,57,8,7,1,1,0,1
8757,22018,9783,43,3,1,2,0,0,0
8758,22025,8634,70,6,1,5,3,3,0
8759,22025,9869,30,2,1,1,2,1,1
8760,22027,9864,39,1,1,0,1,0,1
8761,22027,9906,61,6,2,4,0,0,0
8762,22029,8633,66,9,6,3,4,2,2
8763,22029,8558,34,4,1,3,3,1,2
8764,22030,9868,39,4,3,1,1,1,0
8765,22030,8315,61,9,4,5,1,0,1
8766,22033,8302,43,4,2,2,1,1,0
8767,22033,8394,57,4,2,2,2,1,1
8768,22034,10281,51,7,2,5,1,1,0
8769,22034,10267,49,12,7,5,0,0,0
8770,22036,8634,61,5,5,0,2,1,1
8771,22036,8305,39,5,2,3,2,1,1
8772,22037,8696,60,4,2,2,1,1,0
8773,22037,9906,40,2,1,1,0,0,0
8774,22039,9868,42,2,2,0,4,1,3
8775,22039,8633,58,9,4,5,0,0,0
8776,22040,8315,45,1,1,0,3,2,1
8777,22040,10205,55,6,2,4,0,0,0
8778,22041,8661,52,5,3,2,3,3,0
8779,22041,9867,48,2,0,2,0,0,0
8780,22042,8302,59,3,2,1,4,4,0
8781,22042,8371,41,3,3,0,0,0,0
8782,22044,10267,62,10,10,0,1,0,1
8783,22044,9869,38,5,2,3,0,0,0
8784,22046,9906,39,5,3,2,2,1,1
8785,22046,8634,61,6,5,1,1,0,1
8786,22050,8633,56,3,2,1,4,2,2
8787,22050,10205,44,3,1,2,3,2,1
8788,22051,8315,56,7,2,5,3,1,2
8789,22051,9867,44,3,0,3,1,0,1
8790,22052,8302,58,3,3,0,1,1,0
8791,22052,8661,42,3,1,2,0,0,0
8792,22055,10267,48,8,5,3,1,1,0
8793,22055,8305,52,5,2,3,2,0,2
8794,22056,9865,47,5,3,2,3,1,2
8795,22056,9906,53,9,4,5,0,0,0
8796,22057,8634,69,6,3,3,3,1,2
8797,22057,8696,31,1,0,1,1,0,1
8798,22059,10205,48,6,4,2,1,0,1
8799,22059,9783,52,3,1,2,1,0,1
8800,22060,9867,38,7,2,5,1,0,1
8801,22060,8633,62,5,2,3,0,0,0
8802,22061,8302,58,7,3,4,4,1,3
8803,22061,8315,42,5,1,4,2,0,2
8804,22065,10267,51,1,1,0,2,1,1
8805,22065,9906,49,9,0,9,1,0,1
8806,22067,9864,25,1,1,0,2,1,1
8807,22067,8634,75,5,2,3,1,0,1
8808,22069,8558,58,8,6,2,2,1,1
8809,22069,10205,42,8,3,5,2,0,2
8810,22070,9867,41,1,1,0,1,1,0
8811,22070,9783,59,1,0,1,0,0,0
8812,22071,8633,49,13,8,5,1,0,1
8813,22071,8302,51,0,0,0,0,0,0
8814,22072,8315,51,7,3,4,4,2,2
8815,22072,10281,49,7,2,5,0,0,0
8816,22075,8394,46,7,4,3,1,1,0
8817,22075,9906,54,1,0,1,2,1,1
8818,22076,10267,62,6,3,3,1,1,0
8819,22076,8696,38,6,1,5,0,0,0
8820,22077,8634,80,9,5,4,1,1,0
8821,22077,9865,20,2,1,1,1,0,1
8822,22078,10205,53,8,5,3,1,1,0
8823,22078,9868,47,4,2,2,2,0,2
8824,22080,9783,37,3,2,1,5,2,3
8825,22080,8302,63,7,1,6,1,1,0
8826,22081,10281,51,6,3,3,3,1,2
8827,22081,8633,49,11,5,6,2,1,1
8828,22084,8371,52,6,2,4,2,2,0
8829,22084,9906,48,9,5,4,1,0,1
8830,22086,10267,44,5,4,1,3,2,1
8831,22086,8634,56,7,1,6,1,0,1
8832,22092,9869,34,4,1,3,2,0,2
8833,22092,8633,66,9,4,5,1,0,1
8834,22096,8634,58,3,2,1,6,1,5
8835,22096,8394,42,1,0,1,0,0,0
8836,22097,10267,60,9,5,4,1,1,0
8837,22097,9865,40,5,1,4,0,0,0
8838,22099,9868,39,2,1,1,4,2,2
8839,22099,8302,61,2,0,2,0,0,0
8840,22102,8633,53,9,7,2,2,1,1
8841,22102,8305,47,5,0,5,0,0,0
8842,22103,8315,47,5,3,2,2,1,1
8843,22103,9906,53,7,2,5,1,0,1
8844,22109,10205,42,3,1,2,2,2,0
8845,22109,8302,58,6,1,5,2,2,0
8846,22112,9783,42,3,1,2,2,0,2
8847,22112,8305,58,4,1,3,0,0,0
8848,22113,8633,59,10,7,3,1,0,1
8849,22113,9906,41,3,2,1,0,0,0
8850,22114,8696,46,3,1,2,2,1,1
8851,22114,8315,54,1,1,0,1,0,1
8852,22115,8661,32,3,3,0,4,0,4
8853,22115,8634,68,4,2,2,0,0,0
8854,22117,10267,54,3,3,0,1,1,0
8855,22117,8394,46,7,3,4,0,0,0
8856,22118,9783,42,5,2,3,1,0,1
8857,22118,8558,58,3,2,1,1,0,1
8858,22119,8633,60,10,6,4,1,1,0
8859,22119,9868,40,3,2,1,5,1,4
8860,22120,8315,49,4,2,2,1,0,1
8861,22120,10205,51,3,0,3,1,0,1
8862,22122,8302,42,2,2,0,5,3,2
8863,22122,8371,58,4,1,3,2,1,1
8864,22124,10267,70,14,6,8,3,1,2
8865,22124,9869,30,3,0,3,0,0,0
8866,22126,8634,51,3,2,1,1,0,1
8867,22126,9906,49,5,4,1,1,0,1
8868,22132,9906,47,8,4,4,2,1,1
8869,22132,9783,53,2,0,2,1,0,1
8870,22133,8696,36,2,1,1,4,2,2
8871,22133,8633,64,6,1,5,2,1,1
8872,22134,8634,67,9,5,4,1,1,0
8873,22134,8315,33,4,1,3,0,0,0
8874,22137,9864,35,3,2,1,1,1,0
8875,22137,8394,65,5,2,3,2,0,2
8876,22138,8302,66,5,1,4,3,1,2
8877,22138,9864,34,1,0,1,0,0,0
8878,22142,8558,41,5,3,2,1,1,0
8879,22142,9906,59,3,2,1,4,0,4
8880,22144,8634,59,4,2,2,1,0,1
8881,22144,8633,41,10,1,9,1,0,1
8882,22146,8661,39,8,4,4,1,1,0
8883,22146,10267,61,3,1,2,1,0,1
8884,22148,10281,48,7,4,3,1,1,0
8885,22148,8302,52,2,0,2,0,0,0
8886,22150,8305,44,4,3,1,2,2,0
8887,22150,10205,56,4,2,2,1,0,1
8888,22151,9906,52,6,3,3,2,2,0
8889,22151,9868,48,2,1,1,2,2,0
8890,22153,9783,24,2,1,1,1,1,0
8891,22153,8634,76,10,6,4,0,0,0
8892,22154,8633,63,18,9,9,3,1,2
8893,22154,9865,37,5,2,3,1,0,1
8894,22155,10267,62,6,2,4,1,1,0
8895,22155,8315,38,3,1,2,0,0,0
8896,22158,10281,52,1,1,0,2,2,0
8897,22158,9864,48,0,0,0,0,0,0
8898,22161,10205,53,4,3,1,1,1,0
8899,22161,9906,47,5,2,3,2,1,1
8900,22163,8558,31,3,3,0,1,1,0
8901,22163,8634,69,3,1,2,2,0,2
8902,22165,8633,55,10,6,4,2,1,1
8903,22165,10267,45,2,1,1,1,0,1
8904,22166,8315,43,7,2,5,1,1,0
8905,22166,8394,57,2,1,1,2,0,2
8906,22169,8305,52,6,1,5,2,1,1
8907,22169,8302,48,5,0,5,1,0,1
8908,22170,9906,45,5,4,1,1,1,0
8909,22170,9867,55,3,2,1,0,0,0
8910,22172,8634,68,7,2,5,3,2,1
8911,22172,9868,32,3,1,2,1,0,1
8912,22174,10267,63,7,2,5,1,1,0
8913,22174,9783,37,2,1,1,1,0,1
8914,22175,8633,62,10,3,7,1,1,0
8915,22175,8394,38,2,0,2,0,0,0
8916,22180,8302,53,3,2,1,2,1,1
8917,22180,9906,47,2,2,0,1,0,1
8918,22182,8634,69,5,4,1,3,2,1
8919,22182,10205,31,3,1,2,0,0,0
8920,22184,10267,60,6,4,2,2,0,2
8921,22184,8558,40,2,1,1,0,0,0
8922,22185,9783,44,5,1,4,2,1,1
8923,22185,8394,56,1,1,0,0,0,0
8924,22186,8633,57,10,4,6,2,2,0
8925,22186,8371,43,5,2,3,1,0,1
8926,22187,8315,51,4,2,2,3,2,1
8927,22187,8661,49,6,3,3,1,0,1
8928,22191,8634,77,5,3,2,2,1,1
8929,22191,9867,23,2,1,1,0,0,0
8930,22193,10267,66,6,4,2,1,0,1
8931,22193,9868,34,2,2,0,0,0,0
8932,22196,8633,64,5,4,1,1,1,0
8933,22196,8661,36,3,3,0,1,0,1
8934,22199,9906,56,2,1,1,3,0,3
8935,22199,9869,44,0,0,0,0,0,0
8936,22201,8634,65,4,1,3,3,2,1
8937,22201,8302,35,3,2,1,2,2,0
8938,22203,10205,54,5,3,2,2,1,1
8939,22203,10267,46,5,2,3,0,0,0
8940,22206,8661,44,3,2,1,2,1,1
8941,22206,9783,56,4,2,2,1,0,1
8942,22207,8315,38,3,2,1,1,1,0
8943,22207,8633,62,15,8,7,0,0,0
8944,22209,8696,55,9,8,1,1,0,1
8945,22209,9869,45,5,1,4,1,0,1
8946,22210,10281,31,5,2,3,2,2,0
8947,22210,8634,69,6,6,0,4,2,2
8948,22211,9865,51,4,1,3,2,1,1
8949,22211,8302,49,3,2,1,2,1,1
8950,22213,8394,53,3,2,1,1,0,1
8951,22213,10205,47,7,4,3,0,0,0
8952,22215,8661,48,5,4,1,3,1,2
8953,22215,8558,52,2,0,2,0,0,0
8954,22217,9864,27,2,1,1,3,2,1
8955,22217,8633,73,9,3,6,2,2,0
8956,22227,8634,73,7,2,5,1,1,0
8957,22227,8696,27,1,0,1,3,1,2
8958,22230,8633,54,10,4,6,1,1,0
8959,22230,9867,46,8,3,5,2,1,1
8960,22232,8661,59,5,2,3,1,0,1
8961,22232,10281,41,1,0,1,0,0,0
8962,22235,10267,58,8,2,6,6,1,5
8963,22235,9906,42,4,0,4,0,0,0
8964,22241,8302,59,14,5,9,1,1,0
8965,22241,8633,41,4,2,2,0,0,0
8966,22246,8696,48,5,2,3,1,1,0
8967,22246,10267,52,3,2,1,0,0,0
8968,22247,8634,74,10,4,6,1,0,1
8969,22247,9865,26,0,0,0,0,0,0
8970,22250,9783,41,2,2,0,1,1,0
8971,22250,8302,59,1,0,1,4,2,2
8972,22251,10281,39,11,3,8,3,3,0
8973,22251,8633,61,5,0,5,1,0,1
8974,22256,10267,55,4,1,3,2,1,1
8975,22256,8634,45,6,2,4,2,1,1
8976,22260,8558,41,2,1,1,1,0,1
8977,22260,8302,59,13,7,6,0,0,0
8978,22262,8633,62,9,5,4,3,1,2
8979,22262,9869,38,4,3,1,3,1,2
8980,22266,8634,77,9,6,3,1,1,0
8981,22266,8394,23,5,1,4,3,0,3
8982,22271,9783,53,5,2,3,1,1,0
8983,22271,9869,47,5,3,2,1,0,1
8984,22272,8633,52,14,8,6,4,2,2
8985,22272,8305,48,8,3,5,0,0,0
8986,22275,8634,65,11,6,5,2,0,2
8987,22275,8371,35,0,0,0,0,0,0
8988,22277,10267,56,12,7,5,3,2,1
8989,22277,9864,44,6,2,4,0,0,0
8990,22278,9869,38,10,6,4,2,1,1
8991,22278,9906,62,6,2,4,0,0,0
8992,22281,10267,55,9,6,3,4,2,2
8993,22281,9864,45,6,2,4,3,0,3
8994,22283,8581,58,5,1,4,2,1,1
8995,22283,8302,42,8,5,3,1,0,1
8996,22287,8633,51,11,2,9,2,2,0
8997,22287,8661,49,3,1,2,2,1,1
8998,22289,8302,53,9,5,4,2,0,2
8999,22289,10267,47,7,3,4,0,0,0
9000,22291,10205,59,10,5,5,2,0,2
9001,22291,8315,41,6,1,5,0,0,0
9002,22296,8558,51,6,4,2,2,1,1
9003,22296,9864,49,4,2,2,1,0,1
9004,22309,8305,74,7,5,2,3,1,2
9005,22309,8394,26,5,2,3,4,1,3
9006,22311,8634,76,9,3,6,3,3,0
9007,22311,9865,24,3,1,2,0,0,0
9008,22312,8315,44,9,6,3,3,1,2
9009,22312,8633,56,4,2,2,0,0,0
9010,22319,8394,53,5,3,2,1,0,1
9011,22319,10205,47,5,2,3,0,0,0
9012,22329,10205,49,5,5,0,1,0,1
9013,22329,8302,51,4,0,4,0,0,0
9014,22331,10267,43,7,2,5,3,1,2
9015,22331,8633,57,10,6,4,2,0,2
9016,22332,8371,26,2,1,1,2,0,2
9017,22332,8634,74,6,1,5,0,0,0
9018,22333,8315,48,7,1,6,1,0,1
9019,22333,8560,52,1,0,1,1,0,1
9020,22339,8302,59,2,1,1,1,0,1
9021,22339,9865,41,3,3,0,1,0,1
9022,22341,10267,60,7,6,1,3,1,2
9023,22341,8371,40,3,0,3,1,0,1
9024,22345,9906,52,3,3,0,2,2,0
9025,22345,9783,48,1,1,0,0,0,0
9026,22349,8305,60,7,3,4,1,1,0
9027,22349,9865,40,7,6,1,0,0,0
9028,22351,8394,44,3,2,1,1,0,1
9029,22351,8371,56,9,8,1,2,0,2
9030,22360,8302,68,6,6,0,7,1,6
9031,22360,8371,32,3,1,2,1,0,1
9032,22362,10267,55,7,4,3,1,0,1
9033,22362,8558,45,4,1,3,0,0,0
9034,22363,8634,75,12,8,4,3,2,1
9035,22363,8581,25,2,1,1,0,0,0
9036,22368,9865,49,2,1,1,2,2,0
9037,22368,8661,51,5,0,5,1,0,1
9038,22369,10205,46,4,2,2,2,2,0
9039,22369,8633,54,5,1,4,0,0,0
9040,22373,8581,35,6,6,0,2,2,0
9041,22373,10267,65,6,3,3,0,0,0
9042,22374,8634,71,2,1,1,5,3,2
9043,22374,9783,29,3,1,2,1,0,1
9044,22387,8661,44,8,3,5,2,0,2
9045,22387,9906,56,2,1,1,0,0,0
9046,22390,8634,69,7,2,5,2,1,1
9047,22390,10278,31,4,1,3,1,1,0
9048,22393,8302,52,14,4,10,1,1,0
9049,22393,9783,48,4,2,2,0,0,0
9050,22395,8558,51,9,6,3,2,1,1
9051,22395,10205,49,7,2,5,1,0,1
9052,22397,8371,37,1,1,0,2,2,0
9053,22397,8633,63,7,3,4,0,0,0
9054,22401,9864,45,4,3,1,1,1,0
9055,22401,10267,55,5,1,4,1,0,1
9056,22405,10205,57,10,5,5,2,0,2
9057,22405,8560,43,2,2,0,0,0,0
9058,22407,8633,62,10,4,6,8,4,4
9059,22407,8661,38,2,0,2,2,0,2
9060,22408,9869,41,2,1,1,1,1,0
9061,22408,8661,59,3,0,3,2,2,0
9062,22410,8634,68,9,6,3,2,1,1
9063,22410,10278,32,2,1,1,0,0,0
9064,22413,8302,53,3,1,2,1,1,0
9065,22413,9783,47,1,0,1,1,1,0
9066,22424,8581,44,6,4,2,3,1,2
9067,22424,10205,56,10,4,6,1,0,1
9068,22432,8696,36,2,2,0,2,1,1
9069,22432,8302,64,7,2,5,1,1,0
9070,22434,10205,51,2,2,0,1,1,0
9071,22434,9783,49,2,1,1,0,0,0
9072,22440,9906,54,7,6,1,3,1,2
9073,22440,8394,46,4,2,2,2,1,1
9074,22445,8581,24,2,2,0,3,0,3
9075,22445,8633,76,12,5,7,0,0,0
9076,22447,8661,47,4,1,3,1,1,0
9077,22447,8560,53,4,2,2,1,1,0
9078,22448,8661,30,5,3,2,2,0,2
9079,22448,8634,70,2,2,0,0,0,0
9080,22449,8315,44,4,2,2,1,0,1
9081,22449,10267,56,5,3,2,0,0,0
9082,22453,8696,59,7,4,3,2,2,0
9083,22453,10205,41,9,6,3,1,0,1
9084,22455,8633,69,13,3,10,4,1,3
9085,22455,9783,31,2,2,0,1,0,1
9086,22469,8634,79,13,6,7,1,1,0
9087,22469,8394,21,1,0,1,1,0,1
9088,22470,8315,55,5,2,3,3,1,2
9089,22470,8302,45,3,0,3,0,0,0
9090,22472,10205,48,3,1,2,2,1,1
9091,22472,9906,52,5,0,5,0,0,0
9092,22480,8302,27,3,1,2,3,2,1
9093,22480,8634,73,6,1,5,1,0,1
9094,22482,9906,51,10,3,7,2,1,1
9095,22482,9865,49,6,3,3,3,2,1
9096,22488,8661,59,3,3,0,2,1,1
9097,22488,8394,41,1,0,1,1,0,1
9098,22498,8315,51,10,1,9,1,0,1
9099,22498,9869,49,3,3,0,1,0,1
9100,22499,8634,70,10,3,7,2,2,0
9101,22499,9906,30,5,3,2,2,1,1
9102,22502,9864,47,5,4,1,1,1,0
9103,22502,8302,53,7,5,2,6,4,2
9104,22506,8633,48,8,3,5,3,2,1
9105,22506,8560,52,2,0,2,0,0,0
9106,22509,8305,40,5,2,3,2,2,0
9107,22509,10267,60,3,2,1,1,0,1
9108,22510,10205,32,2,1,1,1,1,0
9109,22510,8634,68,7,3,4,0,0,0
9110,22515,8696,33,3,1,2,2,2,0
9111,22515,8558,67,3,2,1,2,1,1
9112,22519,8305,52,6,4,2,2,1,1
9113,22519,8394,48,6,1,5,1,1,0
9114,22522,8315,46,6,4,2,2,1,1
9115,22522,8633,54,4,2,2,0,0,0
9116,22529,8394,43,9,4,5,1,1,0
9117,22529,10205,57,6,4,2,0,0,0
9118,22550,8394,48,2,2,0,4,1,3
9119,22550,8633,52,9,1,8,1,0,1
9120,22558,8661,51,5,3,2,2,0,2
9121,22558,10205,49,2,0,2,1,0,1
9122,22562,8560,44,4,3,1,3,0,3
9123,22562,10267,56,1,0,1,0,0,0
9124,22572,8558,53,7,3,4,1,0,1
9125,22572,10267,47,3,2,1,0,0,0
9126,22576,8696,52,5,3,2,2,2,0
9127,22576,9906,48,3,2,1,0,0,0
9128,22579,8633,59,3,1,2,4,2,2
9129,22579,10205,41,3,0,3,0,0,0
9130,22580,8305,57,6,3,3,2,2,0
9131,22580,8371,43,4,0,4,4,3,1
9132,22584,9783,23,5,2,3,4,2,2
9133,22584,8634,77,2,0,2,0,0,0
9134,22590,8560,55,7,6,1,1,1,0
9135,22590,8305,45,2,2,0,0,0,0
9136,22593,9783,49,7,2,5,2,1,1
9137,22593,10267,51,6,3,3,1,0,1
9138,22598,8661,53,6,4,2,1,1,0
9139,22598,8315,47,5,2,3,1,0,1
9140,22599,8634,74,7,4,3,3,1,2
9141,22599,9869,26,1,1,0,2,1,1
9142,22600,9906,42,2,0,2,1,0,1
9143,22600,10267,58,5,0,5,1,0,1
9144,22606,8633,60,13,8,5,3,1,2
9145,22606,8558,40,4,0,4,0,0,0
9146,22608,8634,69,12,4,8,8,2,6
9147,22608,8315,31,2,1,1,0,0,0
9148,22609,10267,55,3,0,3,2,1,1
9149,22609,9869,45,2,0,2,1,1,0
9150,22610,9906,58,4,2,2,1,1,0
9151,22610,8394,42,11,2,9,1,0,1
9152,22611,8302,64,7,5,2,3,1,2
9153,22611,10278,36,4,1,3,1,0,1
9154,22615,8633,66,12,5,7,3,2,1
9155,22615,8581,34,2,1,1,2,1,1
9156,22618,8634,78,9,4,5,2,2,0
9157,22618,8661,22,4,1,3,2,0,2
9158,22619,10267,59,5,1,4,2,1,1
9159,22619,8315,41,2,0,2,0,0,0
9160,22621,8302,49,9,8,1,1,0,1
9161,22621,9906,51,6,4,2,0,0,0
9162,22625,8633,60,8,6,2,3,0,3
9163,22625,9783,40,1,0,1,0,0,0
9164,22629,8394,42,4,2,2,1,1,0
9165,22629,8315,58,7,1,6,1,1,0
9166,22630,9869,51,5,3,2,1,1,0
9167,22630,8302,49,3,3,0,2,0,2
9168,22634,8633,65,4,1,3,1,0,1
9169,22634,9864,35,1,0,1,0,0,0
9170,22635,8371,48,2,2,0,2,1,1
9171,22635,9783,52,13,4,9,2,0,2
9172,22637,8558,43,6,2,4,4,2,2
9173,22637,8661,57,4,1,3,2,1,1
9174,22640,8315,47,4,2,2,3,3,0
9175,22640,8302,53,5,3,2,0,0,0
9176,22642,9906,41,4,2,2,7,3,4
9177,22642,10205,59,3,1,2,3,3,0
9178,22648,8394,40,3,2,1,2,1,1
9179,22648,10267,60,8,1,7,3,1,2
9180,22650,8315,51,6,3,3,3,0,3
9181,22650,8305,49,3,0,3,2,0,2
9182,22653,8633,65,12,5,7,3,2,1
9183,22653,10278,35,2,2,0,0,0,0
9184,22661,10205,63,4,2,2,2,2,0
9185,22661,9869,37,3,1,2,0,0,0
9186,22681,8633,70,7,7,0,2,2,0
9187,22681,8560,30,2,0,2,4,1,3
9188,22684,8302,45,11,3,8,3,2,1
9189,22684,7878,55,4,2,2,0,0,0
9190,22685,10267,61,4,2,2,1,1,0
9191,22685,8305,39,5,5,0,0,0,0
9192,22691,10205,40,4,1,3,2,1,1
9193,22691,8558,60,7,4,3,2,0,2
9194,22693,8581,31,6,1,5,1,1,0
9195,22693,10267,69,4,1,3,5,3,2
9196,22698,8558,58,10,2,8,4,2,2
9197,22698,8560,42,1,1,0,0,0,0
9198,22699,8661,56,4,4,0,2,0,2
9199,22699,7878,44,3,3,0,0,0,0
9200,22700,9906,64,12,4,8,1,0,1
9201,22700,8581,36,3,1,2,0,0,0
9202,22701,8603,68,10,5,5,2,2,0
9203,22701,10205,32,5,1,4,0,0,0
9204,22702,8315,53,3,2,1,3,2,1
9205,22702,8302,47,4,1,3,0,0,0
9206,22710,9869,49,5,3,2,7,4,3
9207,22710,8581,51,1,0,1,0,0,0
9208,22711,8560,40,6,4,2,2,0,2
9209,22711,8603,60,7,5,2,1,0,1
9210,22714,10205,38,7,3,4,4,3,1
9211,22714,9864,62,6,6,0,2,2,0
9212,22716,10267,47,3,1,2,5,2,3
9213,22716,8370,53,3,1,2,1,1,0
9214,22718,9906,52,9,3,6,3,2,1
9215,22718,8370,48,5,1,4,1,1,0
9216,22719,8696,40,1,1,0,6,2,4
9217,22719,10205,60,2,0,2,0,0,0
9218,22720,8302,56,5,1,4,4,2,2
9219,22720,8305,44,0,0,0,3,0,3
9220,22721,10267,45,5,4,1,1,1,0
9221,22721,8558,55,1,1,0,2,0,2
9222,22722,8581,27,4,2,2,2,1,1
9223,22722,8634,73,7,3,4,0,0,0
9224,22723,8371,68,6,3,3,1,1,0
9225,22723,8603,32,8,0,8,2,1,1
9226,22730,9869,30,7,4,3,2,0,2
9227,22730,8370,70,8,3,5,0,0,0
9228,22733,8558,52,9,4,5,2,1,1
9229,22733,9906,48,4,1,3,0,0,0
9230,22735,8603,40,5,1,4,1,1,0
9231,22735,10267,60,4,2,2,1,0,1
9232,22736,8315,63,5,1,4,5,2,3
9233,22736,8696,37,1,0,1,0,0,0
9234,22737,8633,44,10,4,6,1,0,1
9235,22737,8634,56,4,2,2,0,0,0
9236,22738,8558,54,10,1,9,1,1,0
9237,22738,9869,46,8,3,5,1,0,1
9238,22740,8581,42,8,4,4,1,1,0
9239,22740,7878,58,6,2,4,0,0,0
9240,22741,9906,68,13,6,7,1,0,1
9241,22741,8603,32,2,1,1,2,0,2
9242,22745,8634,58,3,3,0,1,0,1
9243,22745,8370,42,6,2,4,0,0,0
9244,22746,8371,44,9,6,3,3,1,2
9245,22746,10205,56,4,2,2,0,0,0
9246,22755,10267,57,5,3,2,1,1,0
9247,22755,10205,43,7,2,5,3,1,2
9248,22761,9869,40,5,3,2,4,3,1
9249,22761,9864,60,6,2,4,0,0,0
9250,22769,9906,57,11,4,7,2,1,1
9251,22769,8371,43,4,1,3,2,1,1
9252,22772,8302,44,8,4,4,1,0,1
9253,22772,9864,56,1,1,0,0,0,0
9254,22776,8394,40,4,3,1,3,2,1
9255,22776,8633,60,18,8,10,1,0,1
9256,22779,8560,41,9,4,5,1,1,0
9257,22779,9906,59,5,0,5,0,0,0
9258,22782,8633,46,12,5,7,1,1,0
9259,22782,8315,54,4,4,0,1,0,1
9260,22798,8394,44,4,2,2,1,1,0
9261,22798,8370,56,3,0,3,0,0,0
9262,22799,9906,42,3,1,2,2,1,1
9263,22799,10267,58,4,3,1,0,0,0
9264,22800,9864,42,4,4,0,2,2,0
9265,22800,7878,58,9,4,5,3,1,2
9266,22802,8371,43,7,2,5,1,1,0
9267,22802,9869,57,5,2,3,1,0,1
9268,22808,9864,60,8,4,4,1,1,0
9269,22808,8661,40,2,1,1,0,0,0
9270,22813,8394,40,5,1,4,3,2,1
9271,22813,8558,60,4,1,3,1,0,1
9272,22815,10205,51,4,1,3,1,0,1
9273,22815,7878,49,2,0,2,1,0,1
9274,22817,10267,65,6,2,4,3,2,1
9275,22817,9869,35,1,1,0,1,1,0
9276,22821,8394,52,11,8,3,1,1,0
9277,22821,8603,48,7,2,5,1,0,1
9278,22823,8305,47,11,3,8,1,0,1
9279,22823,8558,53,2,0,2,0,0,0
9280,22840,7878,53,7,2,5,1,0,1
9281,22840,10267,47,0,0,0,0,0,0
9282,22843,8581,27,2,1,1,2,1,1
9283,22843,8603,73,10,6,4,1,0,1
9284,22863,8633,52,10,6,4,2,2,0
9285,22863,9864,48,3,2,1,1,0,1
9286,22872,9906,44,8,2,6,3,0,3
9287,22872,8315,56,1,0,1,0,0,0
9288,22873,10205,36,2,2,0,2,2,0
9289,22873,8633,64,9,6,3,1,0,1
9290,22874,8302,63,7,4,3,4,2,2
9291,22874,8696,37,4,2,2,0,0,0
9292,22876,9864,67,4,2,2,1,1,0
9293,22876,8370,33,7,1,6,1,0,1
9294,22877,8634,70,7,5,2,1,1,0
9295,22877,7878,30,1,1,0,2,1,1
9296,22881,10205,51,8,5,3,2,2,0
9297,22881,8302,49,2,2,0,0,0,0
9298,22884,8315,49,8,4,4,1,1,0
9299,22884,8558,51,4,4,0,1,0,1
9300,22891,8633,64,7,3,4,2,1,1
9301,22891,8560,36,3,1,2,0,0,0
9302,22892,9906,45,3,1,2,2,1,1
9303,22892,8394,55,1,0,1,0,0,0
9304,22895,8305,39,3,1,2,4,2,2
9305,22895,10267,61,7,2,5,0,0,0
9306,22907,8394,53,4,3,1,1,0,1
9307,22907,9869,47,5,4,1,0,0,0
9308,22909,8603,40,7,3,4,2,1,1
9309,22909,10205,60,4,0,4,1,0,1
9310,22914,8370,41,7,2,5,1,1,0
9311,22914,8371,59,3,1,2,0,0,0
9312,22923,8633,47,9,5,4,2,1,1
9313,22923,9906,53,4,1,3,2,0,2
9314,22926,10267,61,4,4,0,1,1,0
9315,22926,8370,39,4,2,2,2,0,2
9316,22930,8633,71,5,2,3,1,1,0
9317,22930,9869,29,1,1,0,2,1,1
9318,22936,8558,47,3,1,2,1,0,1
9319,22936,10267,53,0,0,0,1,0,1
9320,22937,8634,72,10,7,3,1,1,0
9321,22937,8581,28,2,1,1,1,0,1
9322,22938,10267,55,5,1,4,2,1,1
9323,22938,8603,45,3,1,2,0,0,0
9324,22940,8633,30,5,3,2,1,1,0
9325,22940,8634,70,4,0,4,0,0,0
9326,22947,8302,72,8,3,5,1,0,1
9327,22947,8581,28,2,1,1,1,0,1
9328,22948,9864,56,9,3,6,3,1,2
9329,22948,10267,44,1,0,1,0,0,0
9330,22949,8394,42,9,3,6,2,1,1
9331,22949,8315,58,4,4,0,2,0,2
9332,22953,9869,40,3,2,1,1,0,1
9333,22953,8558,60,9,3,6,0,0,0
9334,22956,8603,51,2,2,0,1,1,0
9335,22956,9906,49,9,2,7,0,0,0
9336,22957,8633,57,3,3,0,3,2,1
9337,22957,8302,43,3,2,1,1,1,0
9338,22963,8634,66,5,4,1,1,1,0
9339,22963,8558,34,5,1,4,2,0,2
9340,22971,10267,65,6,3,3,3,3,0
9341,22971,8560,35,5,3,2,2,2,0
9342,22973,8634,69,6,4,2,4,2,2
9343,22973,8603,31,3,1,2,1,1,0
9344,22975,8633,67,9,4,5,2,2,0
9345,22975,8661,33,4,1,3,0,0,0
9346,22980,7878,41,3,1,2,2,0,2
9347,22980,10205,59,3,1,2,0,0,0
9348,22982,9869,30,11,3,8,1,0,1
9349,22982,10267,70,6,1,5,0,0,0
9350,22984,8633,69,10,5,5,4,2,2
9351,22984,8581,31,6,2,4,1,0,1
9352,22986,8315,60,10,2,8,1,0,1
9353,22986,8603,40,2,1,1,0,0,0
9354,22987,8302,55,5,3,2,3,0,3
9355,22987,8560,45,1,1,0,0,0,0
9356,22989,8696,36,2,1,1,3,1,2
9357,22989,8633,64,7,1,6,2,0,2
9358,22991,8394,51,8,2,6,2,0,2
9359,22991,8603,49,3,3,0,0,0,0
9360,23000,8302,46,6,3,3,1,0,1
9361,23000,10267,54,9,3,6,0,0,0
9362,23005,8560,53,5,2,3,2,0,2
9363,23005,8661,47,5,2,3,0,0,0
9364,23010,10267,61,14,9,5,2,1,1
9365,23010,7878,39,3,2,1,2,1,1
9366,23012,8661,42,4,4,0,2,1,1
9367,23012,8371,58,4,3,1,2,1,1
9368,23014,8634,79,6,1,5,2,1,1
9369,23014,9869,21,3,2,1,1,0,1
9370,23016,8633,57,5,4,1,1,1,0
9371,23016,8558,43,5,3,2,3,0,3
9372,23018,9906,56,8,2,6,4,2,2
9373,23018,7878,44,5,1,4,0,0,0
9374,23022,8696,26,3,2,1,2,2,0
9375,23022,8634,74,6,3,3,1,1,0
9376,23024,9864,62,4,3,1,2,1,1
9377,23024,8581,38,4,2,2,2,0,2
9378,23033,9864,35,6,2,4,1,0,1
9379,23033,8633,65,4,2,2,0,0,0
9380,23034,8634,76,11,6,5,2,0,2
9381,23034,8302,24,3,2,1,0,0,0
9382,23434,8634,61,10,4,6,5,2,3
9383,23434,8633,39,5,1,4,0,0,0
9384,23634,8634,64,9,5,4,2,1,1
9385,23634,8633,36,6,4,2,0,0,0
9386,23800,9906,45,6,4,2,1,0,1
9387,23800,8370,55,5,1,4,0,0,0
9388,23802,9910,57,8,5,3,2,1,1
9389,23802,8305,43,2,2,0,1,1,0
9390,23803,8560,58,10,5,5,4,2,2
9391,23803,8372,42,6,4,2,0,0,0
9392,23804,9783,47,5,2,3,2,1,1
9393,23804,7878,53,1,0,1,0,0,0
9394,23805,8634,79,4,1,3,1,0,1
9395,23805,10268,21,0,0,0,1,0,1
9396,23806,8633,73,9,7,2,2,0,2
9397,23806,7869,27,2,0,2,1,0,1
9398,23807,9865,52,7,5,2,3,1,2
9399,23807,8558,48,4,1,3,0,0,0
9400,23808,9864,56,3,2,1,3,1,2
9401,23808,8560,44,2,0,2,0,0,0
9402,23809,9906,70,7,5,2,1,0,1
9403,23809,7869,30,2,1,1,0,0,0
9404,23810,8305,51,5,1,4,5,2,3
9405,23810,9783,49,4,0,4,1,0,1
9406,23811,10268,37,4,3,1,4,2,2
9407,23811,8558,63,11,6,5,3,0,3
9408,23812,10267,35,2,1,1,3,1,2
9409,23812,10205,65,8,5,3,0,0,0
9410,23813,8315,49,5,3,2,2,2,0
9411,23813,8302,51,1,1,0,1,0,1
9412,23815,8634,64,9,6,3,5,2,3
9413,23815,9910,36,5,2,3,1,0,1
9414,23816,8633,73,8,3,5,1,1,0
9415,23816,7878,27,6,1,5,3,2,1
9416,23818,9906,49,1,1,0,2,1,1
9417,23818,8560,51,5,4,1,3,0,3
9418,23819,9783,41,4,3,1,3,1,2
9419,23819,7869,59,7,1,6,2,0,2
9420,23820,10268,53,6,3,3,3,1,2
9421,23820,8305,47,7,4,3,4,3,1
9422,23822,10267,43,3,2,1,3,2,1
9423,23822,8315,57,1,0,1,2,0,2
9424,23823,8581,37,7,4,3,2,2,0
9425,23823,8302,63,6,3,3,2,1,1
9426,23824,8634,69,4,3,1,1,1,0
9427,23824,9865,31,3,2,1,1,0,1
9428,23825,7878,39,4,1,3,5,3,2
9429,23825,9910,61,9,4,5,1,1,0
9430,23826,8633,54,7,3,4,1,1,0
9431,23826,8370,46,8,3,5,1,0,1
9432,23829,9783,52,9,3,6,3,1,2
9433,23829,8560,48,8,4,4,1,0,1
9434,23830,7869,52,5,3,2,1,1,0
9435,23830,10268,48,5,3,2,2,2,0
9436,23831,8305,43,7,1,6,2,1,1
9437,23831,10205,57,3,2,1,1,0,1
9438,23832,8315,60,3,2,1,2,2,0
9439,23832,8558,40,3,2,1,1,0,1
9440,23833,10267,66,10,3,7,1,0,1
9441,23833,8581,34,6,2,4,0,0,0
9442,23834,8634,69,8,5,3,2,1,1
9443,23834,8302,31,2,1,1,0,0,0
9444,23836,9910,55,6,3,3,1,1,0
9445,23836,8370,45,3,1,2,1,0,1
9446,23837,8372,34,5,2,3,1,0,1
9447,23837,8633,66,5,3,2,4,0,4
9448,23840,10205,52,5,1,4,2,1,1
9449,23840,7869,48,8,3,5,1,0,1
9450,23841,8305,37,9,3,6,5,2,3
9451,23841,8315,63,2,2,0,0,0,0
9452,23842,8558,68,5,4,1,1,1,0
9453,23842,8581,32,7,5,2,1,1,0
9454,23843,10267,28,6,2,4,2,0,2
9455,23843,8634,72,7,1,6,0,0,0
9456,23845,8370,45,5,3,2,2,1,1
9457,23845,9865,55,5,3,2,0,0,0
9458,23847,8633,55,11,6,5,1,1,0
9459,23847,9864,45,7,2,5,0,0,0
9460,23850,10205,54,13,6,7,1,1,0
9461,23850,8560,46,6,2,4,0,0,0
9462,23851,7869,45,3,2,1,4,3,1
9463,23851,8315,55,8,1,7,2,1,1
9464,23852,8581,46,7,3,4,3,2,1
9465,23852,8305,54,2,0,2,0,0,0
9466,23853,8558,23,2,2,0,1,0,1
9467,23853,8634,77,5,3,2,2,0,2
9468,23854,7878,37,5,3,2,3,1,2
9469,23854,10267,63,4,3,1,2,2,0
9470,23856,9865,60,4,3,1,2,2,0
9471,23856,8372,40,5,0,5,2,1,1
9472,23857,8633,56,12,7,5,2,2,0
9473,23857,9910,44,3,0,3,2,1,1
9474,23859,9906,55,3,2,1,2,2,0
9475,23859,10205,45,3,1,2,1,1,0
9476,23861,8581,36,6,4,2,3,2,1
9477,23861,7869,64,4,2,2,2,0,2
9478,23862,8634,75,11,3,8,1,1,0
9479,23862,8305,25,4,2,2,0,0,0
9480,23863,8558,39,4,3,1,1,0,1
9481,23863,7878,61,5,4,1,0,0,0
9482,23865,8372,40,3,3,0,1,1,0
9483,23865,8302,60,12,4,8,2,1,1
9484,23866,9865,31,6,3,3,1,0,1
9485,23866,8633,69,5,0,5,0,0,0
9486,23867,9864,47,5,3,2,3,2,1
9487,23867,9910,53,8,3,5,0,0,0
9488,23868,9864,53,11,7,4,1,0,1
9489,23868,10268,47,4,3,1,0,0,0
9490,23869,10205,51,10,8,2,1,0,1
9491,23869,9783,49,4,0,4,1,0,1
9492,23870,8315,51,2,1,1,3,0,3
9493,23870,9906,49,0,0,0,0,0,0
9494,23871,8581,40,4,2,2,1,1,0
9495,23871,8560,60,2,2,0,0,0,0
9496,23873,7878,53,6,5,1,3,1,2
9497,23873,8305,47,4,2,2,3,1,2
9498,23875,8372,59,4,3,1,2,2,0
9499,23875,10267,41,5,1,4,2,0,2
9500,23876,8302,42,5,3,2,6,2,4
9501,23876,8633,58,6,2,4,1,0,1
9502,23878,10205,48,9,5,4,1,1,0
9503,23878,10268,52,7,5,2,0,0,0
9504,23879,8315,53,6,2,4,4,2,2
9505,23879,9783,47,4,2,2,0,0,0
9506,23880,8581,32,4,2,2,1,0,1
9507,23880,9906,68,3,2,1,1,0,1
9508,23881,8634,72,8,3,5,1,1,0
9509,23881,8560,28,3,1,2,0,0,0
9510,23882,7869,45,1,1,0,7,1,6
9511,23882,7878,55,2,0,2,1,0,1
9512,23883,8370,73,6,3,3,2,1,1
9513,23883,8305,27,5,1,4,4,1,3
9514,23885,10267,39,3,2,1,2,1,1
9515,23885,8633,61,11,4,7,0,0,0
9516,23887,9864,60,7,3,4,2,1,1
9517,23887,9865,40,2,1,1,1,0,1
9518,23888,9864,56,6,3,3,1,1,0
9519,23888,10205,44,4,2,2,1,1,0
9520,23889,8315,55,6,3,3,3,1,2
9521,23889,10268,45,6,2,4,3,2,1
9522,23890,9783,49,8,2,6,2,1,1
9523,23890,8581,51,3,1,2,1,0,1
9524,23891,8634,65,9,4,5,1,1,0
9525,23891,9906,35,2,0,2,0,0,0
9526,23892,7878,56,6,3,3,1,0,1
9527,23892,8560,44,5,4,1,0,0,0
9528,23893,8370,60,8,2,6,3,1,2
9529,23893,7869,40,3,2,1,0,0,0
9530,23894,8372,58,7,3,4,2,1,1
9531,23894,8305,42,3,2,1,0,0,0
9532,23895,8558,44,5,3,2,3,2,1
9533,23895,8633,56,6,3,3,1,0,1
9534,23897,9865,49,9,2,7,2,1,1
9535,23897,8302,51,6,1,5,0,0,0
9536,23898,8315,54,7,4,3,1,1,0
9537,23898,10205,46,6,2,4,1,0,1
9538,23899,10268,65,6,4,2,1,0,1
9539,23899,8581,35,2,0,2,2,0,2
9540,23900,8634,67,5,2,3,3,0,3
9541,23900,9783,33,3,1,2,1,0,1
9542,23901,9906,58,7,4,3,6,4,2
9543,23901,7878,42,2,2,0,0,0,0
9544,23902,8560,44,3,2,1,1,1,0
9545,23902,8370,56,5,2,3,0,0,0
9546,23903,7869,56,7,3,4,1,0,1
9547,23903,8372,44,3,2,1,0,0,0
9548,23904,8633,58,14,10,4,3,2,1
9549,23904,8305,42,1,0,1,1,1,0
9550,23906,10267,67,7,3,4,1,1,0
9551,23906,9865,33,0,0,0,1,0,1
9552,23907,9864,46,4,2,2,3,2,1
9553,23907,8302,54,5,3,2,1,0,1
9554,23909,8302,58,5,3,2,2,2,0
9555,23909,8558,42,2,0,2,0,0,0
9556,23910,8305,60,7,4,3,2,0,2
9557,23910,9865,40,8,3,5,0,0,0
9558,23911,9910,64,6,4,2,1,1,0
9559,23911,7869,36,1,0,1,2,0,2
9560,23912,8633,51,6,3,3,2,1,1
9561,23912,8560,49,3,2,1,2,1,1
9562,23914,9783,46,5,2,3,3,2,1
9563,23914,8370,54,3,2,1,0,0,0
9564,23916,8634,77,11,5,6,1,1,0
9565,23916,10205,23,1,0,1,2,1,1
9566,23917,8581,38,4,2,2,1,0,1
9567,23917,8315,62,3,1,2,2,0,2
9568,23918,8302,58,7,4,3,1,1,0
9569,23918,10267,42,7,2,5,2,1,1
9570,23920,9910,60,5,4,1,1,1,0
9571,23920,8305,40,8,3,5,1,1,0
9572,23921,7869,40,6,4,2,5,2,3
9573,23921,8633,60,4,0,4,1,0,1
9574,23922,8372,45,5,3,2,1,1,0
9575,23922,8560,55,4,2,2,1,1,0
9576,23925,10268,25,3,3,0,2,2,0
9577,23925,8634,75,2,0,2,1,0,1
9578,23928,9864,62,6,2,4,1,0,1
9579,23928,10267,38,3,1,2,3,0,3
9580,23930,9865,54,7,2,5,1,0,1
9581,23930,8305,46,7,4,3,0,0,0
9582,23931,7869,35,3,2,1,1,1,0
9583,23931,9910,65,11,8,3,3,1,2
9584,23932,8560,37,1,1,0,1,0,1
9585,23932,8633,63,12,5,7,0,0,0
9586,23933,8372,52,3,1,2,2,1,1
9587,23933,9906,48,2,1,1,1,1,0
9588,23934,8370,53,6,4,2,1,1,0
9589,23934,9783,47,8,5,3,1,0,1
9590,23935,7878,54,7,3,4,1,1,0
9591,23935,10268,46,2,2,0,2,1,1
9592,23936,8634,65,6,5,1,3,1,2
9593,23936,10205,35,4,2,2,0,0,0
9594,23940,7869,54,8,2,6,1,1,0
9595,23940,9865,46,0,0,0,2,1,1
9596,23941,9910,52,5,3,2,8,2,6
9597,23941,8560,48,6,3,3,0,0,0
9598,23942,9906,47,8,3,5,2,2,0
9599,23942,8633,53,2,1,1,1,0,1
9600,23943,9783,63,7,5,2,2,1,1
9601,23943,8372,37,4,0,4,0,0,0
9602,23944,10268,42,8,5,3,1,1,0
9603,23944,8370,58,6,1,5,1,1,0
9604,23945,10205,53,5,2,3,5,3,2
9605,23945,7878,47,5,0,5,1,0,1
9606,23946,8634,72,10,4,6,1,1,0
9607,23946,8315,28,8,2,6,0,0,0
9608,23948,9864,59,10,3,7,1,0,1
9609,23948,8558,41,1,0,1,1,0,1
9610,23951,8560,56,2,1,1,2,0,2
9611,23951,9865,44,2,0,2,2,0,2
9612,23952,9906,32,5,2,3,1,1,0
9613,23952,9910,68,5,4,1,1,0,1
9614,23955,8370,51,7,1,6,6,1,5
9615,23955,10205,49,2,0,2,0,0,0
9616,23956,7878,56,5,2,3,3,0,3
9617,23956,8315,44,4,0,4,0,0,0
9618,23958,8305,54,6,4,2,4,1,3
9619,23958,8558,46,9,1,8,0,0,0
9620,23960,8302,43,8,2,6,2,1,1
9621,23960,8560,57,8,2,6,1,0,1
9622,23961,9865,44,3,0,3,1,1,0
9623,23961,9906,56,3,0,3,3,0,3
9624,23963,8633,61,6,4,2,1,0,1
9625,23963,10268,39,4,1,3,0,0,0
9626,23964,8372,34,5,1,4,2,1,1
9627,23964,10205,66,10,6,4,0,0,0
9628,23965,8315,52,12,6,6,2,0,2
9629,23965,8370,48,3,1,2,0,0,0
9630,23968,9864,55,6,5,1,2,2,0
9631,23968,8305,45,6,3,3,3,2,1
9632,23970,8560,49,2,2,0,3,1,2
9633,23970,10267,51,4,3,1,1,1,0
9634,23971,8302,64,5,3,2,1,0,1
9635,23971,9906,36,4,0,4,0,0,0
9636,23972,9865,43,6,4,2,2,1,1
9637,23972,9783,57,10,7,3,1,0,1
9638,23973,9910,53,7,1,6,3,2,1
9639,23973,10268,47,1,0,1,2,0,2
9640,23974,8633,68,8,4,4,6,2,4
9641,23974,10205,32,5,4,1,0,0,0
9642,23977,8634,70,7,4,3,4,1,3
9643,23977,7878,30,4,3,1,1,0,1
9644,23982,10268,54,8,3,5,1,1,0
9645,23982,9865,46,5,2,3,0,0,0
9646,23984,8633,63,6,2,4,1,0,1
9647,23984,8315,37,3,1,2,0,0,0
9648,23985,8581,60,6,4,2,2,2,0
9649,23985,8372,40,7,4,3,0,0,0
9650,23986,8370,48,4,3,1,2,1,1
9651,23986,8634,52,9,3,6,0,0,0
9652,23989,8305,45,7,6,1,4,2,2
9653,23989,8560,55,4,1,3,2,0,2
9654,23992,8302,60,5,3,2,3,2,1
9655,23992,10268,40,7,3,4,0,0,0
9656,23993,10205,55,14,7,7,2,0,2
9657,23993,9865,45,4,1,3,0,0,0
9658,23994,9910,54,6,1,5,1,1,0
9659,23994,8315,46,5,3,2,0,0,0
9660,23995,8633,71,8,5,3,2,2,0
9661,23995,8581,29,1,1,0,1,0,1
9662,23999,9906,55,5,4,1,5,0,5
9663,23999,8305,45,4,1,3,1,0,1
9664,24000,8558,46,3,2,1,2,0,2
9665,24000,9783,54,6,3,3,0,0,0
9666,24001,10267,48,5,3,2,1,1,0
9667,24001,10268,52,5,3,2,0,0,0
9668,24002,8302,46,5,4,1,1,1,0
9669,24002,10205,54,12,7,5,1,0,1
9670,24005,8634,51,6,2,4,2,1,1
9671,24005,8633,49,5,2,3,3,1,2
9672,24007,8370,54,8,3,5,2,1,1
9673,24007,9864,46,4,2,2,0,0,0
9674,24008,9864,55,13,4,9,2,1,1
9675,24008,8560,45,4,4,0,0,0,0
9676,24009,7869,57,5,2,3,1,0,1
9677,24009,9906,43,4,2,2,0,0,0
9678,24011,10268,53,4,1,3,2,1,1
9679,24011,8558,47,2,0,2,1,0,1
9680,24012,10205,54,4,2,2,2,0,2
9681,24012,10267,46,6,1,5,1,0,1
9682,24015,9910,36,2,1,1,2,1,1
9683,24015,8634,64,2,2,0,1,0,1
9684,24016,7878,41,6,1,5,1,1,0
9685,24016,8633,59,5,2,3,1,0,1
9686,24017,8372,36,3,1,2,3,0,3
9687,24017,8370,64,4,0,4,0,0,0
9688,24019,8302,63,6,3,3,1,1,0
9689,24019,8305,37,3,0,3,0,0,0
9690,24020,7869,51,3,2,1,1,1,0
9691,24020,9865,49,4,1,3,2,0,2
9692,24021,8560,42,9,3,6,2,0,2
9693,24021,9910,58,7,3,4,1,0,1
9694,24022,9906,32,4,2,2,2,1,1
9695,24022,8633,68,10,5,5,0,0,0
9696,24023,8372,57,6,3,3,1,0,1
9697,24023,9783,43,2,0,2,0,0,0
9698,24024,10268,37,3,2,1,1,1,0
9699,24024,8370,63,4,1,3,2,1,1
9700,24025,10205,63,6,1,5,3,2,1
9701,24025,7878,37,4,0,4,2,1,1
9702,24026,8315,36,4,2,2,1,1,0
9703,24026,8634,64,9,4,5,3,1,2
9704,24028,9906,46,4,3,1,1,1,0
9705,24028,8560,54,6,4,2,1,0,1
9706,24029,9783,48,5,4,1,2,1,1
9707,24029,7869,52,7,1,6,5,2,3
9708,24030,10268,56,6,2,4,1,1,0
9709,24030,8305,44,6,2,4,1,0,1
9710,24033,8581,62,8,1,7,2,1,1
9711,24033,8302,38,2,1,1,1,0,1
9712,24034,8634,64,9,3,6,3,2,1
9713,24034,9865,36,3,2,1,0,0,0
9714,24035,7878,35,3,2,1,2,2,0
9715,24035,9910,65,5,2,3,3,1,2
9716,24036,8370,59,13,6,7,1,1,0
9717,24036,8633,41,5,2,3,3,1,2
9718,24037,9864,47,6,1,5,5,2,3
9719,24037,8372,53,5,3,2,0,0,0
9720,24038,9864,48,6,2,4,4,2,2
9721,24038,9906,52,4,0,4,0,0,0
9722,24039,8560,46,6,3,3,2,2,0
9723,24039,9783,54,7,3,4,1,0,1
9724,24040,7869,52,4,1,3,2,0,2
9725,24040,10268,48,2,1,1,0,0,0
9726,24041,10205,49,3,1,2,4,3,1
9727,24041,8305,51,6,2,4,0,0,0
9728,24044,8634,69,9,5,4,3,1,2
9729,24044,8302,31,4,2,2,1,0,1
9730,24046,8370,46,4,1,3,0,0,0
9731,24046,9910,54,6,3,3,0,0,0
9732,24047,8372,29,3,2,1,0,0,0
9733,24047,8633,71,10,5,5,0,0,0
9734,24048,9783,49,5,2,3,0,0,0
9735,24048,9906,51,9,1,8,0,0,0
9736,24049,8560,49,3,2,1,0,0,0
9737,24049,10268,51,2,1,1,0,0,0
9738,24050,7869,47,10,8,2,0,0,0
9739,24050,10205,53,13,3,10,0,0,0
9740,24052,8581,55,6,3,3,0,0,0
9741,24052,8558,45,7,1,6,0,0,0
9742,24053,10267,42,4,2,2,0,0,0
9743,24053,8634,58,3,0,3,0,0,0
9744,24054,8302,53,5,2,3,0,0,0
9745,24054,7878,47,1,0,1,0,0,0
9746,24056,8372,40,5,2,3,0,0,0
9747,24056,9910,60,10,1,9,0,0,0
9748,24057,9864,35,3,2,1,0,0,0
9749,24057,8633,65,5,2,3,0,0,0
9750,24058,9783,47,4,2,2,0,0,0
9751,24058,9864,53,5,0,5,0,0,0
9752,24059,9906,58,9,7,2,0,0,0
9753,24059,10268,42,3,0,3,0,0,0
9754,24061,7869,47,7,5,2,0,0,0
9755,24061,8315,53,7,3,4,0,0,0
9756,24063,8634,72,7,3,4,0,0,0
9757,24063,8558,28,3,0,3,0,0,0
9758,24064,10267,63,6,4,2,0,0,0
9759,24064,7878,37,3,0,3,0,0,0
9760,24067,9910,44,7,4,3,0,0,0
9761,24067,8633,56,5,0,5,0,0,0
9762,24068,10268,70,5,1,4,0,0,0
9763,24068,9783,30,7,0,7,0,0,0
9764,24071,7869,48,2,2,0,0,0,0
9765,24071,8581,52,3,1,2,0,0,0
9766,24073,8558,48,2,1,1,0,0,0
9767,24073,7878,52,6,3,3,0,0,0
9768,24074,8370,55,5,3,2,0,0,0
9769,24074,10267,45,8,5,3,0,0,0
9770,24078,10268,45,2,2,0,0,0,0
9771,24078,9864,55,13,2,11,0,0,0
9772,24079,9783,54,3,2,1,0,0,0
9773,24079,10205,46,2,1,1,0,0,0
9774,24081,8581,36,6,2,4,0,0,0
9775,24081,8560,64,1,0,1,0,0,0
9776,24082,8634,65,9,6,3,0,0,0
9777,24082,7869,35,1,0,1,0,0,0
9778,24083,8305,53,7,2,5,0,0,0
9779,24083,7878,47,6,3,3,0,0,0
9780,24084,8558,43,6,4,2,0,0,0
9781,24084,8370,57,5,2,3,0,0,0
9782,24085,10267,67,3,3,0,0,0,0
9783,24085,8372,33,0,0,0,0,0,0
9784,24086,8633,62,7,3,4,0,0,0
9785,24086,8302,38,9,2,7,0,0,0
9786,24087,9865,40,4,1,3,0,0,0
9787,24087,9910,60,3,1,2,0,0,0
9788,24092,7878,55,11,6,5,0,0,0
9789,24092,7869,45,3,2,1,0,0,0
9790,24101,9906,28,5,1,4,0,0,0
9791,24101,8634,72,6,5,1,0,0,0
9792,24102,8560,67,6,3,3,0,0,0
9793,24102,7878,33,5,4,1,0,0,0
9794,24104,8305,60,6,5,1,0,0,0
9795,24104,8372,40,1,1,0,0,0,0
9796,24107,9865,52,3,2,1,0,0,0
9797,24107,8302,48,5,3,2,0,0,0
9798,24109,10268,60,9,5,4,0,0,0
9799,24109,8581,40,5,2,3,0,0,0
9800,24110,8634,79,6,5,1,0,0,0
9801,24110,9783,21,1,0,1,0,0,0
9802,24111,9906,51,1,0,1,0,0,0
9803,24111,7878,49,0,0,0,0,0,0
9804,24112,8370,63,3,3,0,0,0,0
9805,24112,8560,37,4,2,2,0,0,0
9806,24113,8372,39,2,1,1,0,0,0
9807,24113,7869,61,6,3,3,0,0,0
9808,24114,8633,58,6,1,5,0,0,0
9809,24114,8305,42,3,1,2,0,0,0
9810,24115,8558,48,3,3,0,0,0,0
9811,24115,9910,52,5,5,0,0,0,0
9812,24117,8302,45,6,5,1,0,0,0
9813,24117,9864,55,7,3,4,0,0,0
9814,24119,8305,53,8,3,5,0,0,0
9815,24119,10267,47,2,2,0,0,0,0
9816,24124,10268,58,9,3,6,0,0,0
9817,24124,8372,42,3,2,1,0,0,0
9818,24125,8370,60,4,3,1,0,0,0
9819,24125,10205,40,9,3,6,0,0,0
9820,24129,10267,52,8,4,4,0,0,0
9821,24129,7869,48,2,2,0,0,0,0
9822,24130,8302,56,8,4,4,0,0,0
9823,24130,8560,44,3,2,1,0,0,0
9824,24132,9910,58,4,1,3,0,0,0
9825,24132,9783,42,3,1,2,0,0,0
9826,24133,10268,28,4,2,2,0,0,0
9827,24133,8633,72,8,5,3,0,0,0
9828,24141,9906,54,4,2,2,0,0,0
9829,24141,8302,46,3,0,3,0,0,0
9830,24142,9865,38,7,5,2,0,0,0
9831,24142,9783,62,2,0,2,0,0,0
9832,24143,10268,43,6,2,4,0,0,0
9833,24143,9910,57,9,5,4,0,0,0
9834,24144,10205,42,11,8,3,0,0,0
9835,24144,8633,58,5,2,3,0,0,0
9836,24146,8370,59,3,3,0,0,0,0
9837,24146,8581,41,2,0,2,0,0,0
9838,24147,7878,23,2,2,0,0,0,0
9839,24147,8634,77,11,3,8,0,0,0
9840,24148,8305,60,5,2,3,0,0,0
9841,24148,7869,40,4,0,4,0,0,0
9842,24150,9906,57,7,3,4,0,0,0
9843,24150,10267,43,2,0,2,0,0,0
9844,24151,8302,55,7,2,5,0,0,0
9845,24151,9783,45,5,1,4,0,0,0
9846,24153,9910,57,9,3,6,0,0,0
9847,24153,10205,43,1,0,1,0,0,0
9848,24154,8315,34,6,3,3,0,0,0
9849,24154,8633,66,9,2,7,0,0,0
9850,24155,8581,43,4,3,1,0,0,0
9851,24155,8372,57,6,3,3,0,0,0
9852,24157,7878,42,4,1,3,0,0,0
9853,24157,9864,58,4,1,3,0,0,0
9854,24160,9906,68,11,6,5,0,0,0
9855,24160,8558,32,1,1,0,0,0,0
9856,24161,9783,48,6,4,2,0,0,0
9857,24161,10267,52,3,1,2,0,0,0
9858,24162,8302,28,8,1,7,0,0,0
9859,24162,10268,72,3,2,1,0,0,0
9860,24163,10205,60,9,4,5,0,0,0
9861,24163,9865,40,5,2,3,0,0,0
9862,24164,8315,48,9,6,3,0,0,0
9863,24164,9910,52,2,0,2,0,0,0
9864,24165,8633,72,10,4,6,0,0,0
9865,24165,8581,28,3,1,2,0,0,0
9866,24167,8370,62,4,2,2,0,0,0
9867,24167,7878,38,3,0,3,0,0,0
9868,24168,7869,57,3,1,2,0,0,0
9869,24168,8560,43,1,0,1,0,0,0
9870,24169,9906,66,8,7,1,0,0,0
9871,24169,8305,34,6,0,6,0,0,0
9872,24172,8302,53,7,3,4,0,0,0
9873,24172,10205,47,5,4,1,0,0,0
9874,24173,8315,58,2,1,1,0,0,0
9875,24173,9865,42,4,1,3,0,0,0
9876,24174,9910,75,4,2,2,0,0,0
9877,24174,8581,25,2,1,1,0,0,0
9878,24175,8633,45,9,5,4,0,0,0
9879,24175,8634,55,7,3,4,0,0,0
9880,24177,9864,51,9,5,4,0,0,0
9881,24177,8370,49,6,1,5,0,0,0
9882,24178,8581,33,3,3,0,0,0,0
9883,24178,9910,67,7,3,4,0,0,0
9884,24180,9864,53,9,4,5,0,0,0
9885,24180,8302,47,3,1,2,0,0,0
9886,24182,8372,42,4,3,1,0,0,0
9887,24182,7878,58,6,2,4,0,0,0
9888,24183,8305,59,6,2,4,0,0,0
9889,24183,8558,41,1,1,0,0,0,0
9890,24184,10205,38,3,1,2,0,0,0
9891,24184,8603,62,8,0,8,0,0,0
9892,24187,8370,53,6,5,1,0,0,0
9893,24187,10267,47,4,2,2,0,0,0
9894,24188,8372,47,4,3,1,0,0,0
9895,24188,8370,53,2,1,1,0,0,0
9896,24189,8634,70,9,3,6,0,0,0
9897,24189,8305,30,3,2,1,0,0,0
9898,24192,9910,52,9,4,5,0,0,0
9899,24192,8560,48,10,4,6,0,0,0
9900,24194,9906,65,6,5,1,0,0,0
9901,24194,9783,35,3,0,3,0,0,0
9902,24195,9864,55,5,2,3,0,0,0
9903,24195,9869,45,4,0,4,0,0,0
9904,24196,8315,54,9,3,6,0,0,0
9905,24196,8603,46,6,3,3,0,0,0
9906,24197,7878,44,5,3,2,0,0,0
9907,24197,8558,56,5,1,4,0,0,0
9908,24198,8305,57,3,1,2,0,0,0
9909,24198,8372,43,9,3,6,0,0,0
9910,24203,8581,55,9,2,7,0,0,0
9911,24203,9783,45,6,2,4,0,0,0
9912,24204,9906,70,6,1,5,0,0,0
9913,24204,9869,30,4,1,3,0,0,0
9914,24205,9864,57,6,3,3,0,0,0
9915,24205,8603,43,3,3,0,0,0,0
9916,24206,8558,49,2,2,0,0,0,0
9917,24206,8315,51,2,1,1,0,0,0
9918,24207,7878,53,1,1,0,0,0,0
9919,24207,8370,47,3,1,2,0,0,0
9920,24208,8370,58,2,1,1,0,0,0
9921,24208,8305,42,10,5,5,0,0,0
9922,24209,8372,44,10,5,5,0,0,0
9923,24209,10205,56,3,2,1,0,0,0
9924,24210,8634,58,6,3,3,0,0,0
9925,24210,8633,42,7,1,6,0,0,0
9926,24212,10267,44,4,2,2,0,0,0
9927,24212,8306,56,8,2,6,0,0,0
9928,24213,9910,54,5,3,2,0,0,0
9929,24213,9783,46,1,0,1,0,0,0
9930,24216,9864,57,10,7,3,0,0,0
9931,24216,8558,43,2,1,1,0,0,0
9932,24217,8315,61,10,5,5,0,0,0
9933,24217,7878,39,3,2,1,0,0,0
9934,24218,8305,44,7,6,1,0,0,0
9935,24218,10205,56,0,0,0,0,0,0
9936,24219,8372,39,4,2,2,0,0,0
9937,24219,8633,61,8,6,2,0,0,0
9938,24220,8560,42,5,1,4,0,0,0
9939,24220,8634,58,3,1,2,0,0,0
9940,24221,8302,60,8,4,4,0,0,0
9941,24221,10267,40,0,0,0,0,0,0
9942,24223,9910,54,2,2,0,0,0,0
9943,24223,9869,46,1,1,0,0,0,0
9944,24224,8603,52,5,2,3,0,0,0
9945,24224,8581,48,2,1,1,0,0,0
9946,24226,7878,43,5,4,1,0,0,0
9947,24226,9864,57,7,4,3,0,0,0
9948,24228,8370,53,6,4,2,0,0,0
9949,24228,10205,47,6,6,0,0,0,0
9950,24230,8372,39,4,1,3,0,0,0
9951,24230,8560,61,5,1,4,0,0,0
9952,24231,10267,39,6,2,4,0,0,0
9953,24231,8634,61,9,4,5,0,0,0
9954,24232,9783,48,3,1,2,0,0,0
9955,24232,8302,52,1,0,1,0,0,0
9956,24236,9906,58,4,3,1,0,0,0
9957,24236,7878,42,5,2,3,0,0,0
9958,24238,8633,57,5,3,2,0,0,0
9959,24238,10205,43,3,1,2,0,0,0
9960,24239,8560,61,5,3,2,0,0,0
9961,24239,8305,39,6,3,3,0,0,0
9962,24240,8372,51,8,4,4,0,0,0
9963,24240,10267,49,1,0,1,0,0,0
9964,24241,8634,71,7,3,4,0,0,0
9965,24241,9783,29,2,1,1,0,0,0
9966,24243,8306,64,8,5,3,0,0,0
9967,24243,8603,36,3,2,1,0,0,0
9968,24244,9910,64,5,3,2,0,0,0
9969,24244,8558,36,2,1,1,0,0,0
9970,24246,9906,53,3,2,1,0,0,0
9971,24246,8315,47,7,4,3,0,0,0
9972,24247,8370,54,4,3,1,0,0,0
9973,24247,9864,46,8,4,4,0,0,0
9974,24250,8305,41,3,1,2,0,0,0
9975,24250,10267,59,7,1,6,0,0,0
9976,24252,8634,71,6,3,3,0,0,0
9977,24252,9869,29,2,0,2,0,0,0
9978,24255,7878,45,2,1,1,0,0,0
9979,24255,9910,55,5,3,2,0,0,0
9980,24256,8315,59,7,2,5,0,0,0
9981,24256,8581,41,2,2,0,0,0,0
9982,24257,9864,54,5,2,3,0,0,0
9983,24257,9906,46,6,2,4,0,0,0
9984,24258,8633,56,11,7,4,0,0,0
9985,24258,8560,44,2,1,1,0,0,0
9986,24259,10205,65,4,3,1,0,0,0
9987,24259,10267,35,3,0,3,0,0,0
9988,24260,8305,49,7,5,2,0,0,0
9989,24260,9783,51,3,1,2,0,0,0
9990,24261,8372,51,4,3,1,0,0,0
9991,24261,9869,49,2,0,2,0,0,0
9992,24264,7878,40,8,3,5,0,0,0
9993,24264,8306,60,2,0,2,0,0,0
9994,24265,8315,43,6,4,2,0,0,0
9995,24265,9910,57,4,3,1,0,0,0
9996,24266,9864,57,7,2,5,0,0,0
9997,24266,8581,43,3,1,2,0,0,0
9998,24267,9906,39,7,5,2,0,0,0
9999,24267,8370,61,5,2,3,0,0,0
10000,24268,8560,49,8,2,6,0,0,0
10001,24268,8370,51,6,1,5,0,0,0
10002,24269,8633,58,8,4,4,0,0,0
10003,24269,10267,42,3,1,2,0,0,0
10004,24270,9783,57,4,1,3,0,0,0
10005,24270,10205,43,2,0,2,0,0,0
10006,24271,9869,48,5,4,1,0,0,0
10007,24271,8305,52,4,3,1,0,0,0
10008,24272,8603,64,6,1,5,0,0,0
10009,24272,8372,36,1,0,1,0,0,0
10010,24274,7878,45,3,2,1,0,0,0
10011,24274,8302,55,6,1,5,0,0,0
10012,24275,8306,59,6,3,3,0,0,0
10013,24275,8315,41,6,5,1,0,0,0
10014,24277,9906,55,5,3,2,0,0,0
10015,24277,8581,45,2,0,2,0,0,0
10016,24278,8560,55,11,2,9,0,0,0
10017,24278,10267,45,3,2,1,0,0,0
10018,24279,9783,46,7,3,4,0,0,0
10019,24279,8633,54,6,3,3,0,0,0
10020,24280,10205,52,1,1,0,0,0,0
10021,24280,9869,48,7,1,6,0,0,0
10022,24281,8603,49,4,2,2,0,0,0
10023,24281,8305,51,3,2,1,0,0,0
10024,24282,8372,54,8,3,5,0,0,0
10025,24282,8558,46,3,1,2,0,0,0
10026,24283,8634,59,5,3,2,0,0,0
10027,24283,7878,41,5,1,4,0,0,0
10028,24284,8315,46,4,3,1,0,0,0
10029,24284,8302,54,3,0,3,0,0,0
10030,24285,9864,42,2,2,0,0,0,0
10031,24285,8306,58,3,0,3,0,0,0
10032,24287,8370,51,5,1,4,0,0,0
10033,24287,8581,49,4,0,4,0,0,0
10034,24288,9910,64,5,3,2,0,0,0
10035,24288,8370,36,0,0,0,0,0,0
10036,24290,8302,55,17,4,13,0,0,0
10037,24290,9906,45,7,4,3,0,0,0
10038,24291,8634,63,17,7,10,0,0,0
10039,24291,9864,37,1,1,0,0,0,0
10040,24295,8633,67,10,4,6,0,0,0
10041,24295,8603,33,2,1,1,0,0,0
10042,24298,9910,56,7,3,4,0,0,0
10043,24298,8581,44,8,2,6,0,0,0
10044,24299,9906,51,6,2,4,0,0,0
10045,24299,8306,49,5,3,2,0,0,0
10046,24300,9864,43,6,2,4,0,0,0
10047,24300,8302,57,3,0,3,0,0,0
10048,24302,8372,58,4,3,1,0,0,0
10049,24302,7878,42,0,0,0,0,0,0
10050,24303,8305,47,4,3,1,0,0,0
10051,24303,8558,53,5,2,3,0,0,0
10052,24307,8370,59,8,3,5,0,0,0
10053,24307,10267,41,8,3,5,0,0,0
10054,24309,8306,58,6,3,3,0,0,0
10055,24309,8581,42,6,2,4,0,0,0
10056,24312,8372,40,2,1,1,0,0,0
10057,24312,8315,60,2,2,0,0,0,0
10058,24313,7878,58,9,4,5,0,0,0
10059,24313,8305,42,3,0,3,0,0,0
10060,24314,10205,47,4,3,1,0,0,0
10061,24314,8558,53,4,0,4,0,0,0
10062,24315,8603,42,1,1,0,0,0,0
10063,24315,8633,58,8,2,6,0,0,0
10064,24316,8560,59,3,1,2,0,0,0
10065,24316,9869,41,3,0,3,0,0,0
10066,24317,9783,55,4,3,1,0,0,0
10067,24317,10267,45,4,3,1,0,0,0
10068,24319,8302,53,6,3,3,0,0,0
10069,24319,8581,47,9,2,7,0,0,0
10070,24320,9906,36,4,1,3,0,0,0
10071,24320,8634,64,4,3,1,0,0,0
10072,24321,9864,47,2,1,1,0,0,0
10073,24321,8372,53,2,1,1,0,0,0
10074,24325,8603,44,2,1,1,0,0,0
10075,24325,8560,56,4,0,4,0,0,0
10076,24326,10267,61,5,4,1,0,0,0
10077,24326,9869,39,2,0,2,0,0,0
10078,24328,8370,52,8,4,4,0,0,0
10079,24328,8306,48,4,2,2,0,0,0
10080,24329,9910,68,13,2,11,0,0,0
10081,24329,8302,32,3,2,1,0,0,0
10082,24331,9906,45,4,1,3,0,0,0
10083,24331,8372,55,2,1,1,0,0,0
10084,24333,10205,39,5,2,3,0,0,0
10085,24333,8315,61,2,2,0,0,0,0
10086,24334,7878,35,6,3,3,0,0,0
10087,24334,8633,65,6,1,5,0,0,0
10088,24335,8560,39,3,0,3,0,0,0
10089,24335,8558,61,1,0,1,0,0,0
10090,24337,9783,63,4,1,3,0,0,0
10091,24337,9869,37,6,3,3,0,0,0
10092,24338,8306,51,8,4,4,0,0,0
10093,24338,8302,49,4,2,2,0,0,0
10094,24340,8372,57,6,3,3,0,0,0
10095,24340,8581,43,4,1,3,0,0,0
10096,24341,8305,51,6,3,3,0,0,0
10097,24341,9906,49,3,2,1,0,0,0
10098,24342,10205,62,6,5,1,0,0,0
10099,24342,9864,38,2,1,1,0,0,0
10100,24343,8315,41,4,4,0,0,0,0
10101,24343,8633,59,8,4,4,0,0,0
10102,24344,8560,48,3,1,2,0,0,0
10103,24344,7878,52,4,1,3,0,0,0
10104,24345,10267,58,9,6,3,0,0,0
10105,24345,8558,42,10,4,6,0,0,0
10106,24346,9783,57,17,8,9,0,0,0
10107,24346,8603,43,0,0,0,0,0,0
10108,24347,8370,58,6,3,3,0,0,0
10109,24347,9869,42,4,2,2,0,0,0
10110,24348,8302,45,6,4,2,0,0,0
10111,24348,8370,55,3,0,3,0,0,0
10112,24349,8634,57,8,4,4,0,0,0
10113,24349,8306,43,7,4,3,0,0,0
10114,24350,9910,64,6,4,2,0,0,0
10115,24350,8372,36,4,1,3,0,0,0
10116,24354,8560,47,5,4,1,0,0,0
10117,24354,8315,53,4,2,2,0,0,0
10118,24356,9783,52,11,5,6,0,0,0
10119,24356,8558,48,13,7,6,0,0,0
10120,24358,8634,71,9,3,6,0,0,0
10121,24358,8302,29,4,2,2,0,0,0
10122,24360,8305,51,6,4,2,0,0,0
10123,24360,9910,49,3,1,2,0,0,0
10124,24361,8581,51,3,2,1,0,0,0
10125,24361,10205,49,0,0,0,0,0,0
10126,24362,9906,33,5,3,2,0,0,0
10127,24362,8633,67,8,3,5,0,0,0
10128,24363,8560,51,4,2,2,0,0,0
10129,24363,9864,49,4,1,3,0,0,0
10130,24364,8315,49,3,2,1,0,0,0
10131,24364,10267,51,4,0,4,0,0,0
10132,24365,9783,66,5,2,3,0,0,0
10133,24365,7878,34,7,1,6,0,0,0
10134,24366,8558,49,5,2,3,0,0,0
10135,24366,9869,51,3,1,2,0,0,0
10136,24367,8603,44,12,4,8,0,0,0
10137,24367,8370,56,3,0,3,0,0,0
10138,24368,8370,43,3,2,1,0,0,0
10139,24368,8634,57,5,3,2,0,0,0
10140,24369,8302,53,7,2,5,0,0,0
10141,24369,8372,47,7,3,4,0,0,0
10142,24371,10205,43,4,3,1,0,0,0
10143,24371,9910,57,10,3,7,0,0,0
10144,24378,8634,73,4,1,3,0,0,0
10145,24378,8372,27,2,0,2,0,0,0
10146,24379,8302,56,5,5,0,0,0,0
10147,24379,8305,44,5,5,0,0,0,0
10148,24380,8306,56,4,3,1,0,0,0
10149,24380,10205,44,5,3,2,0,0,0
10150,24381,9910,47,3,1,2,0,0,0
10151,24381,8633,53,8,3,5,0,0,0
10152,24384,9783,58,6,5,1,0,0,0
10153,24384,9864,42,0,0,0,0,0,0
10154,24385,8315,67,4,1,3,0,0,0
10155,24385,9869,33,2,1,1,0,0,0
10156,24387,8558,30,7,3,4,0,0,0
10157,24387,8370,70,2,2,0,0,0,0
10158,24388,8370,72,3,2,1,0,0,0
10159,24388,8372,28,1,0,1,0,0,0
10160,24390,10205,44,7,2,5,0,0,0
10161,24390,8302,56,2,0,2,0,0,0
10162,24391,8306,47,7,3,4,0,0,0
10163,24391,8633,53,4,4,0,0,0,0
10164,24392,8560,55,7,1,6,0,0,0
10165,24392,9910,45,1,0,1,0,0,0
10166,24393,10267,54,4,1,3,0,0,0
10167,24393,8581,46,5,4,1,0,0,0
10168,24394,9906,45,7,1,6,0,0,0
10169,24394,9783,55,2,0,2,0,0,0
10170,24395,9869,47,5,2,3,0,0,0
10171,24395,9864,53,4,2,2,0,0,0
10172,24396,8315,53,8,5,3,0,0,0
10173,24396,8603,47,0,0,0,0,0,0
10174,24397,7878,52,5,2,3,0,0,0
10175,24397,8558,48,3,1,2,0,0,0
10176,24399,8581,51,6,1,5,0,0,0
10177,24399,8302,49,4,1,3,0,0,0
10178,24400,9906,29,4,1,3,0,0,0
10179,24400,8634,71,5,3,2,0,0,0
10180,24401,9864,53,4,3,1,0,0,0
10181,24401,8372,47,3,2,1,0,0,0
10182,24403,7878,47,6,1,5,0,0,0
10183,24403,10205,53,2,1,1,0,0,0
10184,24404,8558,46,6,3,3,0,0,0
10185,24404,8633,54,1,0,1,0,0,0
10186,24405,8560,48,5,3,2,0,0,0
10187,24405,8603,52,3,3,0,0,0,0
10188,24406,10267,55,9,4,5,0,0,0
10189,24406,9869,45,8,1,7,0,0,0
10190,24407,8370,68,3,2,1,0,0,0
10191,24407,9783,32,7,3,4,0,0,0
10192,24408,8305,40,3,1,2,0,0,0
10193,24408,8372,60,10,6,4,0,0,0
10194,24409,10205,36,9,4,5,0,0,0
10195,24409,8634,64,6,2,4,0,0,0
10196,24411,8560,59,7,3,4,0,0,0
10197,24411,8306,41,7,6,1,0,0,0
10198,24412,10267,44,5,3,2,0,0,0
10199,24412,9910,56,3,2,1,0,0,0
10200,24416,8315,52,8,4,4,0,0,0
10201,24416,8558,48,6,3,3,0,0,0
10202,24417,8370,66,5,3,2,0,0,0
10203,24417,7878,34,3,2,1,0,0,0
10204,24418,8305,40,8,2,6,0,0,0
10205,24418,8370,60,9,5,4,0,0,0
10206,24419,8372,46,6,3,3,0,0,0
10207,24419,10205,54,3,1,2,0,0,0
10208,24420,8634,70,6,2,4,0,0,0
10209,24420,8633,30,6,1,5,0,0,0
10210,24421,8302,55,8,4,4,0,0,0
10211,24421,8560,45,3,2,1,0,0,0
10212,24423,9783,45,3,2,1,0,0,0
10213,24423,9910,55,3,1,2,0,0,0
10214,24424,8581,52,8,3,5,0,0,0
10215,24424,9869,48,6,4,2,0,0,0
10216,24425,9906,46,10,4,6,0,0,0
10217,24425,8603,54,4,2,2,0,0,0
10218,24426,8558,44,2,1,1,0,0,0
10219,24426,9864,56,6,0,6,0,0,0
10220,24427,7878,44,3,1,2,0,0,0
10221,24427,8315,56,1,1,0,0,0,0
10222,24432,9783,35,7,2,5,0,0,0
10223,24432,8306,65,2,2,0,0,0,0
10224,24434,8581,54,4,2,2,0,0,0
10225,24434,8603,46,2,0,2,0,0,0
10226,24435,9906,52,4,3,1,0,0,0
10227,24435,8558,48,3,1,2,0,0,0
10228,24437,8315,46,8,6,2,0,0,0
10229,24437,8370,54,5,2,3,0,0,0
10230,24441,8634,64,14,9,5,0,0,0
10231,24441,10267,36,2,0,2,0,0,0
10232,24444,9910,63,8,5,3,0,0,0
10233,24444,8603,37,4,1,3,0,0,0
10234,24445,8581,62,5,3,2,0,0,0
10235,24445,8558,38,2,0,2,0,0,0
10236,24448,8633,66,8,4,4,0,0,0
10237,24448,10205,34,4,1,3,0,0,0
10238,24449,8560,51,8,2,6,0,0,0
10239,24449,8305,49,1,0,1,0,0,0
10240,24451,8634,70,4,3,1,0,0,0
10241,24451,9783,30,9,4,5,0,0,0
10242,24452,9869,49,6,4,2,0,0,0
10243,24452,8302,51,7,3,4,0,0,0
10244,24453,8603,38,10,3,7,0,0,0
10245,24453,8306,62,1,0,1,0,0,0
10246,24454,8558,41,5,2,3,0,0,0
10247,24454,9910,59,0,0,0,0,0,0
10248,24455,7878,54,5,3,2,0,0,0
10249,24455,8581,46,7,0,7,0,0,0
10250,24456,8315,57,7,2,5,0,0,0
10251,24456,9906,43,2,1,1,0,0,0
10252,24457,9864,44,4,2,2,0,0,0
10253,24457,8370,56,5,2,3,0,0,0
10254,24459,8560,60,2,1,1,0,0,0
10255,24459,10205,40,6,2,4,0,0,0
10256,24460,10267,60,2,1,1,0,0,0
10257,24460,8305,40,11,4,7,0,0,0
10258,24461,8372,53,4,1,3,0,0,0
10259,24461,9783,47,1,1,0,0,0,0
10260,24462,8634,65,7,3,4,0,0,0
10261,24462,9869,35,4,3,1,0,0,0
10262,24463,8302,62,3,2,1,0,0,0
10263,24463,8603,38,2,0,2,0,0,0
10264,24464,8306,56,8,5,3,0,0,0
10265,24464,8558,44,8,4,4,0,0,0
10266,24465,9910,68,8,7,1,0,0,0
10267,24465,7878,32,8,2,6,0,0,0
10268,24466,8315,66,8,4,4,0,0,0
10269,24466,8581,34,6,3,3,0,0,0
10270,24468,8633,63,8,6,2,0,0,0
10271,24468,8560,37,5,2,3,0,0,0
10272,24470,9783,51,10,5,5,0,0,0
10273,24470,8305,49,4,1,3,0,0,0
10274,24472,8603,34,1,1,0,0,0,0
10275,24472,8634,66,4,2,2,0,0,0
10276,24474,8306,55,5,2,3,0,0,0
10277,24474,7878,45,3,3,0,0,0,0
10278,24476,9864,49,10,6,4,0,0,0
10279,24476,8581,51,7,2,5,0,0,0
10280,24477,9906,44,7,4,3,0,0,0
10281,24477,8370,56,8,3,5,0,0,0
10282,24478,8560,40,6,2,4,0,0,0
10283,24478,8370,60,9,4,5,0,0,0
10284,24479,8633,46,7,4,3,0,0,0
10285,24479,10267,54,8,1,7,0,0,0
10286,24483,8634,69,4,4,0,0,0,0
10287,24483,8558,31,3,2,1,0,0,0
10288,24484,8302,56,9,4,5,0,0,0
10289,24484,7878,44,4,3,1,0,0,0
10290,24485,8315,40,4,1,3,0,0,0
10291,24485,8306,60,1,0,1,0,0,0
10292,24486,9864,39,6,2,4,0,0,0
10293,24486,9910,61,4,1,3,0,0,0
10294,24488,8560,51,8,2,6,0,0,0
10295,24488,10267,49,0,0,0,0,0,0
10296,24489,8633,62,5,3,2,0,0,0
10297,24489,9783,38,4,0,4,0,0,0
10298,24490,9869,52,9,4,5,0,0,0
10299,24490,10205,48,8,3,5,0,0,0
10300,24492,8558,59,3,2,1,0,0,0
10301,24492,8372,41,8,1,7,0,0,0
10302,24493,8634,77,6,4,2,0,0,0
10303,24493,7878,23,2,0,2,0,0,0
10304,24496,9906,42,4,2,2,0,0,0
10305,24496,9910,58,7,5,2,0,0,0
10306,24498,8370,52,5,3,2,0,0,0
10307,24498,8306,48,2,2,0,0,0,0
10308,24499,9910,65,7,3,4,0,0,0
10309,24499,8302,35,9,1,8,0,0,0
10310,24500,8634,72,8,6,2,0,0,0
10311,24500,8581,28,5,0,5,0,0,0
10312,24501,9906,57,6,4,2,0,0,0
10313,24501,8372,43,5,1,4,0,0,0
10314,24502,8305,46,5,1,4,0,0,0
10315,24502,9864,54,4,0,4,0,0,0
10316,24504,8633,64,11,6,5,0,0,0
10317,24504,7878,36,7,2,5,0,0,0
10318,24505,8560,54,4,1,3,0,0,0
10319,24505,8558,46,8,3,5,0,0,0
10320,24506,8603,41,3,3,0,0,0,0
10321,24506,10267,59,16,3,13,0,0,0
10322,24508,8306,51,4,2,2,0,0,0
10323,24508,8302,49,8,2,6,0,0,0
10324,24511,9906,55,7,2,5,0,0,0
10325,24511,8305,45,4,2,2,0,0,0
10326,24512,9864,62,8,1,7,0,0,0
10327,24512,10205,38,3,2,1,0,0,0
10328,24513,8633,60,9,7,2,0,0,0
10329,24513,8315,40,7,2,5,0,0,0
10330,24516,9783,44,2,1,1,0,0,0
10331,24516,8603,56,3,1,2,0,0,0
10332,24517,9869,43,4,3,1,0,0,0
10333,24517,8370,57,5,2,3,0,0,0
10334,24520,9910,61,3,3,0,0,0,0
10335,24520,8372,39,7,2,5,0,0,0
10336,24521,8581,43,4,2,2,0,0,0
10337,24521,8305,57,7,3,4,0,0,0
10338,24523,9864,40,7,4,3,0,0,0
10339,24523,8633,60,13,4,9,0,0,0
10340,24524,8560,54,9,5,4,0,0,0
10341,24524,8315,46,4,2,2,0,0,0
10342,24527,9869,52,7,2,5,0,0,0
10343,24527,8603,48,4,3,1,0,0,0
10344,24528,8634,54,18,3,15,0,0,0
10345,24528,8302,46,6,4,2,0,0,0
10346,24529,8306,58,7,1,6,0,0,0
10347,24529,8372,42,5,0,5,0,0,0
10348,24530,9910,58,10,5,5,0,0,0
10349,24530,8305,42,2,0,2,0,0,0
10350,24531,8581,44,8,4,4,0,0,0
10351,24531,10205,56,2,0,2,0,0,0
10352,24532,8633,56,2,1,1,0,0,0
10353,24532,9906,44,9,0,9,0,0,0
10354,24533,9864,39,6,4,2,0,0,0
10355,24533,8560,61,6,3,3,0,0,0
10356,24534,8315,55,5,5,0,0,0,0
10357,24534,10267,45,5,2,3,0,0,0
10358,24535,7878,52,2,2,0,0,0,0
10359,24535,9783,48,4,0,4,0,0,0
10360,24538,8634,49,5,4,1,0,0,0
10361,24538,8370,51,8,2,6,0,0,0
10362,24539,8302,53,9,3,6,0,0,0
10363,24539,8372,47,4,2,2,0,0,0
10364,24541,10205,47,4,3,1,0,0,0
10365,24541,9910,53,0,0,0,0,0,0
10366,24542,8581,48,8,4,4,0,0,0
10367,24542,8633,52,5,2,3,0,0,0
10368,24544,9864,40,5,2,3,0,0,0
10369,24544,10267,60,2,0,2,0,0,0
10370,24548,8372,28,3,2,1,0,0,0
10371,24548,8634,72,3,1,2,0,0,0
10372,24549,8302,55,10,8,2,0,0,0
10373,24549,8305,45,1,1,0,0,0,0
10374,24552,8560,49,3,3,0,0,0,0
10375,24552,8581,51,6,3,3,0,0,0
10376,24553,9906,47,9,4,5,0,0,0
10377,24553,10267,53,2,0,2,0,0,0
10378,24554,9864,52,3,3,0,0,0,0
10379,24554,9783,48,4,2,2,0,0,0
10380,24555,9869,46,2,1,1,0,0,0
10381,24555,8315,54,3,1,2,0,0,0
10382,24557,8558,39,3,1,2,0,0,0
10383,24557,8370,61,8,4,4,0,0,0
